ID_zbozi,ID_lekarna,ID_vedouci,datum,pocet_prodanych_ks,nakupni_cena_CZK,prodejni_cena_CZK,marze_CZK,trzba_CZK
54,9,3,2025-03-25,14,156,171,15,210
923,28,2,2025-03-13,18,307,368,61,1098
873,2,6,2025-03-05,11,307,368,61,671
252,6,1,2025-03-29,14,416,453,37,518
612,13,3,2025-03-01,11,394,493,99,1089
928,2,3,2025-03-22,5,84,118,34,170
22,10,30,2025-03-14,19,264,309,45,855
858,2,25,2025-03-10,11,287,405,118,1298
212,27,20,2025-03-21,17,309,437,128,2176
323,1,13,2025-03-29,17,242,329,87,1479
654,26,22,2025-03-20,16,286,386,100,1600
384,17,2,2025-03-28,6,391,555,164,984
936,16,22,2025-03-09,6,191,230,39,234
401,29,3,2025-03-24,15,218,285,67,1005
345,1,7,2025-03-19,3,445,593,148,444
14,29,12,2025-03-08,13,292,372,80,1040
844,30,2,2025-03-21,10,273,405,132,1320
646,24,8,2025-03-18,16,110,123,13,208
550,15,13,2025-03-25,15,42,44,2,30
468,7,1,2025-03-09,12,370,434,64,768
445,21,14,2025-03-01,4,336,362,26,104
364,23,3,2025-03-03,14,479,505,26,364
549,13,3,2025-03-18,13,34,51,17,221
269,16,2,2025-03-25,18,191,236,45,810
25,21,21,2025-03-06,14,52,71,19,266
696,5,12,2025-03-22,8,400,434,34,272
901,21,2,2025-03-25,17,218,282,64,1088
150,30,21,2025-03-25,10,417,595,178,1780
378,5,18,2025-03-11,17,81,108,27,459
822,19,13,2025-03-14,2,399,443,44,88
685,1,12,2025-03-15,15,175,218,43,645
793,1,6,2025-03-17,11,466,598,132,1452
570,5,11,2025-03-17,4,299,412,113,452
231,29,19,2025-03-11,3,159,233,74,222
250,7,29,2025-03-11,9,223,238,15,135
513,3,7,2025-03-17,7,408,611,203,1421
913,1,7,2025-03-09,19,138,150,12,228
325,3,11,2025-03-18,18,88,129,41,738
829,30,18,2025-03-05,16,272,375,103,1648
796,1,9,2025-03-23,19,463,587,124,2356
406,30,8,2025-03-27,17,493,546,53,901
651,1,29,2025-03-26,20,331,492,161,3220
352,23,19,2025-03-04,2,204,293,89,178
371,22,28,2025-03-14,11,203,233,30,330
460,11,26,2025-03-25,7,440,659,219,1533
392,26,2,2025-03-27,14,212,270,58,812
850,30,6,2025-03-28,18,212,258,46,828
944,10,4,2025-03-30,9,277,393,116,1044
330,2,13,2025-03-02,19,218,258,40,760
477,19,25,2025-03-31,11,144,193,49,539
273,27,15,2025-03-19,19,196,228,32,608
708,15,17,2025-03-19,9,192,284,92,828
187,4,1,2025-03-14,16,395,438,43,688
548,2,16,2025-03-18,5,186,268,82,410
913,8,20,2025-03-28,2,257,328,71,142
932,29,20,2025-03-25,10,381,500,119,1190
15,11,24,2025-03-13,8,372,539,167,1336
893,9,10,2025-03-06,14,203,252,49,686
622,1,16,2025-03-22,6,121,130,9,54
538,6,25,2025-03-24,17,449,511,62,1054
512,28,29,2025-03-15,8,164,211,47,376
106,15,20,2025-03-18,18,163,230,67,1206
534,30,3,2025-03-21,13,228,321,93,1209
460,4,2,2025-03-19,14,409,550,141,1974
530,12,5,2025-03-16,5,119,175,56,280
248,2,8,2025-03-30,7,57,70,13,91
27,1,14,2025-03-21,11,300,319,19,209
947,8,24,2025-03-29,14,377,445,68,952
191,10,4,2025-03-10,11,128,164,36,396
767,12,26,2025-03-05,15,135,167,32,480
523,22,30,2025-03-14,13,306,347,41,533
79,29,16,2025-03-28,2,166,185,19,38
749,24,30,2025-03-04,5,82,103,21,105
883,12,18,2025-03-20,1,247,317,70,70
296,12,7,2025-03-13,2,74,95,21,42
907,25,4,2025-03-19,11,396,431,35,385
685,7,13,2025-03-06,14,84,121,37,518
144,28,28,2025-03-01,6,423,595,172,1032
339,2,4,2025-03-05,8,254,316,62,496
206,22,13,2025-03-02,2,97,107,10,20
713,3,5,2025-03-22,2,203,253,50,100
832,27,7,2025-03-27,8,140,196,56,448
350,22,5,2025-03-03,1,169,202,33,33
411,12,26,2025-03-08,2,49,64,15,30
113,30,8,2025-03-10,8,84,109,25,200
1,26,29,2025-03-20,18,154,225,71,1278
1000,18,12,2025-03-12,5,453,561,108,540
35,20,10,2025-03-12,11,373,533,160,1760
820,12,17,2025-03-25,1,351,415,64,64
388,24,6,2025-03-20,11,247,355,108,1188
752,20,24,2025-03-18,7,224,299,75,525
73,7,7,2025-03-24,12,238,333,95,1140
291,21,29,2025-03-18,18,103,126,23,414
267,24,1,2025-03-25,6,419,476,57,342
189,4,5,2025-03-23,20,71,83,12,240
915,30,3,2025-03-12,2,488,568,80,160
134,9,14,2025-03-03,20,153,196,43,860
568,28,4,2025-03-22,18,81,121,40,720
338,10,26,2025-03-26,10,245,363,118,1180
6,3,27,2025-03-04,20,71,104,33,660
452,27,13,2025-03-27,12,365,413,48,576
927,5,13,2025-03-01,14,127,147,20,280
5,26,14,2025-03-05,3,109,141,32,96
432,6,25,2025-03-29,13,443,526,83,1079
895,1,4,2025-03-26,19,221,259,38,722
55,21,22,2025-03-18,7,468,557,89,623
612,18,26,2025-03-22,11,31,42,11,121
316,10,29,2025-03-31,7,238,273,35,245
47,14,3,2025-03-28,5,107,144,37,185
564,8,29,2025-03-27,3,249,326,77,231
195,13,19,2025-03-23,14,384,496,112,1568
374,3,27,2025-03-28,7,65,81,16,112
962,18,30,2025-03-10,1,126,171,45,45
160,28,21,2025-03-17,4,385,413,28,112
422,26,24,2025-03-29,16,335,410,75,1200
678,6,21,2025-03-22,13,239,322,83,1079
107,3,2,2025-03-07,5,356,502,146,730
140,26,23,2025-03-22,19,174,211,37,703
431,23,9,2025-03-10,14,452,512,60,840
542,28,22,2025-03-30,18,66,99,33,594
948,1,29,2025-03-19,20,383,427,44,880
778,20,22,2025-03-20,4,252,368,116,464
253,21,26,2025-03-27,18,265,282,17,306
304,26,25,2025-03-15,12,351,485,134,1608
854,18,25,2025-03-19,19,353,496,143,2717
347,7,6,2025-03-02,12,46,60,14,168
503,26,12,2025-03-25,14,359,406,47,658
108,22,20,2025-03-03,8,313,383,70,560
140,17,22,2025-03-23,4,410,603,193,772
956,17,25,2025-03-08,17,274,329,55,935
961,20,21,2025-03-28,14,422,615,193,2702
782,21,9,2025-03-11,16,110,127,17,272
747,23,27,2025-03-02,17,384,537,153,2601
378,30,2,2025-03-05,5,433,581,148,740
702,22,13,2025-03-24,6,414,539,125,750
256,17,21,2025-03-06,16,276,373,97,1552
482,5,9,2025-03-12,17,346,432,86,1462
69,14,24,2025-03-28,16,222,265,43,688
654,14,28,2025-03-14,3,187,234,47,141
15,4,2,2025-03-23,12,206,246,40,480
245,23,18,2025-03-23,18,263,362,99,1782
842,19,23,2025-03-11,8,36,41,5,40
670,15,7,2025-03-27,16,239,320,81,1296
15,12,21,2025-03-30,5,157,232,75,375
366,18,10,2025-03-22,3,197,225,28,84
49,4,18,2025-03-05,17,25,33,8,136
528,14,13,2025-03-23,16,52,73,21,336
188,12,8,2025-03-11,14,397,504,107,1498
406,3,12,2025-03-17,13,72,82,10,130
92,23,4,2025-03-12,6,117,127,10,60
67,14,27,2025-03-21,15,495,682,187,2805
973,15,23,2025-03-02,14,46,50,4,56
307,17,13,2025-03-13,11,208,251,43,473
342,20,6,2025-03-04,1,247,303,56,56
330,2,27,2025-03-07,10,181,247,66,660
156,11,20,2025-03-16,12,135,174,39,468
887,2,20,2025-03-16,5,126,151,25,125
718,16,18,2025-03-08,10,486,680,194,1940
202,15,16,2025-03-26,11,263,350,87,957
475,26,30,2025-03-09,14,388,567,179,2506
82,21,13,2025-03-28,15,70,102,32,480
626,28,11,2025-03-13,19,308,408,100,1900
133,8,25,2025-03-02,6,376,465,89,534
522,15,22,2025-03-20,9,330,381,51,459
298,6,30,2025-03-17,8,484,660,176,1408
828,24,3,2025-03-19,13,300,324,24,312
477,23,21,2025-03-30,5,106,128,22,110
603,5,5,2025-03-31,10,232,260,28,280
466,9,20,2025-03-08,20,438,499,61,1220
196,19,20,2025-03-02,10,495,725,230,2300
197,20,15,2025-03-01,6,101,141,40,240
638,22,26,2025-03-06,11,40,44,4,44
43,12,7,2025-03-03,6,487,613,126,756
177,4,18,2025-03-17,2,330,444,114,228
671,4,14,2025-03-29,5,141,191,50,250
175,15,25,2025-03-05,19,208,287,79,1501
981,1,20,2025-03-16,10,241,300,59,590
616,6,30,2025-03-19,5,118,136,18,90
762,22,26,2025-03-15,17,94,141,47,799
602,23,26,2025-03-07,6,291,328,37,222
511,29,24,2025-03-04,4,174,232,58,232
718,1,16,2025-03-24,13,138,179,41,533
820,8,26,2025-03-20,14,490,673,183,2562
889,3,26,2025-03-09,9,307,363,56,504
242,5,20,2025-03-07,7,24,32,8,56
918,3,14,2025-03-17,10,269,291,22,220
477,11,17,2025-03-03,14,298,354,56,784
779,15,21,2025-03-01,5,155,186,31,155
452,26,24,2025-03-24,15,455,540,85,1275
714,16,16,2025-03-12,12,455,503,48,576
998,12,30,2025-03-23,9,156,204,48,432
95,4,1,2025-03-21,12,211,301,90,1080
459,13,5,2025-03-06,8,111,149,38,304
341,7,24,2025-03-15,5,437,612,175,875
562,8,24,2025-03-26,14,210,256,46,644
265,19,12,2025-03-27,13,293,400,107,1391
704,21,1,2025-03-23,8,263,303,40,320
613,8,5,2025-03-31,20,196,245,49,980
731,20,11,2025-03-23,1,354,446,92,92
466,22,2,2025-03-08,1,152,169,17,17
278,6,16,2025-03-06,6,143,184,41,246
178,21,9,2025-03-26,13,300,379,79,1027
391,19,14,2025-03-09,11,426,473,47,517
238,24,25,2025-03-15,10,477,521,44,440
376,6,14,2025-03-09,15,298,413,115,1725
635,2,2,2025-03-08,5,257,359,102,510
235,4,17,2025-03-16,2,485,697,212,424
859,20,30,2025-03-26,12,452,501,49,588
198,8,1,2025-03-23,3,57,73,16,48
517,16,18,2025-03-21,16,169,226,57,912
197,11,26,2025-03-13,7,284,378,94,658
847,7,2,2025-03-22,17,471,536,65,1105
886,10,9,2025-03-28,16,166,185,19,304
839,13,11,2025-03-05,8,98,106,8,64
382,21,8,2025-03-31,12,74,98,24,288
875,2,23,2025-03-25,1,209,277,68,68
869,19,2,2025-03-21,20,220,326,106,2120
793,24,11,2025-03-21,4,107,143,36,144
844,25,28,2025-03-27,10,348,430,82,820
454,19,21,2025-03-10,7,321,385,64,448
945,16,19,2025-03-23,9,486,647,161,1449
378,17,19,2025-03-12,6,254,324,70,420
67,21,5,2025-03-05,14,399,428,29,406
370,13,22,2025-03-16,7,127,152,25,175
215,21,8,2025-03-06,20,85,99,14,280
446,5,30,2025-03-19,17,215,262,47,799
195,30,1,2025-03-03,19,381,504,123,2337
233,30,22,2025-03-06,8,47,68,21,168
350,11,7,2025-03-22,13,223,291,68,884
932,3,18,2025-03-10,13,374,423,49,637
590,14,6,2025-03-11,8,203,262,59,472
598,19,22,2025-03-02,6,408,509,101,606
350,25,15,2025-03-26,4,29,37,8,32
640,30,23,2025-03-02,13,52,58,6,78
975,4,5,2025-03-11,7,470,548,78,546
195,25,8,2025-03-15,1,38,41,3,3
223,16,11,2025-03-18,5,374,420,46,230
977,16,24,2025-03-16,19,363,483,120,2280
118,14,4,2025-03-15,3,357,494,137,411
868,28,22,2025-03-29,3,93,136,43,129
599,18,8,2025-03-27,18,91,106,15,270
252,6,3,2025-03-28,9,412,548,136,1224
98,8,8,2025-03-01,9,210,307,97,873
994,29,4,2025-03-08,17,489,582,93,1581
823,3,23,2025-03-24,9,60,84,24,216
709,17,21,2025-03-26,17,222,258,36,612
872,11,30,2025-03-15,20,127,165,38,760
498,2,3,2025-03-26,2,448,492,44,88
922,16,13,2025-03-07,17,449,613,164,2788
735,24,1,2025-03-30,18,391,527,136,2448
986,12,24,2025-03-29,5,86,127,41,205
878,29,19,2025-03-06,20,465,609,144,2880
713,10,28,2025-03-09,3,497,732,235,705
458,1,28,2025-03-03,9,455,580,125,1125
269,14,22,2025-03-24,15,193,213,20,300
476,22,5,2025-03-26,20,487,629,142,2840
610,20,10,2025-03-18,18,481,575,94,1692
510,21,21,2025-03-28,19,167,188,21,399
797,8,26,2025-03-21,15,181,196,15,225
483,29,28,2025-03-08,15,222,257,35,525
399,10,11,2025-03-18,18,380,561,181,3258
685,29,18,2025-03-19,18,395,418,23,414
541,4,15,2025-03-22,5,91,115,24,120
439,5,22,2025-03-15,4,460,664,204,816
144,26,8,2025-03-03,4,333,494,161,644
599,30,10,2025-03-11,5,181,266,85,425
448,10,3,2025-03-08,19,403,433,30,570
538,13,12,2025-03-14,2,154,222,68,136
229,10,15,2025-03-22,18,130,163,33,594
215,7,28,2025-03-22,6,282,406,124,744
308,5,11,2025-03-06,10,61,75,14,140
842,8,14,2025-03-31,15,405,454,49,735
297,17,20,2025-03-01,8,244,304,60,480
834,10,10,2025-03-10,2,391,568,177,354
995,29,15,2025-03-08,1,457,488,31,31
301,27,5,2025-03-29,14,477,682,205,2870
683,27,29,2025-03-19,3,119,166,47,141
850,6,1,2025-03-27,18,95,105,10,180
183,26,18,2025-03-28,18,489,631,142,2556
531,1,2,2025-03-29,3,144,181,37,111
491,22,27,2025-03-31,17,282,342,60,1020
711,14,28,2025-03-16,4,32,46,14,56
620,9,7,2025-03-29,13,327,436,109,1417
762,17,19,2025-03-01,18,113,127,14,252
926,10,26,2025-03-06,16,29,36,7,112
143,11,20,2025-03-16,18,255,350,95,1710
858,5,26,2025-03-04,8,430,565,135,1080
719,11,29,2025-03-03,7,210,284,74,518
24,7,10,2025-03-16,14,38,53,15,210
774,23,27,2025-03-29,20,438,608,170,3400
979,16,15,2025-03-08,7,457,558,101,707
582,18,20,2025-03-13,12,73,98,25,300
203,2,8,2025-03-17,17,493,683,190,3230
178,9,14,2025-03-10,6,319,350,31,186
320,18,9,2025-03-14,3,27,32,5,15
402,14,27,2025-03-29,19,457,551,94,1786
318,15,25,2025-03-31,16,218,244,26,416
759,25,6,2025-03-31,3,489,609,120,360
90,12,7,2025-03-29,2,379,543,164,328
6,30,14,2025-03-06,20,353,518,165,3300
104,8,10,2025-03-22,12,321,446,125,1500
585,6,10,2025-03-18,6,286,362,76,456
876,18,2,2025-03-10,10,165,202,37,370
670,3,18,2025-03-02,12,393,428,35,420
266,30,3,2025-03-18,7,42,54,12,84
923,17,23,2025-03-20,15,285,305,20,300
291,9,29,2025-03-11,18,232,272,40,720
185,18,7,2025-03-29,7,498,652,154,1078
1000,14,8,2025-03-01,6,492,576,84,504
633,16,2,2025-03-11,10,286,392,106,1060
203,16,5,2025-03-29,12,375,454,79,948
332,28,18,2025-03-12,20,395,423,28,560
656,22,21,2025-03-29,19,111,162,51,969
335,9,7,2025-03-17,11,487,657,170,1870
678,8,16,2025-03-10,18,404,580,176,3168
901,19,8,2025-03-28,11,371,472,101,1111
629,12,28,2025-03-24,14,377,456,79,1106
506,16,28,2025-03-02,19,335,449,114,2166
919,13,18,2025-03-05,18,464,548,84,1512
939,30,16,2025-03-03,9,166,183,17,153
182,16,12,2025-03-05,12,380,411,31,372
814,22,28,2025-03-07,12,59,74,15,180
988,30,22,2025-03-21,14,47,64,17,238
981,23,6,2025-03-17,8,50,75,25,200
536,6,6,2025-03-02,1,300,448,148,148
798,4,8,2025-03-11,2,295,406,111,222
923,8,16,2025-03-26,13,196,222,26,338
49,5,14,2025-03-30,8,459,589,130,1040
833,9,20,2025-03-28,3,414,553,139,417
549,3,1,2025-03-18,20,65,79,14,280
695,29,25,2025-03-23,15,439,565,126,1890
466,2,2,2025-03-08,3,342,385,43,129
881,13,25,2025-03-27,7,127,163,36,252
884,27,3,2025-03-29,10,327,351,24,240
480,25,18,2025-03-29,15,267,318,51,765
95,5,14,2025-03-16,8,76,100,24,192
435,12,17,2025-03-07,13,187,226,39,507
363,4,21,2025-03-02,13,400,435,35,455
532,9,18,2025-03-12,11,388,493,105,1155
580,30,3,2025-03-18,11,480,511,31,341
426,14,24,2025-03-24,13,394,494,100,1300
290,10,25,2025-03-25,12,488,692,204,2448
496,29,8,2025-03-19,16,192,259,67,1072
83,9,11,2025-03-08,7,413,448,35,245
217,23,18,2025-03-11,19,496,716,220,4180
719,30,28,2025-03-14,2,264,367,103,206
459,30,11,2025-03-02,1,251,269,18,18
96,13,17,2025-03-05,11,114,166,52,572
651,30,5,2025-03-22,4,402,584,182,728
933,19,3,2025-03-12,11,284,417,133,1463
625,20,13,2025-03-28,16,178,260,82,1312
550,3,10,2025-03-28,9,91,127,36,324
385,9,19,2025-03-27,2,69,76,7,14
636,15,26,2025-03-26,2,438,612,174,348
132,13,21,2025-03-30,20,53,77,24,480
328,14,4,2025-03-10,2,25,37,12,24
561,7,6,2025-03-11,18,159,219,60,1080
365,19,11,2025-03-14,20,258,302,44,880
71,1,26,2025-03-14,10,45,51,6,60
821,9,14,2025-03-06,11,195,238,43,473
795,5,6,2025-03-20,11,178,202,24,264
856,14,15,2025-03-17,9,438,630,192,1728
557,27,21,2025-03-17,12,150,216,66,792
770,29,24,2025-03-17,8,46,64,18,144
986,12,22,2025-03-01,6,429,607,178,1068
45,5,21,2025-03-01,3,442,489,47,141
229,23,15,2025-03-06,4,434,636,202,808
238,18,29,2025-03-17,2,27,36,9,18
530,26,5,2025-03-06,4,221,300,79,316
228,20,7,2025-03-16,6,451,481,30,180
76,16,21,2025-03-12,8,380,518,138,1104
678,19,25,2025-03-13,14,207,249,42,588
39,2,23,2025-03-01,17,486,571,85,1445
550,30,22,2025-03-16,9,37,54,17,153
707,20,26,2025-03-18,11,371,453,82,902
19,11,12,2025-03-08,15,153,199,46,690
865,5,1,2025-03-14,1,109,162,53,53
455,1,16,2025-03-24,15,344,441,97,1455
947,6,14,2025-03-21,13,321,465,144,1872
375,23,20,2025-03-27,16,293,435,142,2272
806,11,12,2025-03-23,20,170,246,76,1520
914,11,18,2025-03-11,17,160,231,71,1207
675,13,25,2025-03-07,19,101,133,32,608
31,24,6,2025-03-30,11,436,477,41,451
631,26,16,2025-03-23,9,453,675,222,1998
306,11,25,2025-03-19,4,154,204,50,200
888,6,25,2025-03-18,9,445,539,94,846
487,9,3,2025-03-18,12,94,135,41,492
754,2,28,2025-03-02,20,233,314,81,1620
541,20,9,2025-03-06,5,313,357,44,220
260,16,3,2025-03-23,12,419,443,24,288
3,16,20,2025-03-11,16,341,375,34,544
458,20,7,2025-03-21,11,493,571,78,858
72,21,30,2025-03-10,20,399,497,98,1960
997,24,8,2025-03-09,6,71,86,15,90
991,9,9,2025-03-20,10,135,161,26,260
137,16,23,2025-03-04,10,93,136,43,430
598,13,3,2025-03-16,4,349,479,130,520
970,8,16,2025-03-13,3,57,65,8,24
582,10,12,2025-03-13,3,300,342,42,126
779,15,16,2025-03-29,19,402,582,180,3420
506,8,14,2025-03-27,12,243,307,64,768
756,13,16,2025-03-10,8,84,115,31,248
657,17,15,2025-03-17,16,173,251,78,1248
470,17,20,2025-03-17,10,269,380,111,1110
581,4,11,2025-03-13,3,323,377,54,162
53,1,22,2025-03-23,4,178,206,28,112
546,28,4,2025-03-05,20,490,626,136,2720
727,25,30,2025-03-25,7,395,497,102,714
89,15,11,2025-03-28,4,438,483,45,180
379,15,30,2025-03-06,3,58,67,9,27
737,2,24,2025-03-11,6,403,424,21,126
878,28,4,2025-03-07,11,56,66,10,110
856,3,4,2025-03-07,20,191,266,75,1500
406,15,20,2025-03-14,7,423,460,37,259
118,27,8,2025-03-20,8,165,179,14,112
652,28,2,2025-03-14,13,374,524,150,1950
848,30,29,2025-03-05,14,167,203,36,504
609,11,19,2025-03-07,16,114,143,29,464
266,13,25,2025-03-11,11,49,60,11,121
382,22,29,2025-03-19,9,152,187,35,315
976,17,30,2025-03-06,8,79,113,34,272
893,2,5,2025-03-18,8,106,134,28,224
606,8,16,2025-03-11,9,274,322,48,432
924,25,15,2025-03-28,11,262,370,108,1188
770,21,26,2025-03-04,9,335,478,143,1287
124,22,19,2025-03-28,8,289,381,92,736
51,19,25,2025-03-06,8,137,188,51,408
77,24,27,2025-03-23,16,26,34,8,128
553,18,15,2025-03-24,11,481,535,54,594
741,9,18,2025-03-31,2,387,464,77,154
252,11,23,2025-03-01,14,151,201,50,700
384,7,16,2025-03-02,19,456,536,80,1520
629,23,5,2025-03-05,9,80,88,8,72
495,23,28,2025-03-17,18,396,558,162,2916
170,21,8,2025-03-19,8,347,505,158,1264
486,20,25,2025-03-24,1,316,424,108,108
976,29,28,2025-03-22,7,450,590,140,980
465,12,1,2025-03-05,15,58,78,20,300
135,18,23,2025-03-22,18,406,486,80,1440
729,25,8,2025-03-14,5,145,170,25,125
958,26,30,2025-03-04,1,184,237,53,53
70,2,25,2025-03-16,9,330,349,19,171
65,20,3,2025-03-21,6,358,483,125,750
755,6,27,2025-03-29,13,157,208,51,663
953,18,12,2025-03-02,11,386,499,113,1243
812,1,26,2025-03-28,5,210,299,89,445
888,14,26,2025-03-08,10,86,93,7,70
393,12,7,2025-03-19,5,428,489,61,305
725,25,20,2025-03-17,20,432,528,96,1920
785,18,27,2025-03-30,2,391,510,119,238
345,23,26,2025-03-02,14,80,119,39,546
502,25,1,2025-03-08,13,388,520,132,1716
231,4,25,2025-03-09,15,163,228,65,975
187,26,19,2025-03-09,11,346,406,60,660
166,26,20,2025-03-09,8,410,434,24,192
755,15,4,2025-03-30,7,262,379,117,819
29,21,25,2025-03-10,17,190,236,46,782
191,18,2,2025-03-21,5,432,497,65,325
740,26,6,2025-03-01,17,470,631,161,2737
134,7,8,2025-03-05,19,188,217,29,551
636,29,26,2025-03-03,17,352,416,64,1088
36,7,16,2025-03-23,4,330,390,60,240
29,25,5,2025-03-09,6,440,507,67,402
460,14,16,2025-03-07,18,370,405,35,630
494,23,12,2025-03-25,19,216,237,21,399
818,2,9,2025-03-26,17,457,641,184,3128
731,28,1,2025-03-29,14,405,458,53,742
240,8,19,2025-03-05,4,277,309,32,128
957,14,19,2025-03-23,10,197,214,17,170
587,11,15,2025-03-04,7,478,564,86,602
810,26,6,2025-03-05,19,81,114,33,627
687,27,25,2025-03-10,15,398,455,57,855
542,1,3,2025-03-15,5,388,432,44,220
407,16,26,2025-03-28,3,257,272,15,45
61,8,4,2025-03-13,2,307,453,146,292
272,3,8,2025-03-17,6,96,132,36,216
737,16,5,2025-03-19,17,333,448,115,1955
215,5,8,2025-03-11,8,230,294,64,512
305,19,19,2025-03-24,5,29,33,4,20
210,7,5,2025-03-03,3,46,58,12,36
961,6,17,2025-03-04,14,131,174,43,602
199,26,18,2025-03-14,2,44,47,3,6
380,12,28,2025-03-24,16,90,101,11,176
801,24,27,2025-03-06,13,47,61,14,182
196,18,5,2025-03-31,15,227,332,105,1575
966,12,25,2025-03-25,12,399,526,127,1524
13,4,17,2025-03-17,17,301,443,142,2414
848,8,13,2025-03-10,10,95,117,22,220
891,27,30,2025-03-02,7,179,255,76,532
308,10,11,2025-03-26,18,267,281,14,252
35,2,19,2025-03-25,2,447,600,153,306
727,13,17,2025-03-12,3,316,351,35,105
78,5,11,2025-03-30,12,45,53,8,96
482,24,8,2025-03-19,10,244,257,13,130
470,16,16,2025-03-07,3,92,113,21,63
637,19,26,2025-03-05,9,200,218,18,162
958,28,22,2025-03-29,14,162,201,39,546
622,25,9,2025-03-29,17,226,330,104,1768
156,16,14,2025-03-26,17,448,607,159,2703
41,10,14,2025-03-28,13,270,330,60,780
613,11,25,2025-03-15,11,442,544,102,1122
529,8,27,2025-03-21,7,32,34,2,14
983,11,7,2025-03-02,13,264,320,56,728
883,12,9,2025-03-13,17,292,347,55,935
619,8,30,2025-03-05,20,105,116,11,220
459,18,26,2025-03-28,1,36,40,4,4
845,10,18,2025-03-13,10,65,69,4,40
243,27,18,2025-03-17,20,399,486,87,1740
121,26,27,2025-03-18,20,231,338,107,2140
277,17,21,2025-03-17,3,43,64,21,63
374,23,7,2025-03-31,16,44,56,12,192
381,1,9,2025-03-03,14,91,99,8,112
798,29,14,2025-03-11,4,84,118,34,136
787,29,30,2025-03-09,15,27,32,5,75
319,16,19,2025-03-22,3,471,495,24,72
746,23,17,2025-03-29,6,360,480,120,720
29,8,12,2025-03-03,10,225,259,34,340
968,13,4,2025-03-04,15,184,202,18,270
960,7,15,2025-03-21,7,104,150,46,322
166,5,20,2025-03-04,13,31,43,12,156
571,23,25,2025-03-29,8,433,647,214,1712
792,23,9,2025-03-31,2,79,87,8,16
893,10,22,2025-03-30,7,133,194,61,427
556,10,18,2025-03-30,10,22,30,8,80
166,30,17,2025-03-18,12,469,677,208,2496
623,7,9,2025-03-14,2,258,333,75,150
701,18,3,2025-03-22,1,317,380,63,63
940,30,27,2025-03-13,1,54,60,6,6
289,14,23,2025-03-03,6,364,445,81,486
188,20,1,2025-03-29,1,46,59,13,13
277,9,1,2025-03-30,15,29,41,12,180
454,27,21,2025-03-30,13,423,517,94,1222
439,22,29,2025-03-07,3,449,557,108,324
856,5,17,2025-03-11,11,389,450,61,671
343,10,26,2025-03-05,13,430,587,157,2041
873,5,2,2025-03-03,1,231,318,87,87
582,20,1,2025-03-18,4,224,238,14,56
895,6,18,2025-03-29,13,48,61,13,169
729,24,8,2025-03-24,1,494,544,50,50
16,8,8,2025-03-09,13,351,410,59,767
995,15,23,2025-03-30,18,378,512,134,2412
229,17,13,2025-03-23,14,229,279,50,700
675,20,28,2025-03-20,20,250,263,13,260
398,6,22,2025-03-01,9,252,355,103,927
596,9,23,2025-03-09,19,318,475,157,2983
28,2,22,2025-03-07,4,344,396,52,208
106,28,25,2025-03-11,12,117,136,19,228
267,27,26,2025-03-03,16,442,628,186,2976
425,25,19,2025-03-04,16,106,123,17,272
39,29,8,2025-03-28,7,228,303,75,525
422,20,19,2025-03-22,15,363,396,33,495
614,19,13,2025-03-18,9,272,293,21,189
545,16,25,2025-03-21,6,167,250,83,498
936,11,5,2025-03-05,19,27,34,7,133
302,15,26,2025-03-28,9,165,207,42,378
41,2,8,2025-03-18,3,121,168,47,141
275,29,6,2025-03-23,12,229,310,81,972
155,18,1,2025-03-11,10,289,350,61,610
742,27,5,2025-03-26,2,191,283,92,184
309,24,15,2025-03-29,9,274,411,137,1233
101,6,26,2025-03-22,9,469,635,166,1494
142,26,3,2025-03-12,9,195,220,25,225
987,2,13,2025-03-14,11,65,74,9,99
207,20,7,2025-03-27,12,169,189,20,240
930,3,17,2025-03-04,5,110,134,24,120
678,29,26,2025-03-29,16,376,423,47,752
725,23,15,2025-03-03,19,417,583,166,3154
770,10,2,2025-03-23,20,421,527,106,2120
570,16,7,2025-03-25,10,492,574,82,820
748,19,29,2025-03-25,18,122,182,60,1080
318,3,6,2025-03-29,15,124,164,40,600
460,12,5,2025-03-31,11,215,252,37,407
687,12,6,2025-03-18,10,234,253,19,190
300,4,26,2025-03-21,10,191,207,16,160
317,2,10,2025-03-14,8,369,484,115,920
324,25,17,2025-03-23,4,99,127,28,112
190,23,30,2025-03-03,4,391,556,165,660
764,20,21,2025-03-07,14,105,116,11,154
39,14,6,2025-03-20,6,194,280,86,516
917,24,4,2025-03-13,15,70,86,16,240
985,3,26,2025-03-14,10,327,411,84,840
262,24,16,2025-03-07,16,483,584,101,1616
555,2,18,2025-03-24,18,372,410,38,684
17,1,26,2025-03-19,18,345,389,44,792
233,10,19,2025-03-20,18,198,263,65,1170
466,2,19,2025-03-21,19,158,234,76,1444
718,27,16,2025-03-14,1,279,349,70,70
882,10,7,2025-03-26,19,247,353,106,2014
77,18,1,2025-03-15,16,189,204,15,240
611,3,7,2025-03-16,1,37,44,7,7
382,15,18,2025-03-26,9,132,181,49,441
748,9,25,2025-03-07,13,320,445,125,1625
695,22,3,2025-03-31,7,94,120,26,182
348,24,13,2025-03-24,3,325,398,73,219
673,19,11,2025-03-09,8,441,498,57,456
315,30,13,2025-03-24,17,111,140,29,493
768,27,12,2025-03-29,20,290,366,76,1520
14,23,23,2025-03-20,14,45,48,3,42
440,3,30,2025-03-22,8,31,37,6,48
214,26,14,2025-03-02,2,63,72,9,18
865,22,3,2025-03-17,2,265,358,93,186
668,10,7,2025-03-27,11,252,325,73,803
117,18,25,2025-03-21,8,477,580,103,824
686,22,19,2025-03-26,19,279,411,132,2508
776,1,21,2025-03-25,6,244,280,36,216
572,6,20,2025-03-03,12,22,29,7,84
206,1,5,2025-03-10,1,421,577,156,156
264,2,7,2025-03-18,1,248,299,51,51
67,4,27,2025-03-27,14,25,35,10,140
505,27,18,2025-03-09,3,79,90,11,33
344,30,18,2025-03-10,19,118,158,40,760
565,8,7,2025-03-07,10,73,107,34,340
236,18,22,2025-03-07,18,262,326,64,1152
586,25,4,2025-03-02,20,278,316,38,760
556,1,6,2025-03-15,17,27,40,13,221
386,8,15,2025-03-22,3,73,100,27,81
450,19,18,2025-03-06,5,214,259,45,225
666,1,10,2025-03-24,11,154,168,14,154
774,25,18,2025-03-04,16,273,302,29,464
726,24,16,2025-03-20,18,26,28,2,36
286,12,16,2025-03-14,16,463,530,67,1072
919,6,29,2025-03-11,6,247,271,24,144
302,8,25,2025-03-06,8,339,425,86,688
432,10,4,2025-03-09,7,153,229,76,532
479,18,6,2025-03-22,2,311,389,78,156
783,6,10,2025-03-25,17,190,274,84,1428
877,9,22,2025-03-23,14,94,104,10,140
763,14,6,2025-03-10,18,211,291,80,1440
392,24,16,2025-03-30,19,308,335,27,513
552,9,2,2025-03-10,6,250,279,29,174
60,5,11,2025-03-25,4,88,128,40,160
268,5,16,2025-03-29,5,401,442,41,205
698,12,20,2025-03-18,15,291,410,119,1785
986,22,16,2025-03-11,3,42,62,20,60
862,12,25,2025-03-06,16,402,502,100,1600
633,15,1,2025-03-04,13,146,186,40,520
444,17,28,2025-03-19,1,239,325,86,86
960,24,16,2025-03-20,10,291,347,56,560
934,22,15,2025-03-26,14,52,68,16,224
312,21,27,2025-03-20,20,246,278,32,640
541,5,29,2025-03-26,4,288,432,144,576
304,9,12,2025-03-30,20,482,575,93,1860
890,14,23,2025-03-03,16,300,362,62,992
504,6,10,2025-03-15,13,71,94,23,299
450,3,12,2025-03-22,2,117,163,46,92
567,15,13,2025-03-14,13,32,41,9,117
525,30,28,2025-03-05,4,413,460,47,188
161,30,20,2025-03-13,15,264,330,66,990
504,14,16,2025-03-18,4,47,56,9,36
574,28,30,2025-03-18,8,141,207,66,528
336,15,21,2025-03-13,9,296,349,53,477
471,26,1,2025-03-23,12,371,543,172,2064
86,2,10,2025-03-13,17,432,581,149,2533
434,2,8,2025-03-19,11,466,502,36,396
940,28,19,2025-03-24,19,189,245,56,1064
868,20,27,2025-03-09,8,404,573,169,1352
926,10,6,2025-03-06,18,31,34,3,54
312,3,24,2025-03-07,5,34,42,8,40
633,23,5,2025-03-09,8,74,83,9,72
394,14,23,2025-03-08,3,393,552,159,477
266,17,19,2025-03-09,19,348,508,160,3040
715,1,20,2025-03-29,14,321,376,55,770
418,21,3,2025-03-02,5,485,528,43,215
111,22,8,2025-03-21,19,329,436,107,2033
941,24,30,2025-03-10,19,146,162,16,304
262,3,28,2025-03-05,6,384,409,25,150
744,30,12,2025-03-29,3,77,107,30,90
834,17,30,2025-03-25,5,401,489,88,440
162,18,27,2025-03-29,6,203,215,12,72
562,13,21,2025-03-11,20,231,338,107,2140
219,4,20,2025-03-08,15,496,678,182,2730
434,27,12,2025-03-20,4,247,311,64,256
897,22,7,2025-03-07,5,42,51,9,45
571,22,14,2025-03-29,8,461,572,111,888
874,27,23,2025-03-08,13,253,311,58,754
958,14,23,2025-03-08,5,122,140,18,90
789,1,4,2025-03-21,12,53,74,21,252
893,14,12,2025-03-31,6,137,173,36,216
432,26,18,2025-03-07,18,278,362,84,1512
609,4,15,2025-03-16,9,351,384,33,297
358,28,9,2025-03-23,9,315,448,133,1197
151,20,1,2025-03-10,12,177,194,17,204
538,1,8,2025-03-12,14,385,571,186,2604
898,18,26,2025-03-11,11,414,450,36,396
543,27,18,2025-03-27,15,490,605,115,1725
870,11,18,2025-03-22,2,437,596,159,318
219,4,17,2025-03-19,8,92,137,45,360
123,3,3,2025-03-10,13,329,452,123,1599
438,1,10,2025-03-21,9,208,294,86,774
665,19,4,2025-03-07,13,122,138,16,208
446,18,16,2025-03-15,17,195,249,54,918
483,13,15,2025-03-28,12,343,422,79,948
861,14,30,2025-03-10,17,185,272,87,1479
296,17,7,2025-03-15,5,494,523,29,145
224,16,8,2025-03-18,12,346,403,57,684
875,29,14,2025-03-29,4,185,202,17,68
961,22,23,2025-03-18,10,218,259,41,410
771,14,2,2025-03-25,10,329,419,90,900
136,9,25,2025-03-23,7,360,473,113,791
322,16,26,2025-03-12,11,454,503,49,539
911,4,3,2025-03-24,7,476,508,32,224
772,23,19,2025-03-04,7,44,59,15,105
299,16,2,2025-03-03,1,143,197,54,54
140,15,21,2025-03-26,5,223,304,81,405
66,29,2,2025-03-24,3,20,26,6,18
345,25,10,2025-03-29,19,71,85,14,266
742,11,11,2025-03-28,18,461,623,162,2916
728,22,6,2025-03-26,10,364,546,182,1820
749,24,21,2025-03-30,3,439,657,218,654
28,22,18,2025-03-25,9,306,444,138,1242
980,16,2,2025-03-06,1,148,162,14,14
391,4,18,2025-03-23,13,131,170,39,507
935,26,5,2025-03-20,17,385,454,69,1173
105,6,30,2025-03-19,20,242,258,16,320
408,18,16,2025-03-28,13,393,463,70,910
799,19,15,2025-03-24,15,331,350,19,285
859,19,10,2025-03-05,1,385,539,154,154
700,21,23,2025-03-31,3,383,523,140,420
226,17,27,2025-03-14,8,453,527,74,592
835,8,2,2025-03-06,8,259,365,106,848
263,13,15,2025-03-09,15,218,233,15,225
532,12,28,2025-03-09,19,316,423,107,2033
941,13,28,2025-03-06,7,387,457,70,490
72,18,20,2025-03-01,15,409,490,81,1215
181,29,27,2025-03-27,20,451,666,215,4300
53,1,24,2025-03-05,8,292,367,75,600
277,26,9,2025-03-30,13,387,437,50,650
726,11,2,2025-03-29,6,460,504,44,264
462,6,17,2025-03-01,14,229,320,91,1274
744,27,10,2025-03-28,5,302,318,16,80
59,12,6,2025-03-11,14,126,161,35,490
80,14,10,2025-03-03,14,376,422,46,644
370,28,28,2025-03-28,6,36,44,8,48
703,13,25,2025-03-03,3,135,169,34,102
770,15,1,2025-03-10,7,337,460,123,861
326,12,11,2025-03-26,18,246,352,106,1908
197,13,9,2025-03-27,8,253,281,28,224
32,19,28,2025-03-10,7,349,516,167,1169
573,6,24,2025-03-31,9,291,415,124,1116
810,4,28,2025-03-28,12,482,580,98,1176
403,24,4,2025-03-25,6,140,170,30,180
769,17,18,2025-03-10,3,494,584,90,270
288,4,13,2025-03-21,11,137,184,47,517
989,2,2,2025-03-10,4,426,639,213,852
105,8,16,2025-03-28,17,481,690,209,3553
209,16,9,2025-03-15,9,21,31,10,90
178,3,23,2025-03-24,6,479,518,39,234
882,16,11,2025-03-12,18,420,441,21,378
427,8,9,2025-03-14,20,31,35,4,80
4,30,9,2025-03-29,7,357,396,39,273
813,4,6,2025-03-01,13,150,182,32,416
914,19,26,2025-03-25,7,195,249,54,378
111,1,13,2025-03-01,12,303,416,113,1356
145,25,8,2025-03-30,10,366,548,182,1820
677,22,21,2025-03-12,18,112,152,40,720
52,13,1,2025-03-31,16,364,427,63,1008
659,16,4,2025-03-16,13,321,369,48,624
203,3,19,2025-03-15,4,71,106,35,140
276,11,11,2025-03-09,20,417,601,184,3680
503,3,6,2025-03-05,3,49,65,16,48
918,13,25,2025-03-15,11,61,82,21,231
427,25,12,2025-03-12,9,491,704,213,1917
941,23,1,2025-03-22,7,418,527,109,763
301,27,9,2025-03-09,13,141,201,60,780
78,2,27,2025-03-12,1,139,165,26,26
893,3,20,2025-03-21,20,88,124,36,720
161,23,4,2025-03-01,5,306,422,116,580
16,3,23,2025-03-10,1,224,257,33,33
234,6,4,2025-03-26,9,449,647,198,1782
906,17,30,2025-03-02,6,164,181,17,102
512,1,8,2025-03-31,17,409,458,49,833
38,3,20,2025-03-03,13,167,232,65,845
290,7,15,2025-03-19,19,195,217,22,418
748,29,12,2025-03-11,6,279,323,44,264
782,26,21,2025-03-25,5,256,355,99,495
366,3,11,2025-03-01,9,341,434,93,837
397,9,28,2025-03-06,7,53,65,12,84
811,7,20,2025-03-24,12,344,497,153,1836
581,12,30,2025-03-05,11,175,257,82,902
778,21,6,2025-03-25,18,339,508,169,3042
783,10,26,2025-03-22,13,206,261,55,715
148,28,15,2025-03-11,13,498,561,63,819
33,3,23,2025-03-10,9,305,433,128,1152
617,6,27,2025-03-18,9,342,476,134,1206
972,15,26,2025-03-25,1,130,178,48,48
764,16,5,2025-03-29,2,418,522,104,208
321,22,22,2025-03-30,11,213,235,22,242
402,24,7,2025-03-14,4,203,220,17,68
661,24,5,2025-03-17,8,340,373,33,264
56,16,25,2025-03-10,7,383,460,77,539
368,11,11,2025-03-25,12,254,283,29,348
480,9,15,2025-03-31,16,138,175,37,592
494,19,4,2025-03-13,10,80,105,25,250
37,29,2,2025-03-13,10,202,267,65,650
489,27,8,2025-03-15,18,340,382,42,756
681,16,28,2025-03-01,20,123,138,15,300
562,24,15,2025-03-06,15,425,495,70,1050
748,28,15,2025-03-27,13,423,528,105,1365
875,5,25,2025-03-07,10,148,219,71,710
796,12,16,2025-03-23,5,92,136,44,220
747,19,30,2025-03-11,12,288,361,73,876
586,8,13,2025-03-10,18,364,425,61,1098
630,17,9,2025-03-21,16,124,184,60,960
235,24,17,2025-03-01,10,353,525,172,1720
734,30,23,2025-03-02,10,445,482,37,370
943,2,6,2025-03-22,20,39,44,5,100
90,22,26,2025-03-21,6,321,462,141,846
389,2,13,2025-03-19,16,366,504,138,2208
82,24,18,2025-03-19,14,118,133,15,210
796,25,15,2025-03-15,14,424,488,64,896
600,17,12,2025-03-25,14,434,507,73,1022
707,24,3,2025-03-29,11,347,512,165,1815
477,18,27,2025-03-07,2,188,239,51,102
170,2,5,2025-03-04,19,180,193,13,247
81,1,29,2025-03-15,9,236,336,100,900
122,27,2,2025-03-30,4,346,416,70,280
594,5,3,2025-03-27,10,472,656,184,1840
194,18,20,2025-03-09,15,268,373,105,1575
160,4,13,2025-03-28,12,402,492,90,1080
464,27,4,2025-03-05,6,79,111,32,192
449,22,14,2025-03-09,2,381,509,128,256
389,18,16,2025-03-12,9,350,408,58,522
401,21,23,2025-03-27,8,284,305,21,168
209,6,15,2025-03-15,7,320,375,55,385
473,23,30,2025-03-10,17,284,325,41,697
129,8,18,2025-03-24,11,321,388,67,737
612,26,28,2025-03-30,7,361,479,118,826
802,28,23,2025-03-27,12,498,745,247,2964
553,1,30,2025-03-27,9,361,476,115,1035
965,19,17,2025-03-30,1,87,93,6,6
49,18,4,2025-03-30,16,258,318,60,960
338,20,19,2025-03-23,20,269,320,51,1020
718,2,27,2025-03-15,12,118,158,40,480
983,30,18,2025-03-27,19,32,42,10,190
218,24,19,2025-03-15,11,482,672,190,2090
885,21,9,2025-03-23,5,281,309,28,140
691,12,28,2025-03-18,3,434,543,109,327
12,15,30,2025-03-24,15,23,32,9,135
174,29,13,2025-03-04,12,103,141,38,456
302,15,9,2025-03-22,18,80,96,16,288
797,1,27,2025-03-22,14,392,529,137,1918
487,18,24,2025-03-15,11,99,135,36,396
783,27,24,2025-03-24,19,174,261,87,1653
83,15,7,2025-03-23,18,170,225,55,990
137,6,9,2025-03-13,1,362,463,101,101
341,24,19,2025-03-29,3,49,64,15,45
566,27,26,2025-03-29,11,145,210,65,715
441,3,19,2025-03-12,6,439,554,115,690
409,28,13,2025-03-07,12,346,441,95,1140
368,19,16,2025-03-27,5,83,119,36,180
158,3,30,2025-03-04,5,140,148,8,40
624,13,2,2025-03-10,8,362,508,146,1168
537,30,4,2025-03-06,3,408,441,33,99
524,14,9,2025-03-09,5,349,416,67,335
695,11,27,2025-03-20,4,382,457,75,300
316,25,12,2025-03-28,18,432,603,171,3078
179,7,21,2025-03-31,16,468,615,147,2352
957,28,30,2025-03-26,16,236,321,85,1360
828,20,5,2025-03-06,1,203,288,85,85
514,25,19,2025-03-23,5,72,92,20,100
159,7,9,2025-03-03,16,133,169,36,576
659,1,25,2025-03-22,17,325,479,154,2618
7,10,15,2025-03-13,4,110,157,47,188
570,16,1,2025-03-26,2,123,171,48,96
433,6,28,2025-03-06,20,213,298,85,1700
316,16,19,2025-03-05,1,48,56,8,8
612,25,22,2025-03-02,16,294,427,133,2128
491,11,11,2025-03-01,11,365,543,178,1958
637,20,20,2025-03-06,18,370,437,67,1206
910,20,6,2025-03-15,5,176,256,80,400
768,29,3,2025-03-08,8,231,336,105,840
71,20,15,2025-03-28,10,265,297,32,320
791,7,11,2025-03-22,18,389,542,153,2754
601,5,7,2025-03-22,16,121,139,18,288
783,21,13,2025-03-08,3,197,286,89,267
593,6,26,2025-03-23,20,324,424,100,2000
26,12,18,2025-03-06,19,180,218,38,722
250,6,25,2025-03-25,19,163,172,9,171
642,10,3,2025-03-22,14,438,554,116,1624
418,6,13,2025-03-30,20,75,85,10,200
838,7,23,2025-03-26,12,420,600,180,2160
978,18,8,2025-03-10,13,327,479,152,1976
206,17,3,2025-03-15,11,93,127,34,374
200,8,7,2025-03-18,2,173,234,61,122
149,12,1,2025-03-13,11,434,537,103,1133
928,14,3,2025-03-06,19,243,307,64,1216
279,17,23,2025-03-22,11,400,441,41,451
466,16,19,2025-03-16,17,275,392,117,1989
836,30,11,2025-03-23,14,115,147,32,448
284,21,19,2025-03-22,12,130,186,56,672
134,13,14,2025-03-04,13,405,573,168,2184
692,24,7,2025-03-18,11,252,369,117,1287
492,24,3,2025-03-16,3,126,178,52,156
27,10,15,2025-03-06,13,321,365,44,572
689,20,20,2025-03-22,7,361,409,48,336
142,19,3,2025-03-25,12,109,147,38,456
462,21,16,2025-03-05,4,202,233,31,124
96,29,21,2025-03-30,12,331,364,33,396
616,13,2,2025-03-28,13,293,436,143,1859
429,11,29,2025-03-03,1,262,376,114,114
705,23,26,2025-03-31,16,264,366,102,1632
707,4,1,2025-03-06,9,29,31,2,18
744,20,27,2025-03-28,8,445,566,121,968
564,27,19,2025-03-13,16,450,475,25,400
272,28,26,2025-03-27,2,175,214,39,78
312,17,4,2025-03-02,19,320,409,89,1691
304,10,16,2025-03-22,12,266,354,88,1056
716,10,14,2025-03-02,17,423,539,116,1972
488,9,19,2025-03-30,12,73,87,14,168
81,16,17,2025-03-24,1,331,380,49,49
882,7,10,2025-03-28,6,468,542,74,444
631,28,2,2025-03-25,12,486,609,123,1476
743,20,23,2025-03-09,17,343,440,97,1649
728,10,3,2025-03-16,5,113,156,43,215
892,2,8,2025-03-12,11,430,551,121,1331
37,17,26,2025-03-17,19,352,387,35,665
941,27,20,2025-03-28,17,170,254,84,1428
102,2,1,2025-03-25,17,339,387,48,816
353,9,21,2025-03-08,3,160,191,31,93
39,28,12,2025-03-10,6,376,417,41,246
716,13,26,2025-03-06,12,37,55,18,216
535,2,27,2025-03-01,19,241,265,24,456
367,28,2,2025-03-12,16,89,94,5,80
661,10,2,2025-03-24,18,232,285,53,954
948,7,11,2025-03-16,7,354,466,112,784
644,1,4,2025-03-24,6,353,433,80,480
889,21,19,2025-03-03,5,24,26,2,10
649,25,8,2025-03-06,13,113,132,19,247
54,21,4,2025-03-02,9,461,600,139,1251
793,3,25,2025-03-23,5,146,197,51,255
36,22,2,2025-03-26,18,305,451,146,2628
972,26,22,2025-03-04,16,195,291,96,1536
538,10,1,2025-03-31,1,407,452,45,45
89,23,16,2025-03-19,17,327,455,128,2176
34,17,15,2025-03-29,17,129,181,52,884
389,12,17,2025-03-09,10,314,467,153,1530
662,21,30,2025-03-17,12,318,436,118,1416
250,9,21,2025-03-27,13,172,201,29,377
121,22,17,2025-03-23,18,451,613,162,2916
576,17,18,2025-03-17,5,311,383,72,360
409,16,17,2025-03-21,7,320,432,112,784
628,15,20,2025-03-10,1,263,351,88,88
912,12,21,2025-03-22,20,163,243,80,1600
919,10,30,2025-03-11,17,434,483,49,833
924,15,1,2025-03-30,4,445,580,135,540
615,7,23,2025-03-16,5,422,497,75,375
851,27,1,2025-03-27,2,211,231,20,40
1000,23,17,2025-03-25,6,400,498,98,588
191,11,30,2025-03-01,6,83,94,11,66
985,12,12,2025-03-21,19,80,115,35,665
743,25,28,2025-03-20,8,274,348,74,592
970,9,6,2025-03-31,12,396,545,149,1788
26,16,4,2025-03-11,5,21,24,3,15
509,26,22,2025-03-26,6,298,397,99,594
333,25,17,2025-03-29,16,308,410,102,1632
240,23,21,2025-03-21,10,125,147,22,220
99,4,5,2025-03-17,9,459,638,179,1611
506,4,19,2025-03-30,10,58,79,21,210
310,3,15,2025-03-16,11,150,172,22,242
847,27,4,2025-03-30,14,400,519,119,1666
620,23,29,2025-03-06,15,154,184,30,450
932,1,22,2025-03-31,4,48,66,18,72
115,25,9,2025-03-03,20,494,617,123,2460
873,22,16,2025-03-21,10,27,31,4,40
228,27,14,2025-03-29,3,266,375,109,327
393,26,8,2025-03-28,9,389,553,164,1476
278,21,14,2025-03-01,4,191,207,16,64
389,15,6,2025-03-06,5,307,361,54,270
606,17,3,2025-03-12,4,105,119,14,56
903,24,6,2025-03-12,14,431,571,140,1960
537,26,20,2025-03-21,17,212,280,68,1156
368,20,2,2025-03-20,19,116,133,17,323
597,17,16,2025-03-29,1,487,604,117,117
799,2,13,2025-03-31,12,92,107,15,180
389,12,30,2025-03-10,20,114,163,49,980
719,8,11,2025-03-15,5,474,650,176,880
770,26,8,2025-03-26,6,104,110,6,36
249,28,7,2025-03-05,1,415,559,144,144
787,3,21,2025-03-29,16,323,409,86,1376
17,3,30,2025-03-25,8,390,556,166,1328
220,2,18,2025-03-05,2,482,534,52,104
146,14,14,2025-03-25,7,467,623,156,1092
931,28,14,2025-03-15,4,76,82,6,24
641,7,19,2025-03-25,7,217,312,95,665
611,1,17,2025-03-19,16,416,463,47,752
730,25,27,2025-03-31,10,475,622,147,1470
579,7,11,2025-03-26,12,454,667,213,2556
871,12,11,2025-03-06,4,243,300,57,228
956,25,21,2025-03-19,6,270,285,15,90
27,1,26,2025-03-28,3,406,565,159,477
677,4,3,2025-03-27,11,221,271,50,550
742,11,8,2025-03-05,10,87,120,33,330
902,10,13,2025-03-26,3,93,127,34,102
752,23,4,2025-03-17,9,154,167,13,117
18,19,20,2025-03-12,13,402,449,47,611
63,13,4,2025-03-06,1,453,616,163,163
347,16,28,2025-03-01,3,344,467,123,369
351,18,2,2025-03-08,20,318,470,152,3040
745,4,9,2025-03-07,9,370,494,124,1116
776,11,13,2025-03-14,20,340,431,91,1820
369,23,16,2025-03-06,16,316,428,112,1792
915,29,20,2025-03-12,12,349,465,116,1392
685,29,18,2025-03-04,12,169,252,83,996
348,13,19,2025-03-24,16,277,331,54,864
3,11,27,2025-03-15,17,439,556,117,1989
159,30,23,2025-03-01,8,236,273,37,296
531,22,21,2025-03-07,3,236,322,86,258
299,4,1,2025-03-28,5,124,133,9,45
325,27,21,2025-03-23,13,232,276,44,572
11,16,29,2025-03-09,13,231,322,91,1183
212,2,2,2025-03-30,4,206,281,75,300
494,23,8,2025-03-21,9,159,206,47,423
453,1,12,2025-03-31,13,35,47,12,156
681,21,16,2025-03-31,7,471,699,228,1596
545,17,12,2025-03-09,15,117,155,38,570
344,17,19,2025-03-19,17,174,202,28,476
205,8,25,2025-03-20,16,392,449,57,912
90,28,10,2025-03-14,8,451,612,161,1288
7,3,11,2025-03-28,16,327,485,158,2528
151,17,29,2025-03-28,19,406,487,81,1539
367,23,3,2025-03-21,4,274,396,122,488
894,23,21,2025-03-13,13,56,71,15,195
43,29,25,2025-03-14,11,397,448,51,561
76,8,15,2025-03-02,20,476,705,229,4580
512,30,17,2025-03-16,2,460,689,229,458
367,19,11,2025-03-31,1,259,377,118,118
522,5,14,2025-03-03,4,330,456,126,504
213,22,21,2025-03-05,9,362,434,72,648
813,2,8,2025-03-05,3,192,274,82,246
549,7,15,2025-03-20,17,426,605,179,3043
33,5,16,2025-03-09,16,172,217,45,720
751,26,14,2025-03-16,9,330,490,160,1440
596,29,24,2025-03-23,1,138,163,25,25
632,4,18,2025-03-18,8,145,166,21,168
855,2,4,2025-03-30,8,269,331,62,496
754,17,14,2025-03-09,4,124,165,41,164
942,3,18,2025-03-01,18,433,531,98,1764
70,9,6,2025-03-17,18,401,485,84,1512
849,28,28,2025-03-31,5,498,680,182,910
998,18,20,2025-03-19,6,375,498,123,738
320,10,15,2025-03-21,8,350,429,79,632
869,28,17,2025-03-08,10,472,529,57,570
725,16,12,2025-03-24,19,322,465,143,2717
502,6,2,2025-03-24,14,81,121,40,560
45,10,2,2025-03-05,7,180,192,12,84
553,30,21,2025-03-28,3,493,725,232,696
239,25,3,2025-03-26,4,423,464,41,164
482,23,8,2025-03-22,14,348,385,37,518
991,22,28,2025-03-05,11,214,297,83,913
787,22,28,2025-03-05,17,334,457,123,2091
264,12,8,2025-03-15,16,436,618,182,2912
875,3,2,2025-03-23,8,387,552,165,1320
780,30,21,2025-03-28,7,83,112,29,203
628,8,29,2025-03-05,20,185,272,87,1740
673,4,19,2025-03-19,5,174,183,9,45
837,30,7,2025-03-21,17,90,102,12,204
599,6,11,2025-03-31,1,385,551,166,166
973,25,21,2025-03-01,13,220,317,97,1261
884,10,30,2025-03-23,8,138,198,60,480
66,21,16,2025-03-11,5,196,225,29,145
524,2,14,2025-03-16,1,398,586,188,188
250,3,1,2025-03-26,3,432,558,126,378
846,9,29,2025-03-18,7,468,598,130,910
134,1,19,2025-03-26,5,88,132,44,220
457,4,27,2025-03-03,12,349,366,17,204
816,10,21,2025-03-01,20,298,401,103,2060
264,8,21,2025-03-19,1,207,249,42,42
225,21,21,2025-03-17,14,283,364,81,1134
889,7,22,2025-03-09,6,93,102,9,54
479,30,5,2025-03-15,15,439,611,172,2580
824,8,23,2025-03-15,19,343,504,161,3059
591,29,22,2025-03-28,19,323,379,56,1064
591,2,25,2025-03-06,8,102,147,45,360
751,22,23,2025-03-18,8,458,527,69,552
513,22,10,2025-03-05,15,168,204,36,540
996,14,25,2025-03-25,1,354,477,123,123
21,10,13,2025-03-28,15,125,175,50,750
304,12,19,2025-03-09,19,114,170,56,1064
843,23,1,2025-03-24,15,126,139,13,195
957,26,27,2025-03-19,4,284,407,123,492
921,30,5,2025-03-23,6,109,116,7,42
77,12,8,2025-03-08,9,249,285,36,324
886,4,30,2025-03-22,18,422,477,55,990
892,16,11,2025-03-18,2,171,240,69,138
232,6,12,2025-03-20,19,281,354,73,1387
163,27,21,2025-03-05,10,127,148,21,210
276,30,13,2025-03-15,3,292,411,119,357
504,24,20,2025-03-15,4,320,421,101,404
195,27,19,2025-03-17,18,295,412,117,2106
718,10,23,2025-03-17,19,89,127,38,722
495,23,28,2025-03-28,17,156,204,48,816
600,16,3,2025-03-08,19,356,374,18,342
250,17,6,2025-03-03,1,397,574,177,177
428,10,12,2025-03-22,1,64,87,23,23
4,17,30,2025-03-19,9,242,348,106,954
287,16,24,2025-03-11,18,436,473,37,666
268,8,10,2025-03-14,3,417,521,104,312
758,19,5,2025-03-07,13,345,501,156,2028
40,16,12,2025-03-19,1,223,307,84,84
408,19,10,2025-03-11,5,439,462,23,115
2,20,9,2025-03-22,2,467,634,167,334
750,16,15,2025-03-24,10,187,226,39,390
540,22,3,2025-03-29,16,423,531,108,1728
819,17,20,2025-03-11,8,448,639,191,1528
326,7,10,2025-03-02,14,336,440,104,1456
334,18,24,2025-03-25,19,318,346,28,532
48,16,26,2025-03-27,10,413,439,26,260
738,11,12,2025-03-30,9,279,388,109,981
124,16,23,2025-03-31,17,128,169,41,697
308,20,29,2025-03-06,19,121,159,38,722
144,8,24,2025-03-09,7,232,297,65,455
249,20,3,2025-03-07,11,187,214,27,297
971,29,17,2025-03-26,9,226,296,70,630
434,8,11,2025-03-29,15,134,188,54,810
968,26,9,2025-03-27,1,125,160,35,35
167,30,11,2025-03-29,1,379,483,104,104
593,13,20,2025-03-27,8,324,434,110,880
207,9,7,2025-03-15,11,106,156,50,550
573,12,15,2025-03-15,15,43,63,20,300
275,30,28,2025-03-08,14,81,107,26,364
565,7,16,2025-03-10,14,437,541,104,1456
562,10,2,2025-03-03,9,391,533,142,1278
363,5,30,2025-03-31,1,278,336,58,58
427,26,3,2025-03-05,11,22,29,7,77
737,20,21,2025-03-21,17,89,122,33,561
648,8,17,2025-03-25,12,455,676,221,2652
630,24,19,2025-03-20,16,71,99,28,448
806,11,1,2025-03-09,6,82,114,32,192
732,29,7,2025-03-21,13,125,184,59,767
797,13,22,2025-03-28,20,423,576,153,3060
960,11,6,2025-03-23,5,480,536,56,280
907,7,24,2025-03-02,15,388,549,161,2415
792,16,26,2025-03-12,16,224,238,14,224
497,26,24,2025-03-04,9,170,241,71,639
612,6,9,2025-03-11,20,182,224,42,840
397,16,9,2025-03-20,3,265,300,35,105
623,15,26,2025-03-29,12,372,464,92,1104
468,21,29,2025-03-05,3,438,532,94,282
420,4,23,2025-03-16,11,350,418,68,748
139,18,12,2025-03-23,10,296,325,29,290
791,2,5,2025-03-08,11,204,265,61,671
972,3,26,2025-03-30,7,374,446,72,504
647,7,3,2025-03-27,17,419,587,168,2856
591,5,27,2025-03-02,1,344,362,18,18
1,11,14,2025-03-24,18,116,142,26,468
590,19,4,2025-03-27,2,313,386,73,146
959,16,11,2025-03-03,3,250,339,89,267
873,7,11,2025-03-24,8,132,193,61,488
482,2,21,2025-03-22,6,210,251,41,246
927,21,29,2025-03-10,11,368,388,20,220
990,3,15,2025-03-28,3,376,528,152,456
259,4,21,2025-03-15,2,213,242,29,58
96,20,4,2025-03-28,8,436,559,123,984
683,17,16,2025-03-30,16,306,336,30,480
736,18,23,2025-03-08,17,76,93,17,289
24,13,14,2025-03-19,12,304,351,47,564
824,21,20,2025-03-17,13,63,79,16,208
556,16,2,2025-03-27,8,145,214,69,552
909,3,3,2025-03-22,10,257,385,128,1280
115,17,2,2025-03-13,11,47,61,14,154
696,22,26,2025-03-30,18,327,471,144,2592
774,20,6,2025-03-30,20,298,365,67,1340
291,6,19,2025-03-19,3,109,157,48,144
830,14,25,2025-03-14,2,384,573,189,378
240,12,18,2025-03-31,11,228,295,67,737
998,19,27,2025-03-18,15,59,87,28,420
192,10,22,2025-03-23,1,309,419,110,110
766,13,21,2025-03-02,20,469,663,194,3880
937,3,11,2025-03-13,19,325,462,137,2603
996,23,26,2025-03-23,15,453,528,75,1125
723,24,16,2025-03-01,9,58,68,10,90
453,27,20,2025-03-01,4,138,150,12,48
546,9,10,2025-03-05,16,437,469,32,512
826,30,13,2025-03-13,14,266,368,102,1428
136,13,2,2025-03-17,5,50,69,19,95
757,3,5,2025-03-21,6,321,393,72,432
320,24,4,2025-03-20,19,399,531,132,2508
91,10,9,2025-03-20,7,40,58,18,126
304,29,30,2025-03-24,6,469,675,206,1236
340,30,4,2025-03-06,4,61,84,23,92
621,27,23,2025-03-29,13,337,382,45,585
581,9,14,2025-03-16,15,395,486,91,1365
488,28,12,2025-03-13,2,38,55,17,34
919,6,24,2025-03-27,7,462,687,225,1575
187,14,26,2025-03-27,19,56,63,7,133
315,22,30,2025-03-10,15,342,453,111,1665
480,30,20,2025-03-29,11,321,479,158,1738
472,9,22,2025-03-04,1,21,24,3,3
42,18,5,2025-03-28,3,375,509,134,402
594,22,9,2025-03-16,10,212,284,72,720
795,23,7,2025-03-08,14,29,36,7,98
626,19,28,2025-03-26,15,414,579,165,2475
363,13,29,2025-03-27,5,257,330,73,365
393,23,13,2025-03-10,5,323,398,75,375
143,23,29,2025-03-11,15,491,724,233,3495
835,13,24,2025-03-19,1,166,178,12,12
182,5,20,2025-03-13,13,396,592,196,2548
870,17,28,2025-03-22,6,435,568,133,798
66,19,27,2025-03-01,4,239,254,15,60
94,5,19,2025-03-19,13,216,319,103,1339
817,21,1,2025-03-23,7,21,27,6,42
65,24,3,2025-03-03,5,339,477,138,690
96,22,23,2025-03-27,12,446,562,116,1392
364,17,30,2025-03-31,2,101,133,32,64
73,13,22,2025-03-05,11,352,479,127,1397
388,4,9,2025-03-04,9,378,402,24,216
299,18,15,2025-03-07,4,489,615,126,504
693,10,22,2025-03-27,17,221,309,88,1496
856,17,9,2025-03-22,15,181,259,78,1170
15,23,30,2025-03-12,11,442,638,196,2156
31,9,3,2025-03-23,12,200,298,98,1176
77,18,17,2025-03-23,8,437,633,196,1568
663,21,21,2025-03-23,5,370,541,171,855
53,24,26,2025-03-19,9,407,525,118,1062
160,8,28,2025-03-07,11,197,237,40,440
576,20,11,2025-03-30,14,53,57,4,56
982,22,8,2025-03-17,8,50,58,8,64
930,15,22,2025-03-03,4,73,86,13,52
745,15,4,2025-03-22,2,301,409,108,216
507,26,24,2025-03-29,3,345,414,69,207
621,9,16,2025-03-29,7,44,61,17,119
816,30,27,2025-03-04,9,90,107,17,153
306,13,21,2025-03-21,18,71,75,4,72
421,4,26,2025-03-30,9,156,173,17,153
221,19,14,2025-03-12,7,205,217,12,84
121,24,16,2025-03-17,10,35,45,10,100
1000,3,6,2025-03-12,10,357,417,60,600
778,30,29,2025-03-14,7,273,326,53,371
615,22,20,2025-03-30,9,461,635,174,1566
591,3,3,2025-03-04,12,339,430,91,1092
996,17,13,2025-03-31,17,148,172,24,408
414,15,8,2025-03-09,1,34,39,5,5
764,18,16,2025-03-21,15,185,252,67,1005
832,17,5,2025-03-28,1,81,109,28,28
315,25,5,2025-03-20,18,178,236,58,1044
422,4,30,2025-03-13,16,459,565,106,1696
495,9,23,2025-03-12,14,87,118,31,434
932,15,10,2025-03-23,20,172,238,66,1320
169,23,7,2025-03-14,17,276,385,109,1853
6,16,11,2025-03-23,19,320,349,29,551
379,19,4,2025-03-17,11,464,627,163,1793
770,13,21,2025-03-21,19,30,34,4,76
875,22,2,2025-03-01,12,382,450,68,816
956,15,6,2025-03-07,15,109,146,37,555
138,1,29,2025-03-31,1,145,213,68,68
217,6,23,2025-03-20,7,312,365,53,371
3,1,12,2025-03-04,16,338,407,69,1104
990,8,23,2025-03-26,18,342,445,103,1854
794,17,20,2025-03-10,9,370,463,93,837
605,24,16,2025-03-31,19,408,441,33,627
428,25,24,2025-03-19,9,284,390,106,954
606,2,14,2025-03-21,9,404,436,32,288
86,5,4,2025-03-08,1,458,537,79,79
722,15,2,2025-03-15,1,475,593,118,118
661,17,5,2025-03-03,11,257,338,81,891
247,15,26,2025-03-02,5,429,539,110,550
230,28,15,2025-03-09,11,196,288,92,1012
569,23,15,2025-03-31,16,220,259,39,624
133,13,29,2025-03-14,15,311,376,65,975
942,9,5,2025-03-05,2,338,435,97,194
582,17,19,2025-03-19,4,149,208,59,236
333,17,9,2025-03-16,16,316,338,22,352
9,11,19,2025-03-23,18,377,548,171,3078
142,18,29,2025-03-22,11,452,651,199,2189
172,6,8,2025-03-28,14,257,353,96,1344
875,1,11,2025-03-01,20,365,524,159,3180
411,8,28,2025-03-15,11,424,570,146,1606
465,14,10,2025-03-30,1,160,203,43,43
514,30,24,2025-03-12,16,23,25,2,32
692,21,19,2025-03-03,9,75,87,12,108
693,23,8,2025-03-28,8,372,520,148,1184
109,28,12,2025-03-20,19,27,35,8,152
214,30,1,2025-03-04,1,311,415,104,104
435,1,5,2025-03-13,19,474,549,75,1425
497,24,21,2025-03-24,2,71,88,17,34
625,16,16,2025-03-21,15,303,343,40,600
62,2,10,2025-03-10,17,349,431,82,1394
385,9,5,2025-03-28,16,458,552,94,1504
353,9,4,2025-03-09,8,310,451,141,1128
226,24,19,2025-03-19,6,166,194,28,168
972,19,25,2025-03-15,2,126,178,52,104
632,7,10,2025-03-12,7,294,387,93,651
762,22,28,2025-03-02,14,66,74,8,112
520,26,26,2025-03-07,17,367,449,82,1394
837,7,29,2025-03-19,14,59,66,7,98
906,3,30,2025-03-21,12,291,402,111,1332
487,11,26,2025-03-22,17,272,389,117,1989
360,24,15,2025-03-27,13,405,591,186,2418
126,28,19,2025-03-23,7,225,317,92,644
531,29,3,2025-03-06,5,168,201,33,165
7,17,29,2025-03-30,5,367,544,177,885
680,2,24,2025-03-05,11,411,441,30,330
790,17,6,2025-03-29,17,290,411,121,2057
893,27,17,2025-03-27,18,377,445,68,1224
223,13,16,2025-03-10,12,27,38,11,132
96,7,10,2025-03-12,1,78,108,30,30
36,28,8,2025-03-10,8,31,40,9,72
438,15,8,2025-03-08,12,302,417,115,1380
978,9,19,2025-03-03,18,214,258,44,792
83,17,12,2025-03-09,1,444,479,35,35
447,20,21,2025-03-20,19,328,384,56,1064
676,9,20,2025-03-12,8,104,111,7,56
641,2,29,2025-03-26,19,347,365,18,342
192,1,5,2025-03-16,6,151,171,20,120
231,9,28,2025-03-08,5,269,381,112,560
91,3,25,2025-03-11,8,233,256,23,184
555,24,17,2025-03-08,14,343,422,79,1106
358,5,6,2025-03-26,14,264,356,92,1288
335,17,23,2025-03-20,13,209,238,29,377
41,28,19,2025-03-23,19,293,375,82,1558
99,4,19,2025-03-11,19,28,32,4,76
673,23,6,2025-03-31,5,189,221,32,160
799,28,30,2025-03-27,13,115,137,22,286
379,1,5,2025-03-28,7,287,405,118,826
844,17,30,2025-03-02,15,223,310,87,1305
819,23,9,2025-03-28,18,358,511,153,2754
926,23,10,2025-03-12,19,59,78,19,361
72,9,19,2025-03-09,6,307,339,32,192
14,6,11,2025-03-13,4,176,213,37,148
478,2,24,2025-03-14,9,370,485,115,1035
393,23,7,2025-03-08,18,307,412,105,1890
260,13,26,2025-03-13,20,381,549,168,3360
493,24,25,2025-03-31,16,177,251,74,1184
843,8,24,2025-03-14,18,303,351,48,864
844,5,21,2025-03-27,11,56,84,28,308
440,16,10,2025-03-02,10,236,279,43,430
933,19,26,2025-03-22,4,268,374,106,424
34,2,29,2025-03-24,19,212,315,103,1957
334,4,12,2025-03-08,9,71,98,27,243
171,12,16,2025-03-14,14,429,569,140,1960
828,4,28,2025-03-30,20,358,456,98,1960
948,21,18,2025-03-04,19,96,121,25,475
460,28,14,2025-03-23,16,427,458,31,496
351,27,11,2025-03-23,8,297,359,62,496
565,15,10,2025-03-10,5,303,383,80,400
249,8,10,2025-03-21,5,328,394,66,330
234,28,25,2025-03-25,6,211,222,11,66
459,17,29,2025-03-03,7,479,592,113,791
472,6,15,2025-03-08,9,152,188,36,324
58,13,14,2025-03-15,17,192,257,65,1105
31,20,29,2025-03-07,7,79,87,8,56
453,9,4,2025-03-25,5,354,415,61,305
349,24,12,2025-03-17,10,476,603,127,1270
660,17,10,2025-03-26,14,28,36,8,112
910,28,15,2025-03-25,6,318,427,109,654
198,1,18,2025-03-05,1,345,492,147,147
17,30,18,2025-03-27,8,221,239,18,144
161,3,11,2025-03-24,8,125,167,42,336
403,1,29,2025-03-27,18,495,601,106,1908
503,15,7,2025-03-14,2,288,343,55,110
956,25,10,2025-03-01,11,315,336,21,231
914,16,4,2025-03-17,18,450,496,46,828
590,7,5,2025-03-09,5,306,425,119,595
479,10,15,2025-03-10,3,357,440,83,249
951,7,14,2025-03-30,17,181,267,86,1462
549,22,30,2025-03-21,19,409,499,90,1710
632,26,29,2025-03-31,8,434,560,126,1008
887,10,29,2025-03-22,19,438,571,133,2527
127,21,15,2025-03-28,2,25,37,12,24
853,24,29,2025-03-27,18,405,488,83,1494
127,22,30,2025-03-21,1,106,114,8,8
710,27,25,2025-03-30,5,325,458,133,665
966,28,17,2025-03-04,20,298,413,115,2300
582,4,21,2025-03-11,8,161,203,42,336
113,20,7,2025-03-03,20,271,285,14,280
348,21,29,2025-03-21,20,462,587,125,2500
105,11,24,2025-03-12,18,43,56,13,234
37,21,25,2025-03-04,12,118,138,20,240
698,3,17,2025-03-10,14,424,465,41,574
980,1,26,2025-03-28,20,356,519,163,3260
938,1,23,2025-03-11,8,106,145,39,312
478,3,21,2025-03-01,20,421,624,203,4060
230,2,2,2025-03-21,15,354,459,105,1575
183,26,14,2025-03-09,11,239,258,19,209
824,13,11,2025-03-25,13,357,389,32,416
375,29,6,2025-03-22,19,203,249,46,874
688,16,25,2025-03-22,7,264,323,59,413
389,11,21,2025-03-03,3,452,517,65,195
604,23,8,2025-03-29,16,308,408,100,1600
979,24,30,2025-03-19,11,202,225,23,253
228,24,12,2025-03-21,1,39,57,18,18
505,25,17,2025-03-25,4,23,33,10,40
75,26,26,2025-03-20,9,361,463,102,918
102,26,4,2025-03-25,14,453,654,201,2814
439,6,5,2025-03-13,6,315,349,34,204
764,14,10,2025-03-24,13,402,454,52,676
399,12,18,2025-03-09,6,458,683,225,1350
560,27,11,2025-03-19,7,283,381,98,686
683,16,12,2025-03-18,18,132,147,15,270
870,21,29,2025-03-19,1,236,312,76,76
565,8,22,2025-03-02,3,120,145,25,75
480,16,11,2025-03-05,20,322,366,44,880
810,24,23,2025-03-07,3,468,535,67,201
159,16,2,2025-03-21,10,292,393,101,1010
911,12,15,2025-03-16,10,133,160,27,270
83,16,19,2025-03-07,3,236,349,113,339
918,19,4,2025-03-12,15,50,66,16,240
254,29,1,2025-03-25,16,137,182,45,720
851,17,27,2025-03-24,2,27,38,11,22
882,22,10,2025-03-20,11,340,398,58,638
39,8,22,2025-03-14,17,427,525,98,1666
37,11,23,2025-03-01,8,26,39,13,104
409,16,7,2025-03-21,5,185,235,50,250
684,25,28,2025-03-02,3,118,132,14,42
676,3,7,2025-03-25,11,171,218,47,517
479,29,29,2025-03-30,1,246,259,13,13
261,19,23,2025-03-21,4,174,190,16,64
497,5,9,2025-03-09,14,288,401,113,1582
668,26,27,2025-03-27,5,402,517,115,575
437,15,3,2025-03-18,4,43,51,8,32
638,14,22,2025-03-25,2,102,143,41,82
288,26,10,2025-03-10,14,121,145,24,336
530,10,3,2025-03-07,4,455,664,209,836
39,19,27,2025-03-31,10,245,303,58,580
519,10,16,2025-03-25,15,184,264,80,1200
309,28,18,2025-03-12,1,415,614,199,199
860,20,23,2025-03-03,7,371,495,124,868
292,8,18,2025-03-17,11,372,421,49,539
244,21,2,2025-03-14,10,251,320,69,690
909,16,29,2025-03-15,13,377,533,156,2028
474,29,9,2025-03-07,9,319,368,49,441
335,1,18,2025-03-31,10,375,551,176,1760
582,6,2,2025-03-20,20,133,179,46,920
733,21,21,2025-03-16,7,200,226,26,182
68,16,10,2025-03-07,6,151,189,38,228
331,14,16,2025-03-06,18,77,114,37,666
121,19,25,2025-03-17,13,132,145,13,169
745,7,7,2025-03-22,1,395,456,61,61
398,28,9,2025-03-06,8,419,502,83,664
990,20,13,2025-03-13,12,148,187,39,468
907,15,26,2025-03-20,20,290,374,84,1680
727,28,17,2025-03-13,19,494,658,164,3116
926,15,14,2025-03-26,2,369,483,114,228
824,12,12,2025-03-07,13,310,359,49,637
46,1,26,2025-03-07,1,334,466,132,132
845,13,27,2025-03-18,7,488,705,217,1519
724,6,15,2025-03-15,2,465,695,230,460
15,4,29,2025-03-11,2,42,61,19,38
288,27,10,2025-03-15,3,318,355,37,111
278,24,25,2025-03-31,13,106,134,28,364
959,11,15,2025-03-21,18,393,420,27,486
465,25,17,2025-03-20,10,480,552,72,720
210,19,10,2025-03-07,15,322,427,105,1575
60,3,27,2025-03-09,17,143,151,8,136
458,29,26,2025-03-11,4,400,549,149,596
658,16,2,2025-03-09,20,272,305,33,660
577,21,25,2025-03-25,19,424,567,143,2717
542,24,7,2025-03-12,6,229,255,26,156
793,24,12,2025-03-25,4,113,141,28,112
656,9,4,2025-03-27,10,94,139,45,450
40,20,28,2025-03-21,10,436,463,27,270
727,30,6,2025-03-13,15,425,627,202,3030
480,28,25,2025-03-27,12,140,176,36,432
40,26,18,2025-03-27,10,171,211,40,400
752,28,9,2025-03-07,5,65,95,30,150
264,12,16,2025-03-12,6,143,173,30,180
270,6,26,2025-03-21,9,458,496,38,342
559,17,23,2025-03-08,4,298,383,85,340
940,11,29,2025-03-11,15,194,276,82,1230
433,29,22,2025-03-04,13,288,367,79,1027
26,20,21,2025-03-15,19,173,231,58,1102
521,16,17,2025-03-29,20,227,338,111,2220
417,3,20,2025-03-21,19,125,179,54,1026
219,19,10,2025-03-04,10,346,428,82,820
259,14,30,2025-03-10,16,467,612,145,2320
668,22,29,2025-03-24,20,439,499,60,1200
750,15,8,2025-03-05,10,323,371,48,480
320,26,2,2025-03-26,7,139,192,53,371
282,3,22,2025-03-02,20,469,597,128,2560
487,26,21,2025-03-09,7,195,208,13,91
992,15,20,2025-03-27,10,224,331,107,1070
305,9,20,2025-03-04,9,141,187,46,414
982,6,15,2025-03-12,4,434,529,95,380
326,15,27,2025-03-28,19,291,309,18,342
939,27,10,2025-03-12,12,153,209,56,672
296,4,19,2025-03-04,7,334,414,80,560
697,13,2,2025-03-26,1,219,246,27,27
768,13,10,2025-03-24,6,278,407,129,774
345,13,7,2025-03-03,8,202,279,77,616
415,30,15,2025-03-23,7,300,385,85,595
860,16,2,2025-03-16,18,302,369,67,1206
295,6,23,2025-03-03,9,379,522,143,1287
200,7,6,2025-03-17,20,67,72,5,100
721,12,3,2025-03-13,9,251,282,31,279
487,17,9,2025-03-21,16,261,328,67,1072
283,17,21,2025-03-22,15,365,506,141,2115
586,3,22,2025-03-05,20,281,415,134,2680
959,15,19,2025-03-26,18,296,427,131,2358
809,15,19,2025-03-02,2,404,586,182,364
120,3,1,2025-03-23,1,398,518,120,120
413,17,7,2025-03-13,14,322,373,51,714
599,25,25,2025-03-06,3,462,656,194,582
472,7,27,2025-03-16,4,94,134,40,160
104,6,8,2025-03-18,6,488,682,194,1164
749,14,30,2025-03-20,7,361,456,95,665
457,1,13,2025-03-28,2,352,442,90,180
988,11,26,2025-03-01,2,194,280,86,172
913,25,18,2025-03-20,11,395,522,127,1397
307,24,10,2025-03-04,6,31,40,9,54
215,20,17,2025-03-11,6,475,607,132,792
513,21,4,2025-03-22,4,227,285,58,232
616,24,29,2025-03-27,14,187,257,70,980
814,29,22,2025-03-24,7,348,409,61,427
196,6,30,2025-03-26,10,350,508,158,1580
215,18,4,2025-03-06,18,425,526,101,1818
159,20,24,2025-03-13,18,293,395,102,1836
805,30,16,2025-03-29,9,337,422,85,765
45,13,4,2025-03-20,5,500,585,85,425
268,13,21,2025-03-31,15,32,48,16,240
265,8,17,2025-03-02,3,365,464,99,297
217,2,20,2025-03-29,13,382,417,35,455
832,4,19,2025-03-24,16,467,635,168,2688
782,18,18,2025-03-15,9,435,517,82,738
695,22,7,2025-03-11,14,459,641,182,2548
463,13,4,2025-03-01,10,380,459,79,790
942,30,18,2025-03-27,11,467,681,214,2354
202,16,17,2025-03-03,14,214,262,48,672
60,15,27,2025-03-15,5,344,487,143,715
631,4,7,2025-03-16,12,164,196,32,384
756,21,12,2025-03-13,13,401,476,75,975
70,14,26,2025-03-25,3,330,450,120,360
477,15,22,2025-03-15,4,369,546,177,708
888,30,5,2025-03-24,17,283,421,138,2346
863,4,29,2025-03-22,1,361,385,24,24
9,5,15,2025-03-02,14,131,181,50,700
441,15,8,2025-03-10,10,334,434,100,1000
543,20,20,2025-03-04,19,403,584,181,3439
114,3,28,2025-03-21,10,409,437,28,280
776,18,15,2025-03-16,18,290,354,64,1152
844,14,7,2025-03-16,18,388,536,148,2664
72,26,14,2025-03-03,4,37,39,2,8
706,2,27,2025-03-11,5,137,155,18,90
67,16,12,2025-03-11,17,417,614,197,3349
685,24,26,2025-03-25,12,298,353,55,660
205,30,2,2025-03-30,8,296,420,124,992
669,5,1,2025-03-12,12,21,25,4,48
670,12,18,2025-03-21,20,72,81,9,180
636,22,6,2025-03-09,18,177,252,75,1350
756,16,28,2025-03-12,16,452,647,195,3120
681,3,10,2025-03-31,12,450,577,127,1524
992,5,8,2025-03-21,13,361,531,170,2210
613,11,10,2025-03-04,15,248,290,42,630
901,3,30,2025-03-26,9,385,420,35,315
663,17,27,2025-03-05,5,465,559,94,470
591,11,17,2025-03-29,10,155,181,26,260
226,13,27,2025-03-25,11,262,300,38,418
99,23,7,2025-03-29,18,47,55,8,144
484,10,3,2025-03-29,12,336,367,31,372
240,29,10,2025-03-29,11,73,82,9,99
719,26,13,2025-03-13,19,104,117,13,247
832,2,5,2025-03-05,20,299,434,135,2700
6,29,9,2025-03-07,12,435,588,153,1836
812,6,2,2025-03-16,20,270,371,101,2020
531,1,13,2025-03-17,1,279,308,29,29
896,26,20,2025-03-23,8,354,398,44,352
727,5,18,2025-03-15,10,307,397,90,900
356,27,26,2025-03-18,14,349,452,103,1442
259,20,8,2025-03-01,16,279,352,73,1168
37,6,3,2025-03-29,6,218,313,95,570
583,24,9,2025-03-03,18,486,571,85,1530
171,1,6,2025-03-23,4,173,184,11,44
474,19,9,2025-03-30,12,369,419,50,600
116,22,1,2025-03-26,7,137,193,56,392
811,12,20,2025-03-16,1,419,494,75,75
815,19,28,2025-03-03,10,207,306,99,990
908,1,14,2025-03-09,20,341,412,71,1420
232,6,30,2025-03-31,13,137,166,29,377
963,2,26,2025-03-13,9,470,668,198,1782
77,14,9,2025-03-26,19,202,225,23,437
820,26,2,2025-03-22,19,82,93,11,209
862,3,13,2025-03-03,14,390,495,105,1470
916,23,25,2025-03-28,12,381,408,27,324
305,1,14,2025-03-24,3,326,370,44,132
931,28,14,2025-03-19,19,274,319,45,855
279,13,18,2025-03-01,18,229,247,18,324
871,13,26,2025-03-01,15,449,513,64,960
193,12,23,2025-03-03,8,44,49,5,40
439,10,18,2025-03-29,17,494,557,63,1071
994,15,17,2025-03-10,4,29,43,14,56
993,14,10,2025-03-02,3,395,527,132,396
236,26,22,2025-03-03,16,37,52,15,240
990,24,25,2025-03-16,6,267,318,51,306
388,8,2,2025-03-11,2,346,409,63,126
150,7,23,2025-03-08,19,405,549,144,2736
525,24,20,2025-03-06,15,187,207,20,300
49,14,27,2025-03-16,20,132,159,27,540
366,14,22,2025-03-13,11,373,520,147,1617
725,30,28,2025-03-16,13,200,263,63,819
41,25,5,2025-03-29,17,78,106,28,476
863,3,22,2025-03-22,3,252,336,84,252
547,23,3,2025-03-14,13,352,389,37,481
812,19,16,2025-03-20,4,376,423,47,188
389,15,22,2025-03-24,11,56,67,11,121
980,3,9,2025-03-27,12,469,641,172,2064
554,28,28,2025-03-01,7,66,84,18,126
400,14,28,2025-03-01,6,415,563,148,888
631,11,13,2025-03-18,10,65,91,26,260
494,11,18,2025-03-22,12,228,315,87,1044
953,5,27,2025-03-23,10,29,43,14,140
592,8,18,2025-03-03,10,150,159,9,90
14,29,21,2025-03-08,11,30,43,13,143
862,21,22,2025-03-13,12,24,31,7,84
262,13,24,2025-03-14,20,443,475,32,640
833,10,23,2025-03-07,17,28,35,7,119
954,26,5,2025-03-15,17,62,88,26,442
307,6,2,2025-03-30,8,282,355,73,584
722,2,11,2025-03-13,18,259,315,56,1008
117,19,4,2025-03-09,13,62,78,16,208
817,15,19,2025-03-17,1,112,134,22,22
912,12,18,2025-03-18,18,362,385,23,414
724,4,6,2025-03-25,4,339,497,158,632
439,12,27,2025-03-28,15,279,405,126,1890
426,12,24,2025-03-05,10,301,329,28,280
563,30,18,2025-03-29,14,433,498,65,910
387,24,13,2025-03-19,4,437,511,74,296
62,27,24,2025-03-08,10,214,237,23,230
272,20,11,2025-03-08,18,359,417,58,1044
839,26,25,2025-03-28,14,277,306,29,406
440,16,12,2025-03-29,15,338,358,20,300
953,7,8,2025-03-17,3,197,227,30,90
445,2,30,2025-03-16,13,70,96,26,338
72,6,3,2025-03-12,15,330,375,45,675
46,16,30,2025-03-17,2,281,343,62,124
252,27,9,2025-03-04,5,21,30,9,45
601,1,14,2025-03-02,7,227,277,50,350
931,4,21,2025-03-05,11,393,498,105,1155
355,16,14,2025-03-16,19,67,100,33,627
47,15,12,2025-03-13,1,320,399,79,79
352,3,1,2025-03-15,20,265,388,123,2460
676,6,22,2025-03-19,15,494,634,140,2100
278,6,15,2025-03-17,18,472,671,199,3582
195,25,29,2025-03-28,4,344,492,148,592
939,2,25,2025-03-07,13,44,49,5,65
615,19,25,2025-03-01,11,441,594,153,1683
999,12,30,2025-03-09,17,41,59,18,306
753,10,28,2025-03-01,18,378,549,171,3078
8,5,9,2025-03-29,6,226,305,79,474
382,9,13,2025-03-25,4,59,83,24,96
623,13,21,2025-03-03,12,122,138,16,192
44,21,6,2025-03-10,9,413,500,87,783
345,23,18,2025-03-14,4,381,448,67,268
71,20,15,2025-03-20,17,430,503,73,1241
858,12,27,2025-03-13,9,433,625,192,1728
932,30,12,2025-03-15,8,272,339,67,536
966,18,4,2025-03-03,13,409,507,98,1274
808,27,22,2025-03-27,19,309,438,129,2451
486,12,5,2025-03-14,16,218,282,64,1024
341,6,14,2025-03-14,14,119,126,7,98
22,28,22,2025-03-30,12,246,274,28,336
79,10,26,2025-03-15,12,189,208,19,228
816,17,28,2025-03-09,19,43,58,15,285
794,17,29,2025-03-24,2,361,411,50,100
467,27,8,2025-03-19,16,476,559,83,1328
750,5,13,2025-03-11,17,364,392,28,476
529,22,11,2025-03-11,20,314,414,100,2000
327,9,28,2025-03-10,16,93,103,10,160
952,24,30,2025-03-17,16,181,219,38,608
287,3,5,2025-03-31,6,41,50,9,54
741,4,10,2025-03-09,3,368,505,137,411
912,14,27,2025-03-31,5,460,686,226,1130
760,16,2,2025-03-01,9,81,116,35,315
328,14,9,2025-03-11,13,316,353,37,481
585,2,24,2025-03-11,10,76,105,29,290
840,20,20,2025-03-20,11,276,311,35,385
572,20,20,2025-03-17,2,296,442,146,292
687,8,18,2025-03-09,2,381,536,155,310
202,23,2,2025-03-30,12,129,191,62,744
390,17,18,2025-03-08,13,324,418,94,1222
259,8,15,2025-03-08,3,407,498,91,273
50,30,8,2025-03-09,4,88,111,23,92
65,15,7,2025-03-17,4,217,249,32,128
485,24,21,2025-03-21,13,405,572,167,2171
546,14,24,2025-03-15,20,112,154,42,840
159,27,17,2025-03-14,11,69,86,17,187
192,20,19,2025-03-09,6,107,123,16,96
829,5,6,2025-03-04,2,214,311,97,194
965,7,4,2025-03-10,18,170,209,39,702
994,18,28,2025-03-27,9,81,110,29,261
767,24,19,2025-03-13,15,309,346,37,555
462,24,23,2025-03-30,6,391,545,154,924
446,19,24,2025-03-01,18,234,332,98,1764
970,21,9,2025-03-16,13,466,570,104,1352
246,8,23,2025-03-30,19,23,25,2,38
310,8,3,2025-03-27,2,496,581,85,170
77,30,12,2025-03-03,19,150,161,11,209
53,26,21,2025-03-27,1,149,164,15,15
475,23,26,2025-03-11,6,391,549,158,948
926,15,29,2025-03-01,20,342,464,122,2440
502,4,1,2025-03-24,3,403,590,187,561
307,2,5,2025-03-31,19,187,220,33,627
90,25,7,2025-03-16,18,383,508,125,2250
876,25,4,2025-03-22,11,73,93,20,220
700,25,14,2025-03-20,11,202,284,82,902
240,8,5,2025-03-08,18,184,224,40,720
14,21,5,2025-03-17,8,307,446,139,1112
885,6,15,2025-03-26,2,231,300,69,138
367,3,4,2025-03-22,12,379,524,145,1740
609,22,5,2025-03-24,17,439,552,113,1921
830,23,9,2025-03-06,12,274,403,129,1548
385,19,26,2025-03-26,8,197,247,50,400
294,3,3,2025-03-14,5,64,84,20,100
119,16,11,2025-03-07,13,246,290,44,572
960,15,28,2025-03-05,3,269,389,120,360
388,16,1,2025-03-10,4,160,238,78,312
530,20,23,2025-03-28,2,305,362,57,114
276,8,10,2025-03-12,16,201,221,20,320
441,7,8,2025-03-08,19,28,32,4,76
958,1,26,2025-03-12,13,160,176,16,208
348,17,15,2025-03-06,20,258,278,20,400
989,13,4,2025-03-31,18,323,375,52,936
205,22,28,2025-03-08,6,345,433,88,528
340,15,4,2025-03-04,19,23,28,5,95
404,1,11,2025-03-13,19,40,43,3,57
841,20,16,2025-03-30,12,63,73,10,120
759,8,3,2025-03-15,19,313,399,86,1634
647,4,19,2025-03-24,9,385,430,45,405
355,1,2,2025-03-19,14,139,189,50,700
296,24,22,2025-03-14,3,276,294,18,54
694,6,17,2025-03-10,3,278,408,130,390
226,20,30,2025-03-12,5,495,708,213,1065
82,3,12,2025-03-18,12,272,331,59,708
76,16,27,2025-03-17,12,45,64,19,228
945,11,23,2025-03-21,1,334,439,105,105
642,29,13,2025-03-04,7,269,313,44,308
827,12,27,2025-03-28,16,87,106,19,304
173,23,15,2025-03-27,5,280,310,30,150
324,16,16,2025-03-16,7,249,348,99,693
212,20,16,2025-03-08,6,48,71,23,138
194,25,27,2025-03-13,1,24,33,9,9
791,2,25,2025-03-23,17,260,326,66,1122
955,7,1,2025-03-13,13,63,86,23,299
102,19,8,2025-03-04,13,53,66,13,169
505,2,30,2025-03-17,6,496,656,160,960
517,5,12,2025-03-13,4,385,552,167,668
95,17,9,2025-03-24,9,212,304,92,828
185,30,4,2025-03-30,2,28,35,7,14
17,19,28,2025-03-31,3,421,497,76,228
115,1,27,2025-03-15,14,206,235,29,406
753,21,27,2025-03-24,20,192,229,37,740
777,16,5,2025-03-12,5,452,504,52,260
725,24,23,2025-03-12,19,337,483,146,2774
711,25,9,2025-03-28,5,234,324,90,450
862,27,5,2025-03-17,6,297,416,119,714
512,30,29,2025-03-12,1,257,370,113,113
813,23,10,2025-03-15,18,75,110,35,630
287,13,5,2025-03-12,9,312,384,72,648
420,19,8,2025-03-11,3,478,694,216,648
706,14,21,2025-03-22,8,41,60,19,152
236,27,8,2025-03-25,4,304,348,44,176
433,22,29,2025-03-11,3,412,450,38,114
693,14,13,2025-03-13,7,259,354,95,665
529,5,10,2025-03-01,8,86,105,19,152
747,19,22,2025-03-13,14,102,142,40,560
42,17,1,2025-03-24,15,163,187,24,360
387,9,23,2025-03-09,13,471,566,95,1235
405,30,8,2025-03-29,1,493,647,154,154
43,28,29,2025-03-07,8,315,426,111,888
709,29,20,2025-03-31,19,406,547,141,2679
863,29,15,2025-03-01,1,323,461,138,138
254,29,13,2025-03-22,2,184,204,20,40
635,25,1,2025-03-26,4,486,657,171,684
213,30,15,2025-03-03,13,437,533,96,1248
585,29,4,2025-03-05,8,390,515,125,1000
215,16,8,2025-03-02,6,245,326,81,486
169,11,23,2025-03-24,13,58,86,28,364
406,25,5,2025-03-26,19,263,341,78,1482
840,4,12,2025-03-05,3,274,408,134,402
69,26,8,2025-03-07,8,86,102,16,128
875,27,15,2025-03-12,18,31,45,14,252
518,21,29,2025-03-11,5,25,32,7,35
995,24,15,2025-03-12,12,461,552,91,1092
768,10,5,2025-03-18,14,349,372,23,322
237,3,6,2025-03-27,18,56,61,5,90
741,9,7,2025-03-26,2,258,306,48,96
174,3,1,2025-03-06,15,403,547,144,2160
816,5,4,2025-03-01,9,294,312,18,162
997,30,2,2025-03-18,12,404,566,162,1944
389,11,24,2025-03-05,19,93,108,15,285
244,8,14,2025-03-11,13,50,66,16,208
819,12,5,2025-03-28,4,134,143,9,36
831,6,16,2025-03-28,2,271,313,42,84
187,25,28,2025-03-21,12,217,243,26,312
294,3,30,2025-03-30,17,32,47,15,255
326,26,11,2025-03-25,14,142,164,22,308
912,23,26,2025-03-02,1,94,130,36,36
170,28,30,2025-03-08,19,389,510,121,2299
268,29,29,2025-03-21,17,118,153,35,595
868,3,23,2025-03-20,11,376,490,114,1254
570,11,12,2025-03-15,12,20,22,2,24
513,2,14,2025-03-26,14,24,35,11,154
571,10,9,2025-03-28,19,431,478,47,893
87,18,3,2025-03-30,1,364,450,86,86
656,19,12,2025-03-19,4,269,390,121,484
770,10,12,2025-03-21,2,340,394,54,108
947,30,3,2025-03-08,10,400,573,173,1730
340,11,8,2025-03-06,4,412,461,49,196
171,29,16,2025-03-20,11,480,533,53,583
522,26,9,2025-03-16,1,40,43,3,3
989,22,10,2025-03-20,5,472,537,65,325
571,6,13,2025-03-20,11,140,206,66,726
490,14,5,2025-03-02,8,338,443,105,840
872,23,26,2025-03-28,3,114,159,45,135
271,2,23,2025-03-08,15,324,416,92,1380
472,14,25,2025-03-19,12,218,258,40,480
999,3,12,2025-03-03,3,444,578,134,402
168,7,8,2025-03-01,17,263,279,16,272
994,17,19,2025-03-01,1,367,495,128,128
733,10,2,2025-03-16,15,307,388,81,1215
252,23,14,2025-03-26,11,241,278,37,407
704,19,21,2025-03-31,7,470,659,189,1323
180,18,15,2025-03-06,6,216,267,51,306
497,28,27,2025-03-03,13,396,575,179,2327
779,4,26,2025-03-15,3,247,315,68,204
92,8,12,2025-03-10,5,41,52,11,55
379,28,29,2025-03-18,4,237,258,21,84
864,8,7,2025-03-01,17,279,360,81,1377
804,17,12,2025-03-19,4,261,369,108,432
470,2,3,2025-03-05,1,88,109,21,21
518,10,30,2025-03-24,4,88,130,42,168
837,22,16,2025-03-18,8,405,486,81,648
544,22,3,2025-03-19,4,497,553,56,224
610,10,21,2025-03-13,2,478,623,145,290
505,4,20,2025-03-11,1,228,330,102,102
510,20,6,2025-03-16,7,212,273,61,427
389,1,11,2025-03-09,13,498,687,189,2457
166,29,23,2025-03-17,9,250,282,32,288
797,5,23,2025-03-23,10,197,291,94,940
706,18,11,2025-03-30,10,340,506,166,1660
351,5,20,2025-03-31,4,472,658,186,744
443,11,12,2025-03-26,14,348,509,161,2254
80,3,6,2025-03-09,12,81,116,35,420
657,26,25,2025-03-29,15,115,155,40,600
166,11,20,2025-03-15,1,243,340,97,97
689,17,1,2025-03-04,4,332,371,39,156
359,25,26,2025-03-29,13,343,486,143,1859
598,13,26,2025-03-14,17,404,503,99,1683
867,14,12,2025-03-20,13,265,369,104,1352
835,19,22,2025-03-06,7,202,229,27,189
746,4,10,2025-03-09,14,82,118,36,504
909,15,9,2025-03-13,6,221,233,12,72
35,15,6,2025-03-24,2,250,273,23,46
63,16,22,2025-03-16,5,110,146,36,180
988,25,23,2025-03-22,16,267,333,66,1056
55,5,28,2025-03-27,13,220,310,90,1170
100,5,30,2025-03-14,4,244,307,63,252
630,16,10,2025-03-20,5,123,161,38,190
785,8,30,2025-03-26,2,326,447,121,242
204,2,30,2025-03-28,9,141,208,67,603
459,14,10,2025-03-17,17,187,200,13,221
236,24,14,2025-03-04,19,372,433,61,1159
821,13,18,2025-03-11,9,149,211,62,558
261,20,8,2025-03-07,20,74,83,9,180
822,2,24,2025-03-08,9,257,373,116,1044
993,19,14,2025-03-22,12,475,703,228,2736
537,13,4,2025-03-16,20,173,257,84,1680
810,7,15,2025-03-31,11,45,52,7,77
193,10,29,2025-03-28,12,180,229,49,588
645,12,25,2025-03-08,4,127,179,52,208
399,8,16,2025-03-11,4,298,338,40,160
615,27,14,2025-03-29,1,354,491,137,137
260,10,7,2025-03-11,16,397,556,159,2544
918,25,13,2025-03-31,20,286,336,50,1000
755,13,1,2025-03-09,1,421,480,59,59
135,12,6,2025-03-10,5,406,436,30,150
563,1,11,2025-03-26,16,174,215,41,656
129,16,24,2025-03-03,15,215,290,75,1125
460,8,6,2025-03-09,8,124,141,17,136
380,11,6,2025-03-11,20,420,543,123,2460
720,26,24,2025-03-01,5,92,132,40,200
401,3,13,2025-03-27,16,490,553,63,1008
484,19,24,2025-03-05,7,386,563,177,1239
863,19,30,2025-03-15,9,371,508,137,1233
890,21,18,2025-03-29,9,223,288,65,585
262,23,11,2025-03-17,12,423,522,99,1188
98,4,30,2025-03-28,19,233,283,50,950
18,25,8,2025-03-20,3,220,275,55,165
998,28,18,2025-03-22,13,47,60,13,169
773,8,7,2025-03-07,12,231,330,99,1188
166,19,3,2025-03-28,8,96,120,24,192
734,3,12,2025-03-23,15,432,583,151,2265
563,3,9,2025-03-01,15,147,193,46,690
116,24,8,2025-03-28,2,26,29,3,6
855,3,9,2025-03-30,6,230,300,70,420
210,4,4,2025-03-28,10,195,250,55,550
560,6,5,2025-03-22,1,390,553,163,163
253,20,22,2025-03-15,11,176,225,49,539
800,11,30,2025-03-20,2,240,337,97,194
805,20,30,2025-03-31,15,149,210,61,915
439,27,7,2025-03-31,1,128,138,10,10
977,16,9,2025-03-23,19,468,513,45,855
945,27,4,2025-03-06,3,226,276,50,150
616,26,11,2025-03-07,13,348,505,157,2041
716,9,14,2025-03-29,11,491,626,135,1485
680,20,29,2025-03-13,18,378,498,120,2160
710,29,14,2025-03-13,10,272,400,128,1280
750,30,13,2025-03-24,5,184,204,20,100
229,19,25,2025-03-27,18,116,136,20,360
851,5,17,2025-03-26,20,123,174,51,1020
622,18,28,2025-03-09,16,211,266,55,880
845,19,2,2025-03-31,17,333,352,19,323
863,12,22,2025-03-09,14,349,476,127,1778
755,19,23,2025-03-04,8,227,283,56,448
387,8,15,2025-03-16,14,113,169,56,784
117,2,15,2025-03-10,15,169,231,62,930
289,6,17,2025-03-09,17,363,496,133,2261
55,5,5,2025-03-25,1,336,362,26,26
426,12,21,2025-03-03,3,55,69,14,42
888,9,9,2025-03-27,3,352,476,124,372
368,10,18,2025-03-25,14,75,94,19,266
100,9,25,2025-03-27,4,372,418,46,184
234,13,10,2025-03-23,9,118,163,45,405
445,29,19,2025-03-08,20,372,451,79,1580
169,10,8,2025-03-29,11,310,376,66,726
561,4,17,2025-03-05,8,25,28,3,24
948,29,11,2025-03-27,5,455,648,193,965
56,18,30,2025-03-21,13,24,29,5,65
733,10,12,2025-03-17,12,40,55,15,180
483,5,20,2025-03-05,3,209,276,67,201
843,12,1,2025-03-08,15,269,395,126,1890
872,29,18,2025-03-28,10,41,56,15,150
452,7,3,2025-03-12,15,67,88,21,315
249,6,7,2025-03-07,1,192,225,33,33
673,13,29,2025-03-12,3,126,172,46,138
769,30,25,2025-03-26,4,34,50,16,64
21,12,19,2025-03-31,9,424,622,198,1782
314,12,18,2025-03-25,13,156,172,16,208
682,14,28,2025-03-11,6,490,618,128,768
619,15,12,2025-03-11,19,36,44,8,152
787,30,30,2025-03-06,15,212,273,61,915
91,18,5,2025-03-06,2,145,210,65,130
152,6,6,2025-03-05,7,364,467,103,721
504,27,4,2025-03-07,5,20,27,7,35
1,9,26,2025-03-21,15,272,364,92,1380
379,11,3,2025-03-05,2,209,285,76,152
212,28,6,2025-03-19,6,201,253,52,312
467,3,6,2025-03-23,16,272,291,19,304
197,3,17,2025-03-03,17,403,439,36,612
417,29,20,2025-03-05,1,406,524,118,118
173,6,11,2025-03-21,11,461,679,218,2398
916,13,6,2025-03-03,6,432,458,26,156
338,30,24,2025-03-30,2,255,280,25,50
235,1,24,2025-03-08,6,341,492,151,906
246,20,3,2025-03-01,5,167,211,44,220
135,13,9,2025-03-12,6,245,329,84,504
168,16,4,2025-03-21,3,107,142,35,105
713,2,6,2025-03-18,1,376,528,152,152
373,22,9,2025-03-12,16,417,590,173,2768
169,10,30,2025-03-27,2,269,347,78,156
834,12,22,2025-03-24,8,445,603,158,1264
185,12,6,2025-03-20,9,39,47,8,72
20,29,30,2025-03-19,17,107,142,35,595
960,2,12,2025-03-15,4,291,395,104,416
33,22,29,2025-03-02,18,369,453,84,1512
867,1,29,2025-03-07,11,276,410,134,1474
398,26,25,2025-03-19,20,283,412,129,2580
276,30,23,2025-03-25,6,212,224,12,72
505,15,14,2025-03-19,17,120,129,9,153
959,12,11,2025-03-04,6,492,649,157,942
101,19,5,2025-03-31,17,352,413,61,1037
168,13,8,2025-03-28,18,198,229,31,558
276,10,13,2025-03-06,1,402,583,181,181
241,17,8,2025-03-12,4,173,217,44,176
336,7,8,2025-03-11,15,52,78,26,390
265,18,13,2025-03-15,13,312,352,40,520
245,2,16,2025-03-17,18,433,484,51,918
764,8,11,2025-03-02,2,133,156,23,46
406,29,10,2025-03-21,7,175,204,29,203
476,13,1,2025-03-20,13,363,494,131,1703
309,1,25,2025-03-16,16,445,592,147,2352
545,26,11,2025-03-11,12,24,35,11,132
210,10,16,2025-03-14,2,181,228,47,94
431,28,21,2025-03-15,13,436,638,202,2626
883,13,6,2025-03-25,15,138,167,29,435
741,9,15,2025-03-04,7,220,282,62,434
967,13,15,2025-03-09,16,322,394,72,1152
460,18,6,2025-03-16,17,300,416,116,1972
980,12,24,2025-03-13,2,211,232,21,42
99,8,15,2025-03-29,12,99,131,32,384
989,17,5,2025-03-31,11,368,467,99,1089
798,18,15,2025-03-31,1,340,436,96,96
357,18,25,2025-03-10,4,67,76,9,36
78,11,6,2025-03-11,18,382,538,156,2808
656,6,6,2025-03-11,8,124,131,7,56
485,14,30,2025-03-02,1,451,563,112,112
264,18,17,2025-03-07,13,446,477,31,403
587,15,12,2025-03-03,1,367,463,96,96
299,30,20,2025-03-01,11,376,425,49,539
208,30,22,2025-03-22,18,262,386,124,2232
383,14,16,2025-03-02,2,182,237,55,110
957,20,7,2025-03-14,18,138,148,10,180
791,28,13,2025-03-14,14,145,153,8,112
231,29,19,2025-03-13,13,235,271,36,468
147,29,27,2025-03-08,14,421,507,86,1204
58,24,29,2025-03-05,9,92,99,7,63
470,12,1,2025-03-29,10,202,215,13,130
296,12,6,2025-03-19,4,280,398,118,472
27,7,12,2025-03-13,3,204,280,76,228
624,16,14,2025-03-26,8,406,537,131,1048
781,8,17,2025-03-29,19,230,275,45,855
530,3,7,2025-03-19,10,442,597,155,1550
919,8,30,2025-03-07,8,259,320,61,488
647,8,21,2025-03-25,20,492,593,101,2020
581,26,5,2025-03-20,17,409,573,164,2788
181,16,21,2025-03-22,18,433,556,123,2214
977,10,18,2025-03-31,20,85,107,22,440
235,8,17,2025-03-22,16,324,418,94,1504
968,6,12,2025-03-02,15,368,515,147,2205
705,27,19,2025-03-09,5,292,344,52,260
60,9,22,2025-03-06,1,88,113,25,25
762,28,7,2025-03-13,4,341,393,52,208
490,27,30,2025-03-08,11,59,73,14,154
593,24,26,2025-03-12,2,287,380,93,186
267,2,21,2025-03-02,17,87,116,29,493
430,30,3,2025-03-09,14,448,519,71,994
811,1,12,2025-03-17,6,196,294,98,588
868,20,12,2025-03-26,20,60,67,7,140
750,1,25,2025-03-04,8,340,449,109,872
741,1,22,2025-03-11,10,170,245,75,750
185,27,5,2025-03-25,12,121,132,11,132
640,15,14,2025-03-28,10,21,24,3,30
386,13,16,2025-03-12,3,187,227,40,120
443,24,22,2025-03-01,8,232,255,23,184
46,22,29,2025-03-29,14,266,391,125,1750
866,20,28,2025-03-14,9,428,458,30,270
225,11,23,2025-03-23,2,59,76,17,34
378,28,20,2025-03-07,12,54,63,9,108
692,12,16,2025-03-24,3,477,585,108,324
379,9,15,2025-03-07,15,150,210,60,900
356,27,2,2025-03-15,15,253,316,63,945
339,30,23,2025-03-08,7,439,472,33,231
215,13,4,2025-03-28,19,31,45,14,266
641,5,18,2025-03-27,6,244,323,79,474
862,22,10,2025-03-23,5,350,389,39,195
501,25,29,2025-03-25,9,400,557,157,1413
719,24,15,2025-03-29,5,487,727,240,1200
798,28,14,2025-03-19,3,161,208,47,141
951,13,17,2025-03-12,5,448,475,27,135
182,10,8,2025-03-13,16,199,260,61,976
976,23,3,2025-03-13,10,170,181,11,110
212,6,30,2025-03-28,7,101,106,5,35
455,4,24,2025-03-04,8,285,337,52,416
581,10,12,2025-03-07,10,267,327,60,600
675,1,29,2025-03-18,6,104,136,32,192
137,5,16,2025-03-23,1,356,460,104,104
497,29,24,2025-03-11,8,417,461,44,352
489,28,29,2025-03-13,19,444,501,57,1083
644,6,13,2025-03-20,9,423,634,211,1899
179,26,22,2025-03-11,15,435,493,58,870
633,18,17,2025-03-23,19,500,716,216,4104
470,3,9,2025-03-12,19,388,529,141,2679
877,22,12,2025-03-21,10,144,159,15,150
754,9,28,2025-03-01,5,154,230,76,380
633,12,25,2025-03-16,2,200,297,97,194
689,11,25,2025-03-30,1,118,124,6,6
921,4,2,2025-03-15,12,166,205,39,468
435,22,10,2025-03-06,1,499,615,116,116
896,6,19,2025-03-31,13,110,118,8,104
22,19,8,2025-03-18,6,459,673,214,1284
713,13,24,2025-03-21,11,442,556,114,1254
958,30,30,2025-03-14,20,379,553,174,3480
189,29,9,2025-03-24,8,178,234,56,448
827,16,16,2025-03-12,18,396,472,76,1368
619,30,26,2025-03-06,17,414,601,187,3179
485,6,10,2025-03-20,19,430,517,87,1653
439,2,7,2025-03-27,2,178,246,68,136
495,8,30,2025-03-08,5,299,445,146,730
31,21,16,2025-03-31,15,42,52,10,150
344,17,3,2025-03-04,18,157,174,17,306
104,19,24,2025-03-09,11,249,367,118,1298
448,26,6,2025-03-04,8,436,559,123,984
114,17,7,2025-03-10,12,315,400,85,1020
517,2,5,2025-03-26,4,421,510,89,356
367,7,10,2025-03-18,13,39,52,13,169
739,8,21,2025-03-06,5,259,366,107,535
48,12,17,2025-03-23,11,409,455,46,506
157,21,3,2025-03-12,15,27,34,7,105
967,12,30,2025-03-28,14,152,168,16,224
994,9,26,2025-03-10,16,270,300,30,480
94,10,27,2025-03-06,6,372,475,103,618
965,22,25,2025-03-06,17,205,241,36,612
499,25,5,2025-03-03,5,204,236,32,160
955,16,3,2025-03-28,17,26,33,7,119
907,18,30,2025-03-19,13,394,519,125,1625
401,19,29,2025-03-22,6,236,265,29,174
624,29,24,2025-03-15,2,496,582,86,172
630,1,17,2025-03-12,2,444,518,74,148
251,23,5,2025-03-06,15,123,172,49,735
95,16,24,2025-03-28,10,315,372,57,570
883,15,20,2025-03-12,16,441,640,199,3184
319,22,21,2025-03-28,4,460,642,182,728
227,1,29,2025-03-10,19,322,468,146,2774
217,11,9,2025-03-03,14,441,500,59,826
243,1,17,2025-03-13,18,155,181,26,468
713,1,6,2025-03-11,11,83,124,41,451
612,9,2,2025-03-13,7,468,498,30,210
81,25,28,2025-03-26,18,292,420,128,2304
328,29,8,2025-03-13,18,344,479,135,2430
656,17,27,2025-03-08,2,343,412,69,138
482,6,30,2025-03-12,19,244,294,50,950
182,5,5,2025-03-09,18,193,254,61,1098
364,26,24,2025-03-07,9,409,516,107,963
110,2,28,2025-03-25,4,402,591,189,756
824,21,12,2025-03-07,12,21,27,6,72
654,30,4,2025-03-20,6,156,198,42,252
661,29,15,2025-03-12,8,329,404,75,600
541,5,14,2025-03-30,13,480,602,122,1586
458,16,15,2025-03-27,4,153,195,42,168
492,28,11,2025-03-12,9,31,41,10,90
637,2,5,2025-03-21,16,400,592,192,3072
31,19,2,2025-03-27,14,178,196,18,252
132,11,14,2025-03-25,1,426,496,70,70
998,22,16,2025-03-04,6,492,524,32,192
644,24,29,2025-03-11,18,234,349,115,2070
166,6,11,2025-03-08,17,183,194,11,187
244,15,6,2025-03-18,18,217,232,15,270
768,8,20,2025-03-26,19,400,453,53,1007
185,15,5,2025-03-01,2,268,293,25,50
307,19,14,2025-03-16,3,156,174,18,54
998,11,6,2025-03-15,1,455,562,107,107
622,28,27,2025-03-01,17,223,312,89,1513
813,15,13,2025-03-26,7,287,339,52,364
564,10,13,2025-03-16,11,484,719,235,2585
919,9,25,2025-03-09,1,231,284,53,53
580,5,26,2025-03-16,6,66,75,9,54
802,6,14,2025-03-23,9,499,612,113,1017
76,21,5,2025-03-02,6,57,85,28,168
403,12,19,2025-03-23,8,32,37,5,40
212,16,30,2025-03-03,13,320,350,30,390
810,10,2,2025-03-20,5,68,72,4,20
774,13,8,2025-03-31,18,468,589,121,2178
741,8,11,2025-03-15,2,408,452,44,88
541,25,27,2025-03-20,11,194,205,11,121
63,16,8,2025-03-11,1,409,465,56,56
774,6,29,2025-03-31,18,34,40,6,108
704,17,15,2025-03-03,5,99,108,9,45
882,12,18,2025-03-07,4,373,534,161,644
238,28,11,2025-03-22,13,272,401,129,1677
9,26,16,2025-03-23,10,196,228,32,320
238,10,25,2025-03-15,18,83,95,12,216
347,2,27,2025-03-30,4,57,72,15,60
997,12,6,2025-03-18,13,387,432,45,585
54,6,5,2025-03-13,7,235,248,13,91
290,27,15,2025-03-10,13,76,84,8,104
117,18,3,2025-03-01,7,201,300,99,693
38,21,21,2025-03-18,9,206,268,62,558
531,19,21,2025-03-24,20,190,220,30,600
353,11,17,2025-03-27,3,357,518,161,483
715,24,12,2025-03-16,5,116,130,14,70
449,23,4,2025-03-24,4,248,360,112,448
324,7,30,2025-03-11,16,103,149,46,736
219,9,10,2025-03-29,12,219,251,32,384
594,30,8,2025-03-04,19,452,513,61,1159
759,12,26,2025-03-22,8,317,470,153,1224
973,19,6,2025-03-20,4,291,345,54,216
88,23,5,2025-03-02,19,473,703,230,4370
820,25,21,2025-03-20,1,449,593,144,144
503,11,30,2025-03-30,5,315,423,108,540
62,22,28,2025-03-15,5,244,341,97,485
746,19,29,2025-03-06,2,263,303,40,80
598,9,15,2025-03-04,7,64,80,16,112
322,5,5,2025-03-19,10,372,548,176,1760
804,1,5,2025-03-12,18,435,619,184,3312
62,3,29,2025-03-10,20,402,483,81,1620
286,2,25,2025-03-27,7,292,308,16,112
381,13,30,2025-03-24,1,189,248,59,59
993,28,20,2025-03-25,10,480,592,112,1120
985,29,5,2025-03-31,17,281,407,126,2142
391,17,22,2025-03-24,19,161,195,34,646
978,27,7,2025-03-30,14,334,460,126,1764
174,25,1,2025-03-29,3,82,116,34,102
488,15,13,2025-03-15,20,240,346,106,2120
24,6,11,2025-03-05,10,341,474,133,1330
841,2,24,2025-03-19,10,127,136,9,90
559,3,2,2025-03-03,2,398,574,176,352
865,11,8,2025-03-25,8,256,324,68,544
306,1,12,2025-03-19,12,306,439,133,1596
606,15,1,2025-03-29,12,240,359,119,1428
528,19,9,2025-03-21,15,319,441,122,1830
254,26,14,2025-03-28,17,150,217,67,1139
577,24,10,2025-03-24,16,462,502,40,640
8,29,24,2025-03-16,12,215,263,48,576
829,13,29,2025-03-30,15,218,269,51,765
150,18,7,2025-03-14,12,68,93,25,300
636,24,8,2025-03-06,5,493,626,133,665
767,10,30,2025-03-29,16,467,593,126,2016
34,16,15,2025-03-25,6,246,338,92,552
842,10,25,2025-03-12,7,47,64,17,119
87,1,17,2025-03-24,14,222,273,51,714
739,20,12,2025-03-04,20,123,168,45,900
625,20,1,2025-03-09,15,164,229,65,975
186,11,10,2025-03-19,7,78,107,29,203
856,25,2,2025-03-06,13,87,99,12,156
614,30,16,2025-03-05,14,37,43,6,84
109,26,2,2025-03-06,5,478,672,194,970
854,17,21,2025-03-07,16,217,266,49,784
584,5,26,2025-03-25,20,160,188,28,560
719,29,16,2025-03-21,14,363,467,104,1456
25,5,6,2025-03-28,6,138,199,61,366
790,24,25,2025-03-03,8,237,262,25,200
29,24,4,2025-03-02,3,66,93,27,81
857,28,5,2025-03-30,1,206,286,80,80
161,14,8,2025-03-28,5,58,62,4,20
442,17,6,2025-03-16,17,449,647,198,3366
701,28,21,2025-03-16,10,239,302,63,630
993,29,20,2025-03-26,14,43,64,21,294
996,16,8,2025-03-29,9,286,415,129,1161
714,10,1,2025-03-03,3,350,387,37,111
263,27,13,2025-03-17,10,27,30,3,30
671,6,2,2025-03-02,15,494,570,76,1140
418,12,20,2025-03-12,12,211,266,55,660
874,16,23,2025-03-03,18,120,128,8,144
146,25,2,2025-03-23,9,288,401,113,1017
604,26,2,2025-03-22,16,154,174,20,320
286,2,7,2025-03-01,17,415,512,97,1649
807,25,29,2025-03-06,9,169,194,25,225
704,8,8,2025-03-11,15,239,353,114,1710
948,13,14,2025-03-26,12,151,173,22,264
749,9,13,2025-03-08,8,21,27,6,48
390,25,18,2025-03-21,20,202,227,25,500
787,16,16,2025-03-05,7,81,92,11,77
278,19,19,2025-03-25,5,137,184,47,235
703,29,4,2025-03-17,2,478,621,143,286
729,16,12,2025-03-12,4,326,425,99,396
492,12,18,2025-03-17,6,428,550,122,732
334,14,12,2025-03-06,10,467,514,47,470
593,6,15,2025-03-12,15,280,419,139,2085
132,9,1,2025-03-12,15,76,82,6,90
682,12,23,2025-03-05,14,314,333,19,266
268,9,3,2025-03-26,16,153,210,57,912
320,19,3,2025-03-07,12,182,263,81,972
635,10,27,2025-03-07,18,297,378,81,1458
494,30,17,2025-03-20,9,107,113,6,54
867,3,8,2025-03-17,13,158,217,59,767
207,19,2,2025-03-13,17,85,116,31,527
541,8,10,2025-03-11,8,407,487,80,640
806,3,29,2025-03-28,12,239,348,109,1308
997,9,24,2025-03-23,3,305,403,98,294
997,21,16,2025-03-12,7,410,507,97,679
57,8,5,2025-03-29,15,214,299,85,1275
630,7,19,2025-03-13,13,364,504,140,1820
242,5,23,2025-03-08,18,106,158,52,936
700,2,22,2025-03-07,9,55,59,4,36
356,18,9,2025-03-08,17,127,148,21,357
717,20,28,2025-03-28,20,457,582,125,2500
387,23,12,2025-03-08,3,374,539,165,495
583,27,17,2025-03-25,19,51,54,3,57
660,22,24,2025-03-18,13,400,461,61,793
427,18,19,2025-03-26,1,159,220,61,61
63,4,28,2025-03-13,6,318,452,134,804
86,10,13,2025-03-01,16,74,109,35,560
507,18,11,2025-03-17,2,66,78,12,24
177,10,22,2025-03-22,12,380,546,166,1992
235,18,24,2025-03-23,12,107,144,37,444
811,29,17,2025-03-12,17,361,435,74,1258
285,25,14,2025-03-12,9,409,450,41,369
451,18,18,2025-03-01,7,30,33,3,21
305,19,30,2025-03-09,13,212,274,62,806
116,11,7,2025-03-10,6,199,294,95,570
615,17,24,2025-03-12,3,431,459,28,84
231,14,23,2025-03-22,8,416,487,71,568
911,30,11,2025-03-10,15,464,695,231,3465
584,25,1,2025-03-12,12,453,477,24,288
763,1,28,2025-03-22,9,213,248,35,315
334,15,29,2025-03-05,18,314,435,121,2178
457,4,28,2025-03-14,20,180,259,79,1580
201,24,18,2025-03-15,10,194,240,46,460
228,7,24,2025-03-01,13,122,167,45,585
509,3,4,2025-03-14,17,66,92,26,442
230,15,1,2025-03-14,5,203,274,71,355
599,30,3,2025-03-14,15,79,111,32,480
88,1,28,2025-03-03,11,60,76,16,176
781,9,9,2025-03-04,1,152,173,21,21
1000,6,24,2025-03-10,4,229,290,61,244
163,9,9,2025-03-21,4,171,234,63,252
220,18,23,2025-03-08,5,96,125,29,145
218,14,6,2025-03-22,4,351,370,19,76
919,16,13,2025-03-22,4,101,121,20,80
599,11,22,2025-03-11,4,104,120,16,64
61,26,30,2025-03-28,8,64,72,8,64
250,28,25,2025-03-30,14,97,124,27,378
535,23,3,2025-03-12,16,277,310,33,528
7,2,17,2025-03-09,7,350,416,66,462
354,26,1,2025-03-17,5,400,555,155,775
673,22,28,2025-03-07,12,409,607,198,2376
870,23,27,2025-03-04,11,481,524,43,473
208,7,14,2025-03-23,5,47,51,4,20
173,7,13,2025-03-28,12,65,73,8,96
228,11,1,2025-03-02,17,340,420,80,1360
370,7,28,2025-03-02,1,288,392,104,104
120,4,9,2025-03-29,3,309,403,94,282
180,11,22,2025-03-24,11,113,134,21,231
491,4,16,2025-03-24,7,432,581,149,1043
284,3,30,2025-03-26,11,255,291,36,396
173,21,4,2025-03-09,17,102,108,6,102
314,28,11,2025-03-25,19,115,156,41,779
268,19,29,2025-03-14,18,464,567,103,1854
435,5,5,2025-03-14,15,49,64,15,225
441,24,26,2025-03-20,8,282,348,66,528
952,30,23,2025-03-07,12,149,177,28,336
19,26,3,2025-03-27,15,213,237,24,360
59,8,5,2025-03-21,18,199,253,54,972
992,11,17,2025-03-13,19,229,247,18,342
903,14,12,2025-03-03,19,485,628,143,2717
599,23,15,2025-03-30,9,352,528,176,1584
63,1,23,2025-03-10,10,377,492,115,1150
845,10,17,2025-03-12,19,230,263,33,627
249,6,8,2025-03-01,18,307,459,152,2736
703,19,17,2025-03-09,16,108,137,29,464
932,25,24,2025-03-01,14,147,161,14,196
79,6,7,2025-03-20,16,463,584,121,1936
376,4,23,2025-03-08,2,451,602,151,302
618,5,25,2025-03-04,9,130,166,36,324
235,5,11,2025-03-02,18,136,165,29,522
163,22,7,2025-03-29,13,407,589,182,2366
478,4,26,2025-03-31,2,216,280,64,128
676,23,4,2025-03-14,13,22,31,9,117
147,25,10,2025-03-29,3,453,565,112,336
937,1,11,2025-03-25,9,489,525,36,324
236,19,1,2025-03-14,3,496,565,69,207
950,13,16,2025-03-30,7,337,396,59,413
868,6,30,2025-03-12,5,439,630,191,955
996,4,22,2025-03-15,4,117,155,38,152
572,19,24,2025-03-25,16,378,434,56,896
627,3,15,2025-03-25,14,495,718,223,3122
807,24,13,2025-03-19,1,273,289,16,16
555,10,23,2025-03-03,12,299,344,45,540
53,26,16,2025-03-14,19,245,289,44,836
955,20,19,2025-03-14,13,392,563,171,2223
575,6,22,2025-03-10,13,214,249,35,455
194,6,14,2025-03-28,6,390,447,57,342
385,2,30,2025-03-22,7,425,565,140,980
184,27,4,2025-03-30,12,418,556,138,1656
553,21,11,2025-03-10,7,236,281,45,315
842,20,17,2025-03-04,3,93,137,44,132
267,17,12,2025-03-01,11,389,523,134,1474
232,11,6,2025-03-25,19,278,406,128,2432
960,22,24,2025-03-29,19,27,36,9,171
244,2,21,2025-03-11,20,110,152,42,840
89,10,28,2025-03-19,14,195,287,92,1288
686,16,30,2025-03-30,17,245,343,98,1666
206,23,11,2025-03-18,16,333,441,108,1728
555,30,20,2025-03-30,15,381,494,113,1695
240,21,16,2025-03-19,6,363,482,119,714
538,8,15,2025-03-12,20,389,410,21,420
657,22,8,2025-03-16,13,153,198,45,585
229,15,23,2025-03-15,16,92,118,26,416
168,19,23,2025-03-06,4,107,122,15,60
712,30,20,2025-03-08,19,108,116,8,152
476,21,28,2025-03-06,4,37,43,6,24
625,19,20,2025-03-11,12,497,692,195,2340
597,28,27,2025-03-17,12,475,563,88,1056
767,19,8,2025-03-30,10,387,447,60,600
100,9,22,2025-03-03,4,310,333,23,92
973,21,23,2025-03-22,16,215,315,100,1600
856,13,2,2025-03-02,10,35,48,13,130
477,8,30,2025-03-30,13,488,622,134,1742
446,9,14,2025-03-03,19,255,320,65,1235
480,1,26,2025-03-23,4,418,522,104,416
906,12,28,2025-03-05,8,255,316,61,488
384,29,7,2025-03-02,4,204,275,71,284
972,9,18,2025-03-21,16,409,503,94,1504
332,18,3,2025-03-23,8,151,202,51,408
387,25,28,2025-03-23,12,461,593,132,1584
633,25,26,2025-03-11,7,315,365,50,350
550,5,15,2025-03-02,10,114,130,16,160
143,9,16,2025-03-24,2,366,483,117,234
636,23,16,2025-03-29,19,367,438,71,1349
987,25,15,2025-03-25,19,211,290,79,1501
67,14,15,2025-03-13,7,88,123,35,245
714,11,12,2025-03-07,11,409,542,133,1463
934,20,10,2025-03-26,1,185,248,63,63
55,22,23,2025-03-07,3,48,59,11,33
809,12,10,2025-03-23,15,408,534,126,1890
881,12,3,2025-03-12,11,207,244,37,407
324,14,13,2025-03-21,12,441,591,150,1800
26,9,6,2025-03-07,12,121,150,29,348
69,17,4,2025-03-14,10,87,108,21,210
787,23,6,2025-03-27,10,67,95,28,280
152,3,22,2025-03-10,2,324,435,111,222
172,22,17,2025-03-10,10,110,130,20,200
10,6,2,2025-03-19,15,173,228,55,825
236,10,22,2025-03-01,19,416,493,77,1463
779,28,6,2025-03-16,12,268,379,111,1332
959,12,22,2025-03-04,20,425,575,150,3000
362,14,13,2025-03-20,2,386,493,107,214
320,24,22,2025-03-01,18,363,464,101,1818
641,18,20,2025-03-12,18,337,431,94,1692
779,3,4,2025-03-05,17,164,176,12,204
662,16,28,2025-03-13,2,230,248,18,36
741,15,12,2025-03-28,19,408,482,74,1406
381,11,25,2025-03-29,12,443,579,136,1632
117,23,5,2025-03-21,1,302,408,106,106
798,30,4,2025-03-30,8,466,578,112,896
789,3,13,2025-03-27,20,259,313,54,1080
495,30,5,2025-03-08,6,160,181,21,126
705,1,26,2025-03-27,8,370,522,152,1216
317,19,9,2025-03-03,20,322,477,155,3100
149,9,4,2025-03-09,3,60,78,18,54
965,22,10,2025-03-16,18,324,392,68,1224
442,29,16,2025-03-14,14,322,432,110,1540
662,2,5,2025-03-29,11,120,170,50,550
7,23,5,2025-03-15,6,152,182,30,180
694,8,30,2025-03-15,15,208,289,81,1215
874,9,22,2025-03-26,9,153,217,64,576
274,7,6,2025-03-18,7,236,249,13,91
62,4,27,2025-03-23,12,491,710,219,2628
432,10,24,2025-03-21,5,71,90,19,95
806,12,16,2025-03-29,14,132,165,33,462
144,19,8,2025-03-27,3,392,478,86,258
166,25,4,2025-03-07,9,228,279,51,459
355,11,9,2025-03-26,18,335,381,46,828
848,7,21,2025-03-24,12,369,518,149,1788
528,19,23,2025-03-31,15,437,467,30,450
303,11,30,2025-03-14,8,487,655,168,1344
790,26,13,2025-03-29,9,436,645,209,1881
16,1,9,2025-03-10,19,78,88,10,190
397,21,12,2025-03-12,1,431,631,200,200
627,22,5,2025-03-02,13,376,462,86,1118
921,20,11,2025-03-25,5,479,588,109,545
243,27,17,2025-03-04,7,484,532,48,336
172,26,24,2025-03-11,4,63,80,17,68
146,11,14,2025-03-17,12,229,278,49,588
732,14,13,2025-03-18,7,210,306,96,672
102,30,2,2025-03-03,6,189,272,83,498
491,1,17,2025-03-29,9,63,90,27,243
302,21,22,2025-03-14,4,448,517,69,276
529,23,15,2025-03-21,1,226,317,91,91
334,14,9,2025-03-08,20,92,118,26,520
129,26,2,2025-03-05,3,484,595,111,333
172,1,29,2025-03-31,11,489,610,121,1331
431,17,6,2025-03-07,11,177,261,84,924
697,7,5,2025-03-29,20,400,474,74,1480
441,9,29,2025-03-02,19,88,127,39,741
572,19,12,2025-03-14,10,191,202,11,110
715,17,30,2025-03-12,7,164,220,56,392
604,23,19,2025-03-30,15,275,317,42,630
960,10,6,2025-03-21,8,123,145,22,176
460,3,4,2025-03-24,14,116,147,31,434
951,2,13,2025-03-13,20,132,186,54,1080
112,26,1,2025-03-15,13,252,347,95,1235
819,25,3,2025-03-11,3,472,614,142,426
126,6,16,2025-03-13,17,427,480,53,901
118,8,16,2025-03-07,6,98,146,48,288
621,21,2,2025-03-23,18,412,545,133,2394
632,18,5,2025-03-30,16,215,281,66,1056
833,25,7,2025-03-26,1,453,537,84,84
328,14,8,2025-03-29,3,246,299,53,159
717,1,3,2025-03-17,6,183,239,56,336
135,14,26,2025-03-16,11,109,160,51,561
994,23,10,2025-03-24,5,489,610,121,605
802,24,13,2025-03-17,1,388,428,40,40
532,11,2,2025-03-07,8,77,107,30,240
749,4,26,2025-03-01,6,456,505,49,294
271,18,27,2025-03-13,1,484,551,67,67
956,21,5,2025-03-06,16,439,574,135,2160
420,21,3,2025-03-22,8,172,227,55,440
576,12,19,2025-03-20,6,211,302,91,546
994,8,3,2025-03-21,1,97,138,41,41
794,2,24,2025-03-22,2,111,148,37,74
134,13,24,2025-03-11,19,476,699,223,4237
698,12,11,2025-03-22,5,314,391,77,385
794,5,24,2025-03-12,15,85,118,33,495
281,12,9,2025-03-15,9,195,265,70,630
829,17,5,2025-03-14,16,476,508,32,512
522,17,27,2025-03-11,5,202,230,28,140
457,26,23,2025-03-16,5,168,232,64,320
567,17,4,2025-03-08,12,352,430,78,936
350,3,9,2025-03-23,12,154,177,23,276
619,30,2,2025-03-06,3,43,63,20,60
311,6,18,2025-03-24,5,83,107,24,120
9,11,13,2025-03-18,19,417,465,48,912
375,14,27,2025-03-01,18,209,234,25,450
736,19,20,2025-03-06,4,395,541,146,584
175,23,12,2025-03-12,18,473,508,35,630
156,17,24,2025-03-11,3,305,335,30,90
628,22,17,2025-03-23,17,476,613,137,2329
332,25,4,2025-03-03,19,73,102,29,551
267,24,1,2025-03-30,17,485,630,145,2465
884,8,22,2025-03-27,14,182,215,33,462
443,24,12,2025-03-23,17,432,503,71,1207
641,19,30,2025-03-24,17,137,159,22,374
680,21,21,2025-03-12,11,458,665,207,2277
648,27,30,2025-03-28,19,152,206,54,1026
224,5,4,2025-03-05,4,84,100,16,64
361,17,14,2025-03-23,18,197,262,65,1170
291,27,28,2025-03-11,1,207,231,24,24
468,17,3,2025-03-30,1,434,601,167,167
570,27,8,2025-03-17,11,356,512,156,1716
107,27,25,2025-03-01,11,172,203,31,341
288,4,21,2025-03-09,19,263,309,46,874
319,23,25,2025-03-25,7,458,551,93,651
54,22,4,2025-03-31,15,52,72,20,300
256,7,4,2025-03-17,1,231,326,95,95
489,15,19,2025-03-01,8,294,319,25,200
546,30,27,2025-03-15,13,335,500,165,2145
135,14,25,2025-03-21,6,65,68,3,18
915,14,14,2025-03-22,13,229,342,113,1469
948,11,9,2025-03-12,15,239,312,73,1095
890,4,5,2025-03-08,1,271,374,103,103
330,16,28,2025-03-20,6,282,389,107,642
19,6,14,2025-03-12,2,95,136,41,82
386,14,14,2025-03-21,4,486,670,184,736
772,13,11,2025-03-15,4,435,604,169,676
811,25,2,2025-03-16,14,59,75,16,224
206,7,19,2025-03-22,9,276,394,118,1062
519,5,11,2025-03-12,15,156,166,10,150
818,4,24,2025-03-12,15,374,450,76,1140
330,28,1,2025-03-16,9,394,576,182,1638
801,26,14,2025-03-19,14,336,442,106,1484
636,23,28,2025-03-08,3,443,494,51,153
428,30,15,2025-03-27,12,172,246,74,888
516,25,20,2025-03-17,8,450,658,208,1664
692,20,1,2025-03-02,11,156,229,73,803
228,10,5,2025-03-01,12,145,183,38,456
838,24,15,2025-03-07,1,163,224,61,61
772,12,19,2025-03-21,17,71,87,16,272
633,26,24,2025-03-21,20,121,166,45,900
469,19,25,2025-03-25,7,103,151,48,336
246,29,11,2025-03-02,11,36,45,9,99
674,2,30,2025-03-16,9,262,341,79,711
46,1,17,2025-03-10,17,194,221,27,459
946,18,22,2025-03-21,18,134,191,57,1026
536,6,20,2025-03-02,9,238,334,96,864
196,20,9,2025-03-12,7,281,323,42,294
487,20,13,2025-03-06,19,82,87,5,95
451,1,20,2025-03-08,12,58,64,6,72
585,29,7,2025-03-24,4,32,42,10,40
873,11,2,2025-03-21,11,85,122,37,407
29,2,15,2025-03-18,18,124,140,16,288
329,2,5,2025-03-04,14,104,143,39,546
179,5,16,2025-03-29,4,409,526,117,468
951,14,14,2025-03-29,8,478,579,101,808
501,29,6,2025-03-16,2,297,424,127,254
864,7,17,2025-03-27,10,151,197,46,460
571,12,12,2025-03-07,9,347,389,42,378
984,23,1,2025-03-03,7,187,254,67,469
119,1,15,2025-03-29,9,93,110,17,153
288,3,11,2025-03-16,15,252,311,59,885
292,28,17,2025-03-16,9,333,480,147,1323
270,22,19,2025-03-24,8,255,381,126,1008
12,19,15,2025-03-27,1,383,481,98,98
949,11,30,2025-03-13,3,358,396,38,114
553,8,27,2025-03-08,13,397,532,135,1755
886,20,15,2025-03-21,16,139,156,17,272
948,26,4,2025-03-23,13,60,64,4,52
661,17,11,2025-03-14,19,369,414,45,855
14,15,29,2025-03-13,4,446,590,144,576
851,30,23,2025-03-01,10,109,126,17,170
826,9,19,2025-03-05,20,353,373,20,400
837,14,2,2025-03-11,13,400,471,71,923
128,7,2,2025-03-11,1,279,413,134,134
164,28,22,2025-03-11,20,248,266,18,360
817,11,14,2025-03-22,19,100,106,6,114
567,10,22,2025-03-16,16,52,63,11,176
857,13,25,2025-03-21,10,84,89,5,50
225,4,27,2025-03-30,18,247,364,117,2106
932,8,8,2025-03-19,13,346,472,126,1638
469,3,21,2025-03-07,1,478,565,87,87
393,15,28,2025-03-30,3,175,249,74,222
707,20,21,2025-03-28,4,94,125,31,124
469,4,11,2025-03-13,10,252,315,63,630
198,16,10,2025-03-15,9,243,313,70,630
992,6,25,2025-03-12,15,103,111,8,120
697,17,29,2025-03-20,16,493,556,63,1008
40,17,17,2025-03-02,4,131,185,54,216
745,23,19,2025-03-29,4,221,262,41,164
12,30,18,2025-03-13,18,256,286,30,540
230,28,3,2025-03-29,8,407,455,48,384
140,5,23,2025-03-02,1,125,183,58,58
273,30,22,2025-03-30,19,189,247,58,1102
912,22,2,2025-03-27,16,468,686,218,3488
25,22,19,2025-03-04,2,184,270,86,172
71,23,15,2025-03-13,17,370,511,141,2397
771,17,1,2025-03-08,17,422,505,83,1411
250,7,12,2025-03-20,14,349,417,68,952
662,24,8,2025-03-06,20,329,349,20,400
402,9,21,2025-03-13,11,493,733,240,2640
659,12,10,2025-03-14,19,416,527,111,2109
340,15,17,2025-03-31,12,271,367,96,1152
529,14,26,2025-03-09,10,55,59,4,40
498,15,6,2025-03-04,1,268,342,74,74
124,30,29,2025-03-15,19,206,226,20,380
61,24,15,2025-03-30,9,409,522,113,1017
259,21,19,2025-03-19,5,380,515,135,675
5,28,29,2025-03-13,14,235,351,116,1624
133,7,20,2025-03-23,19,267,281,14,266
757,26,29,2025-03-31,8,292,388,96,768
85,1,11,2025-03-06,3,152,203,51,153
167,13,1,2025-03-02,9,477,694,217,1953
538,2,4,2025-03-12,20,423,505,82,1640
503,10,12,2025-03-18,13,311,347,36,468
555,2,14,2025-03-16,7,87,110,23,161
86,6,7,2025-03-18,15,139,169,30,450
127,19,20,2025-03-20,9,396,546,150,1350
535,25,9,2025-03-22,10,393,414,21,210
71,25,14,2025-03-15,18,363,525,162,2916
27,29,1,2025-03-14,6,445,582,137,822
799,16,4,2025-03-22,7,211,271,60,420
319,2,9,2025-03-24,14,313,361,48,672
740,11,12,2025-03-03,11,218,251,33,363
347,10,21,2025-03-02,7,353,445,92,644
90,18,16,2025-03-16,8,285,333,48,384
799,9,20,2025-03-23,14,169,243,74,1036
650,16,4,2025-03-13,8,346,466,120,960
531,22,4,2025-03-29,19,22,23,1,19
810,20,8,2025-03-21,6,274,328,54,324
10,18,19,2025-03-20,15,366,436,70,1050
807,25,20,2025-03-16,11,102,144,42,462
896,30,5,2025-03-18,17,307,347,40,680
85,20,17,2025-03-14,14,461,595,134,1876
902,29,10,2025-03-10,1,142,170,28,28
328,25,4,2025-03-11,8,313,341,28,224
523,27,27,2025-03-04,9,64,77,13,117
743,26,10,2025-03-25,9,461,530,69,621
302,21,20,2025-03-29,1,283,360,77,77
751,9,25,2025-03-07,9,57,76,19,171
617,11,30,2025-03-23,17,325,448,123,2091
607,4,29,2025-03-09,9,243,306,63,567
921,18,18,2025-03-13,5,258,304,46,230
939,20,27,2025-03-28,11,471,505,34,374
687,7,7,2025-03-20,16,154,214,60,960
542,23,25,2025-03-01,16,114,126,12,192
157,20,25,2025-03-26,7,348,447,99,693
75,29,18,2025-03-31,2,198,227,29,58
113,2,21,2025-03-05,5,419,569,150,750
703,27,6,2025-03-07,1,147,192,45,45
200,23,28,2025-03-08,3,72,83,11,33
100,22,13,2025-03-06,12,344,387,43,516
232,4,6,2025-03-18,10,360,422,62,620
656,5,7,2025-03-16,11,81,95,14,154
112,17,12,2025-03-07,4,182,194,12,48
849,5,12,2025-03-06,16,31,41,10,160
407,14,17,2025-03-15,7,144,211,67,469
266,17,5,2025-03-27,5,497,571,74,370
918,26,4,2025-03-06,11,279,317,38,418
482,29,2,2025-03-19,4,276,327,51,204
696,9,20,2025-03-10,6,306,441,135,810
813,8,4,2025-03-06,12,258,285,27,324
914,15,13,2025-03-16,18,200,219,19,342
150,20,25,2025-03-05,4,317,393,76,304
529,12,6,2025-03-18,18,369,415,46,828
489,11,22,2025-03-07,2,91,117,26,52
439,9,5,2025-03-09,19,168,242,74,1406
146,12,28,2025-03-04,7,324,466,142,994
509,12,1,2025-03-19,15,448,492,44,660
116,15,27,2025-03-30,12,308,326,18,216
479,23,11,2025-03-01,3,396,497,101,303
380,3,17,2025-03-19,7,107,159,52,364
559,30,1,2025-03-15,9,175,193,18,162
927,19,29,2025-03-15,16,469,558,89,1424
918,3,18,2025-03-12,18,32,44,12,216
445,4,29,2025-03-19,14,408,460,52,728
565,11,3,2025-03-10,2,443,536,93,186
252,13,19,2025-03-30,10,422,605,183,1830
298,29,7,2025-03-25,16,52,58,6,96
721,29,15,2025-03-18,9,280,368,88,792
414,10,22,2025-03-14,11,242,360,118,1298
156,30,26,2025-03-30,4,112,140,28,112
240,22,23,2025-03-27,5,103,123,20,100
953,29,7,2025-03-10,16,43,57,14,224
944,16,18,2025-03-14,12,396,565,169,2028
730,13,7,2025-03-03,8,137,189,52,416
417,1,26,2025-03-21,14,289,384,95,1330
441,19,17,2025-03-25,10,388,519,131,1310
774,15,6,2025-03-21,13,211,298,87,1131
387,1,7,2025-03-16,19,406,495,89,1691
786,22,2,2025-03-23,11,111,142,31,341
601,19,10,2025-03-10,4,74,108,34,136
973,3,4,2025-03-12,5,485,581,96,480
585,15,27,2025-03-19,8,332,429,97,776
664,25,19,2025-03-06,8,92,127,35,280
369,24,29,2025-03-06,6,192,251,59,354
405,16,16,2025-03-09,16,274,292,18,288
520,23,1,2025-03-03,1,282,358,76,76
679,17,7,2025-03-18,4,157,227,70,280
683,16,12,2025-03-08,20,492,602,110,2200
6,27,1,2025-03-19,20,189,273,84,1680
597,24,30,2025-03-12,17,286,354,68,1156
224,20,26,2025-03-08,8,128,183,55,440
23,28,23,2025-03-27,1,389,582,193,193
157,16,7,2025-03-18,6,461,664,203,1218
672,24,14,2025-03-20,6,466,622,156,936
350,23,11,2025-03-27,3,45,58,13,39
482,29,29,2025-03-30,10,393,422,29,290
989,11,5,2025-03-12,2,45,55,10,20
5,19,21,2025-03-31,14,267,389,122,1708
888,25,8,2025-03-19,5,391,523,132,660
748,23,12,2025-03-30,8,167,223,56,448
933,27,1,2025-03-01,19,202,229,27,513
304,14,10,2025-03-04,19,337,498,161,3059
391,12,22,2025-03-06,12,202,287,85,1020
771,27,20,2025-03-20,10,23,30,7,70
724,1,27,2025-03-13,11,464,690,226,2486
440,7,15,2025-03-01,6,393,429,36,216
281,5,27,2025-03-18,7,392,547,155,1085
910,3,9,2025-03-18,20,128,191,63,1260
527,27,12,2025-03-12,8,69,86,17,136
279,29,7,2025-03-09,4,369,437,68,272
565,7,30,2025-03-19,2,204,221,17,34
463,22,13,2025-03-07,6,384,510,126,756
458,13,24,2025-03-21,7,489,604,115,805
522,13,4,2025-03-20,13,145,171,26,338
693,5,27,2025-03-17,17,309,394,85,1445
566,6,4,2025-03-09,15,466,506,40,600
796,19,15,2025-03-07,8,495,573,78,624
53,1,9,2025-03-16,5,388,579,191,955
144,29,5,2025-03-30,6,186,245,59,354
797,27,11,2025-03-15,16,427,554,127,2032
257,4,8,2025-03-06,20,442,642,200,4000
201,27,5,2025-03-05,20,31,40,9,180
925,15,12,2025-03-20,16,499,669,170,2720
980,8,27,2025-03-12,5,208,289,81,405
388,7,7,2025-03-15,14,272,364,92,1288
242,19,13,2025-03-16,6,241,311,70,420
389,27,29,2025-03-11,20,75,96,21,420
604,11,6,2025-03-13,6,213,260,47,282
356,23,5,2025-03-27,18,435,621,186,3348
697,19,18,2025-03-05,4,55,75,20,80
341,19,5,2025-03-25,9,215,290,75,675
640,11,11,2025-03-21,20,194,264,70,1400
869,30,28,2025-03-05,1,102,122,20,20
20,20,30,2025-03-25,16,406,604,198,3168
643,22,4,2025-03-04,17,250,277,27,459
355,6,3,2025-03-31,14,205,263,58,812
313,5,26,2025-03-03,19,70,101,31,589
86,15,2,2025-03-19,2,314,460,146,292
922,8,4,2025-03-24,13,44,64,20,260
144,19,3,2025-03-25,19,171,185,14,266
202,15,17,2025-03-06,12,217,325,108,1296
327,11,9,2025-03-02,17,23,25,2,34
268,20,17,2025-03-31,6,363,473,110,660
164,7,18,2025-03-23,4,25,37,12,48
791,19,18,2025-03-27,14,463,638,175,2450
334,27,3,2025-03-03,6,86,111,25,150
253,5,16,2025-03-05,16,198,268,70,1120
722,26,24,2025-03-17,17,235,294,59,1003
853,21,22,2025-03-24,19,242,278,36,684
649,3,3,2025-03-16,2,219,298,79,158
857,11,30,2025-03-28,4,203,218,15,60
741,23,5,2025-03-17,4,476,708,232,928
365,12,27,2025-03-11,6,436,585,149,894
678,21,18,2025-03-04,7,77,99,22,154
638,16,11,2025-03-26,6,128,171,43,258
581,21,13,2025-03-04,8,435,527,92,736
31,29,26,2025-03-05,17,450,627,177,3009
96,12,3,2025-03-21,2,367,434,67,134
864,7,24,2025-03-06,11,61,69,8,88
150,15,20,2025-03-23,5,406,561,155,775
917,5,23,2025-03-29,1,403,474,71,71
193,13,8,2025-03-09,9,195,237,42,378
75,5,12,2025-03-09,1,285,336,51,51
810,30,9,2025-03-11,3,417,463,46,138
823,27,13,2025-03-10,13,308,368,60,780
60,28,29,2025-03-28,7,472,527,55,385
363,20,6,2025-03-18,9,422,454,32,288
763,6,5,2025-03-01,11,94,137,43,473
421,3,2,2025-03-14,8,260,375,115,920
899,19,3,2025-03-09,3,459,556,97,291
338,14,28,2025-03-25,18,22,27,5,90
200,29,1,2025-03-10,16,252,352,100,1600
430,5,29,2025-03-02,6,487,612,125,750
706,9,29,2025-03-19,1,435,490,55,55
88,14,10,2025-03-03,1,167,230,63,63
538,5,27,2025-03-28,12,388,446,58,696
710,20,18,2025-03-22,6,77,109,32,192
5,3,29,2025-03-04,11,432,614,182,2002
391,24,26,2025-03-01,4,200,233,33,132
764,5,1,2025-03-28,19,166,233,67,1273
585,23,8,2025-03-31,10,306,448,142,1420
110,22,24,2025-03-24,10,75,84,9,90
939,2,27,2025-03-17,18,260,322,62,1116
501,13,1,2025-03-27,18,261,368,107,1926
826,13,14,2025-03-24,18,443,608,165,2970
690,29,7,2025-03-31,17,423,502,79,1343
106,11,5,2025-03-16,18,97,133,36,648
590,23,16,2025-03-03,7,228,336,108,756
297,5,2,2025-03-07,6,294,421,127,762
71,16,11,2025-03-12,18,470,672,202,3636
857,14,16,2025-03-14,18,430,557,127,2286
83,12,9,2025-03-17,18,174,192,18,324
513,8,17,2025-03-08,2,169,228,59,118
491,7,23,2025-03-30,3,92,102,10,30
602,27,10,2025-03-17,9,451,547,96,864
354,26,13,2025-03-15,20,163,176,13,260
643,28,7,2025-03-04,18,362,398,36,648
694,25,27,2025-03-29,10,243,265,22,220
700,8,4,2025-03-22,17,249,344,95,1615
955,27,25,2025-03-09,2,44,60,16,32
502,2,11,2025-03-02,2,145,188,43,86
522,28,28,2025-03-19,3,119,131,12,36
853,27,17,2025-03-24,2,100,122,22,44
988,7,30,2025-03-23,18,349,425,76,1368
520,22,5,2025-03-07,15,488,639,151,2265
330,21,3,2025-03-23,18,467,603,136,2448
748,22,5,2025-03-24,5,281,360,79,395
29,18,3,2025-03-17,5,373,484,111,555
405,14,16,2025-03-11,19,461,598,137,2603
498,7,4,2025-03-19,14,275,332,57,798
7,8,25,2025-03-23,2,329,441,112,224
112,15,25,2025-03-22,9,334,367,33,297
124,12,11,2025-03-04,7,43,61,18,126
69,13,24,2025-03-02,20,98,142,44,880
734,20,8,2025-03-10,17,117,168,51,867
955,12,25,2025-03-04,20,302,403,101,2020
514,10,15,2025-03-09,17,378,528,150,2550
166,15,25,2025-03-11,3,108,151,43,129
24,6,13,2025-03-08,8,83,115,32,256
505,13,17,2025-03-19,14,287,343,56,784
643,22,21,2025-03-14,9,200,273,73,657
960,13,3,2025-03-07,1,267,348,81,81
584,2,4,2025-03-22,11,53,64,11,121
641,12,17,2025-03-06,17,52,74,22,374
728,17,28,2025-03-30,11,322,408,86,946
825,29,24,2025-03-21,14,380,547,167,2338
309,3,13,2025-03-28,13,204,222,18,234
738,4,29,2025-03-20,12,33,46,13,156
633,5,21,2025-03-19,17,364,477,113,1921
742,28,5,2025-03-26,18,311,394,83,1494
14,30,16,2025-03-14,10,257,298,41,410
116,7,22,2025-03-24,15,198,297,99,1485
301,10,27,2025-03-29,17,108,151,43,731
147,5,8,2025-03-15,9,232,247,15,135
343,27,6,2025-03-26,19,287,428,141,2679
486,16,13,2025-03-30,7,197,208,11,77
847,4,9,2025-03-05,6,83,112,29,174
514,14,3,2025-03-14,20,310,332,22,440
545,5,21,2025-03-03,2,21,27,6,12
900,4,21,2025-03-26,2,39,48,9,18
584,13,14,2025-03-02,1,33,40,7,7
243,8,28,2025-03-24,13,36,43,7,91
876,25,11,2025-03-18,12,269,387,118,1416
144,17,10,2025-03-18,4,435,466,31,124
219,10,17,2025-03-15,18,64,93,29,522
131,10,17,2025-03-26,9,318,379,61,549
797,27,6,2025-03-09,8,174,231,57,456
810,9,12,2025-03-15,8,310,336,26,208
910,23,2,2025-03-24,13,441,605,164,2132
522,29,29,2025-03-17,18,99,145,46,828
127,21,20,2025-03-13,10,97,127,30,300
404,10,29,2025-03-16,13,410,508,98,1274
598,12,27,2025-03-03,3,454,531,77,231
761,13,6,2025-03-30,4,243,280,37,148
522,11,16,2025-03-07,15,88,106,18,270
179,1,29,2025-03-17,3,61,65,4,12
759,22,2,2025-03-15,12,116,127,11,132
7,17,14,2025-03-12,13,27,39,12,156
606,20,30,2025-03-28,14,270,289,19,266
317,15,16,2025-03-11,18,467,547,80,1440
796,17,11,2025-03-21,8,48,62,14,112
990,1,9,2025-03-28,5,215,298,83,415
805,11,9,2025-03-05,7,495,699,204,1428
496,16,30,2025-03-12,20,360,466,106,2120
502,6,24,2025-03-01,16,489,552,63,1008
624,15,27,2025-03-27,4,133,145,12,48
367,2,7,2025-03-16,3,189,272,83,249
487,21,26,2025-03-06,15,430,493,63,945
670,9,6,2025-03-04,6,353,372,19,114
99,19,12,2025-03-24,3,83,100,17,51
961,10,10,2025-03-02,1,222,323,101,101
899,10,25,2025-03-14,10,131,184,53,530
523,16,5,2025-03-17,2,313,361,48,96
639,11,30,2025-03-03,9,236,318,82,738
795,9,10,2025-03-24,11,253,314,61,671
606,19,1,2025-03-04,2,193,273,80,160
44,11,16,2025-03-17,12,272,356,84,1008
512,16,28,2025-03-17,15,131,188,57,855
843,11,3,2025-03-02,5,181,244,63,315
599,26,27,2025-03-09,1,302,359,57,57
326,19,7,2025-03-08,16,37,50,13,208
991,18,6,2025-03-31,17,139,148,9,153
53,22,17,2025-03-11,8,261,320,59,472
132,28,8,2025-03-09,18,312,383,71,1278
812,28,15,2025-03-28,19,189,279,90,1710
215,17,19,2025-03-10,20,463,568,105,2100
324,5,23,2025-03-18,2,477,514,37,74
750,22,12,2025-03-08,13,475,628,153,1989
46,22,15,2025-03-04,5,125,182,57,285
276,2,1,2025-03-13,16,243,327,84,1344
564,20,15,2025-03-14,1,54,69,15,15
346,17,30,2025-03-15,6,335,382,47,282
560,28,29,2025-03-23,12,131,148,17,204
293,21,18,2025-03-23,16,342,472,130,2080
660,17,24,2025-03-10,13,325,372,47,611
440,29,12,2025-03-27,17,64,71,7,119
964,4,16,2025-03-12,13,296,338,42,546
98,6,7,2025-03-24,6,65,71,6,36
948,27,11,2025-03-30,9,270,380,110,990
849,7,30,2025-03-05,10,244,320,76,760
886,22,19,2025-03-26,13,132,147,15,195
604,28,24,2025-03-01,20,427,500,73,1460
807,22,5,2025-03-31,1,153,216,63,63
881,6,26,2025-03-08,18,194,239,45,810
633,7,10,2025-03-06,18,124,164,40,720
501,14,24,2025-03-17,2,368,444,76,152
776,17,12,2025-03-13,12,263,364,101,1212
700,21,30,2025-03-23,20,478,696,218,4360
777,4,27,2025-03-13,19,377,500,123,2337
568,6,9,2025-03-08,19,152,181,29,551
769,23,19,2025-03-03,16,106,121,15,240
764,3,6,2025-03-25,2,283,328,45,90
944,5,28,2025-03-06,13,444,525,81,1053
755,7,11,2025-03-28,12,441,519,78,936
525,4,15,2025-03-19,18,269,402,133,2394
959,2,16,2025-03-06,3,295,368,73,219
68,3,17,2025-03-27,10,307,336,29,290
63,22,27,2025-03-22,7,331,409,78,546
987,12,2,2025-03-26,12,489,702,213,2556
830,11,22,2025-03-13,14,454,614,160,2240
355,2,13,2025-03-27,19,20,29,9,171
176,5,28,2025-03-24,19,206,267,61,1159
1000,22,18,2025-03-19,12,132,174,42,504
635,6,6,2025-03-05,4,233,308,75,300
873,12,23,2025-03-01,11,138,189,51,561
934,5,12,2025-03-20,13,135,165,30,390
474,18,6,2025-03-30,10,70,92,22,220
8,7,14,2025-03-16,16,292,329,37,592
295,10,25,2025-03-22,16,30,32,2,32
798,24,10,2025-03-25,5,368,517,149,745
114,26,16,2025-03-05,10,381,524,143,1430
488,2,27,2025-03-19,18,186,241,55,990
865,7,27,2025-03-23,17,443,550,107,1819
750,18,27,2025-03-10,18,223,318,95,1710
185,11,30,2025-03-12,10,325,347,22,220
347,15,2,2025-03-14,1,404,480,76,76
980,12,17,2025-03-16,2,256,339,83,166
649,26,10,2025-03-08,7,99,126,27,189
892,12,27,2025-03-28,9,310,439,129,1161
78,18,15,2025-03-02,1,229,291,62,62
616,10,13,2025-03-24,15,337,484,147,2205
799,11,11,2025-03-11,13,56,82,26,338
375,12,30,2025-03-03,9,282,403,121,1089
862,6,9,2025-03-03,8,235,282,47,376
943,26,10,2025-03-30,6,451,670,219,1314
540,23,27,2025-03-31,5,268,334,66,330
754,16,24,2025-03-01,2,55,76,21,42
602,17,3,2025-03-24,13,302,413,111,1443
398,17,23,2025-03-22,12,386,417,31,372
988,1,2,2025-03-12,8,181,240,59,472
309,3,13,2025-03-30,3,408,439,31,93
751,9,14,2025-03-23,16,197,241,44,704
617,4,22,2025-03-30,16,183,197,14,224
292,11,10,2025-03-18,13,355,465,110,1430
452,27,19,2025-03-05,5,280,401,121,605
300,13,10,2025-03-01,19,430,603,173,3287
234,12,19,2025-03-18,15,357,418,61,915
902,15,26,2025-03-06,2,291,413,122,244
450,20,4,2025-03-07,8,407,473,66,528
612,29,21,2025-03-16,2,472,569,97,194
524,25,19,2025-03-08,9,314,363,49,441
621,19,2,2025-03-27,7,202,267,65,455
956,21,25,2025-03-16,7,458,628,170,1190
205,11,29,2025-03-08,12,188,232,44,528
113,26,28,2025-03-31,15,112,139,27,405
206,11,19,2025-03-23,2,170,186,16,32
469,8,9,2025-03-23,18,267,304,37,666
816,10,9,2025-03-03,7,386,542,156,1092
362,30,22,2025-03-14,17,293,407,114,1938
922,26,16,2025-03-12,19,404,495,91,1729
89,9,12,2025-03-25,17,63,86,23,391
838,20,19,2025-03-31,3,351,473,122,366
664,26,5,2025-03-18,18,273,352,79,1422
344,1,27,2025-03-18,14,370,555,185,2590
750,23,25,2025-03-15,8,480,657,177,1416
683,12,10,2025-03-24,17,228,317,89,1513
9,17,10,2025-03-02,4,317,436,119,476
269,13,30,2025-03-26,10,325,382,57,570
31,30,6,2025-03-14,18,65,83,18,324
498,29,27,2025-03-15,15,313,421,108,1620
861,29,21,2025-03-04,16,383,438,55,880
12,18,16,2025-03-14,9,429,494,65,585
350,11,30,2025-03-11,5,139,198,59,295
862,14,19,2025-03-20,15,254,288,34,510
385,12,21,2025-03-02,16,119,155,36,576
863,25,10,2025-03-31,19,431,463,32,608
599,4,20,2025-03-19,17,67,82,15,255
352,15,19,2025-03-06,19,250,331,81,1539
108,10,2,2025-03-28,2,127,167,40,80
134,10,30,2025-03-25,2,288,308,20,40
691,3,13,2025-03-28,6,66,86,20,120
607,12,29,2025-03-22,19,401,456,55,1045
344,12,22,2025-03-16,19,433,621,188,3572
177,19,12,2025-03-07,12,148,156,8,96
794,14,8,2025-03-01,11,419,532,113,1243
723,8,3,2025-03-06,4,268,355,87,348
340,25,7,2025-03-28,6,397,469,72,432
916,11,4,2025-03-08,14,368,514,146,2044
994,4,3,2025-03-06,15,380,534,154,2310
324,10,1,2025-03-31,9,104,126,22,198
452,7,24,2025-03-11,18,369,459,90,1620
614,7,13,2025-03-28,17,439,467,28,476
932,16,19,2025-03-11,15,491,636,145,2175
665,26,21,2025-03-24,9,149,218,69,621
442,14,30,2025-03-14,5,218,304,86,430
548,13,20,2025-03-06,3,389,537,148,444
343,10,17,2025-03-17,7,351,419,68,476
318,16,15,2025-03-14,12,105,116,11,132
421,23,25,2025-03-11,2,336,355,19,38
838,17,14,2025-03-05,15,124,166,42,630
395,24,10,2025-03-30,4,374,559,185,740
144,14,25,2025-03-03,14,467,691,224,3136
56,7,24,2025-03-04,11,369,542,173,1903
989,15,10,2025-03-27,17,160,228,68,1156
13,11,13,2025-03-25,2,40,55,15,30
240,29,10,2025-03-01,10,414,468,54,540
344,19,23,2025-03-24,9,145,196,51,459
410,7,11,2025-03-08,4,36,53,17,68
831,22,20,2025-03-27,10,445,511,66,660
366,22,16,2025-03-28,3,256,270,14,42
717,9,1,2025-03-29,16,214,265,51,816
233,4,12,2025-03-04,5,133,183,50,250
398,10,18,2025-03-02,19,385,543,158,3002
37,20,8,2025-03-07,18,353,381,28,504
855,9,8,2025-03-10,6,197,221,24,144
194,26,28,2025-03-02,11,191,235,44,484
295,10,23,2025-03-20,16,120,167,47,752
735,25,4,2025-03-04,19,490,706,216,4104
392,30,13,2025-03-29,9,407,601,194,1746
29,29,26,2025-03-28,19,95,108,13,247
101,21,6,2025-03-20,11,419,443,24,264
689,2,9,2025-03-21,2,458,548,90,180
14,11,10,2025-03-11,15,97,108,11,165
381,20,3,2025-03-14,6,208,230,22,132
762,24,27,2025-03-23,13,252,347,95,1235
714,27,26,2025-03-13,9,310,385,75,675
181,6,28,2025-03-11,4,149,196,47,188
996,28,24,2025-03-12,5,377,519,142,710
291,7,5,2025-03-27,17,394,532,138,2346
505,14,29,2025-03-05,12,215,257,42,504
283,22,15,2025-03-04,17,341,425,84,1428
711,24,29,2025-03-15,7,348,379,31,217
797,2,16,2025-03-26,17,400,588,188,3196
739,27,1,2025-03-05,13,165,237,72,936
206,27,1,2025-03-09,4,224,335,111,444
146,10,2,2025-03-17,18,322,410,88,1584
433,11,25,2025-03-31,13,185,232,47,611
701,4,22,2025-03-18,19,67,72,5,95
586,3,7,2025-03-09,6,299,420,121,726
188,19,29,2025-03-17,17,30,39,9,153
408,3,1,2025-03-16,18,404,497,93,1674
52,15,11,2025-03-10,16,305,374,69,1104
610,11,18,2025-03-08,14,417,551,134,1876
41,17,3,2025-03-01,16,414,516,102,1632
547,20,23,2025-03-01,12,226,256,30,360
532,12,14,2025-03-01,20,491,689,198,3960
532,16,14,2025-03-01,9,126,172,46,414
515,8,2,2025-03-16,16,189,246,57,912
913,11,26,2025-03-19,17,287,381,94,1598
508,22,16,2025-03-05,10,189,248,59,590
494,2,1,2025-03-12,9,296,387,91,819
391,26,20,2025-03-22,5,295,371,76,380
205,25,17,2025-03-05,15,377,409,32,480
295,21,1,2025-03-27,16,119,176,57,912
700,25,4,2025-03-08,15,414,451,37,555
63,23,29,2025-03-06,8,443,521,78,624
651,18,22,2025-03-31,19,250,315,65,1235
678,15,22,2025-03-27,7,49,52,3,21
860,22,11,2025-03-13,13,169,234,65,845
453,28,5,2025-03-12,16,102,118,16,256
693,2,12,2025-03-08,7,422,476,54,378
931,17,14,2025-03-12,10,386,513,127,1270
58,24,14,2025-03-14,2,395,471,76,152
505,22,5,2025-03-02,3,163,173,10,30
126,16,25,2025-03-30,10,407,547,140,1400
536,7,21,2025-03-22,9,91,118,27,243
894,15,21,2025-03-19,9,75,102,27,243
357,14,10,2025-03-16,20,432,569,137,2740
77,27,20,2025-03-30,20,135,202,67,1340
482,9,13,2025-03-18,9,45,64,19,171
721,9,10,2025-03-09,3,433,548,115,345
717,19,18,2025-03-01,9,172,204,32,288
665,2,18,2025-03-30,17,428,543,115,1955
813,18,17,2025-03-15,1,254,324,70,70
320,22,16,2025-03-18,17,467,552,85,1445
492,27,9,2025-03-24,6,493,547,54,324
517,20,19,2025-03-07,3,482,588,106,318
634,18,23,2025-03-24,1,272,313,41,41
810,7,2,2025-03-21,3,385,427,42,126
565,17,6,2025-03-06,17,363,383,20,340
732,4,2,2025-03-06,10,106,140,34,340
880,10,1,2025-03-02,20,470,504,34,680
211,3,21,2025-03-03,5,479,673,194,970
144,30,12,2025-03-02,11,491,629,138,1518
384,13,29,2025-03-10,8,400,588,188,1504
268,6,15,2025-03-05,13,59,72,13,169
340,12,22,2025-03-19,12,151,212,61,732
329,21,16,2025-03-14,1,449,572,123,123
160,17,11,2025-03-13,7,483,586,103,721
668,3,29,2025-03-13,15,311,386,75,1125
796,14,5,2025-03-17,10,128,137,9,90
672,7,16,2025-03-18,3,345,502,157,471
658,23,19,2025-03-26,1,170,197,27,27
245,27,16,2025-03-31,12,356,424,68,816
466,10,8,2025-03-21,19,408,481,73,1387
783,17,18,2025-03-29,4,459,567,108,432
361,28,29,2025-03-17,10,270,368,98,980
258,25,16,2025-03-18,1,341,484,143,143
55,13,6,2025-03-12,20,55,66,11,220
410,22,19,2025-03-11,1,182,193,11,11
295,4,9,2025-03-05,7,460,637,177,1239
861,16,24,2025-03-25,2,95,127,32,64
516,12,30,2025-03-06,5,354,519,165,825
603,25,1,2025-03-17,9,411,464,53,477
187,23,30,2025-03-25,4,325,426,101,404
336,7,23,2025-03-14,1,417,519,102,102
805,7,24,2025-03-14,9,154,172,18,162
974,28,5,2025-03-09,17,71,88,17,289
538,28,18,2025-03-25,14,482,609,127,1778
183,25,9,2025-03-12,3,472,614,142,426
260,21,5,2025-03-26,18,66,97,31,558
917,27,24,2025-03-04,3,221,255,34,102
581,2,7,2025-03-23,16,269,351,82,1312
634,2,5,2025-03-22,15,390,579,189,2835
923,26,23,2025-03-04,16,301,341,40,640
203,8,11,2025-03-22,19,225,317,92,1748
260,18,7,2025-03-20,8,299,397,98,784
646,9,25,2025-03-08,7,206,291,85,595
579,17,23,2025-03-04,6,336,412,76,456
452,11,29,2025-03-27,12,28,38,10,120
730,16,23,2025-03-06,10,352,499,147,1470
618,5,9,2025-03-01,8,188,234,46,368
301,4,22,2025-03-25,5,191,284,93,465
901,21,7,2025-03-31,10,359,535,176,1760
890,16,11,2025-03-26,14,142,173,31,434
331,6,27,2025-03-27,15,483,521,38,570
274,19,13,2025-03-16,18,474,688,214,3852
816,14,9,2025-03-30,8,22,25,3,24
62,15,21,2025-03-29,20,233,295,62,1240
671,20,28,2025-03-29,1,232,286,54,54
430,27,4,2025-03-03,3,101,134,33,99
138,1,6,2025-03-23,5,192,264,72,360
571,16,25,2025-03-24,4,268,325,57,228
21,1,18,2025-03-24,10,154,228,74,740
21,2,17,2025-03-03,11,53,65,12,132
244,6,26,2025-03-10,20,41,53,12,240
704,8,10,2025-03-04,5,184,268,84,420
600,1,19,2025-03-03,13,459,654,195,2535
74,19,26,2025-03-11,18,159,217,58,1044
628,30,7,2025-03-17,17,334,475,141,2397
577,24,22,2025-03-15,20,116,127,11,220
533,10,14,2025-03-30,1,311,413,102,102
563,20,6,2025-03-24,14,274,314,40,560
376,16,30,2025-03-28,12,356,474,118,1416
765,7,30,2025-03-22,3,400,438,38,114
648,27,2,2025-03-29,2,435,461,26,52
720,23,25,2025-03-03,5,215,252,37,185
876,16,7,2025-03-18,9,445,475,30,270
917,19,3,2025-03-12,4,346,381,35,140
789,28,18,2025-03-27,1,164,194,30,30
874,3,19,2025-03-10,6,336,496,160,960
943,3,3,2025-03-05,12,402,585,183,2196
193,9,14,2025-03-10,13,102,116,14,182
5,21,3,2025-03-01,7,376,524,148,1036
603,21,22,2025-03-21,19,72,88,16,304
462,13,18,2025-03-23,15,222,241,19,285
498,30,13,2025-03-14,14,154,178,24,336
278,5,1,2025-03-11,5,348,487,139,695
795,17,26,2025-03-03,5,236,257,21,105
686,2,20,2025-03-12,7,144,196,52,364
901,13,16,2025-03-03,17,168,188,20,340
983,28,7,2025-03-08,14,191,218,27,378
257,29,30,2025-03-09,18,76,99,23,414
1,27,7,2025-03-02,6,199,277,78,468
110,2,16,2025-03-29,9,403,604,201,1809
397,15,12,2025-03-13,9,170,187,17,153
719,26,4,2025-03-03,1,324,383,59,59
322,6,27,2025-03-18,13,436,534,98,1274
731,18,10,2025-03-17,9,30,35,5,45
952,4,5,2025-03-28,14,75,98,23,322
833,9,12,2025-03-19,16,92,114,22,352
851,7,16,2025-03-01,5,325,438,113,565
126,6,4,2025-03-18,2,67,74,7,14
255,11,4,2025-03-09,7,388,513,125,875
833,13,7,2025-03-11,17,454,534,80,1360
176,16,1,2025-03-02,5,373,558,185,925
465,20,3,2025-03-20,13,439,483,44,572
710,7,18,2025-03-27,10,323,471,148,1480
651,27,11,2025-03-15,14,439,534,95,1330
191,2,16,2025-03-20,19,475,561,86,1634
43,16,10,2025-03-23,7,269,387,118,826
680,26,18,2025-03-23,16,443,622,179,2864
606,27,5,2025-03-15,1,199,296,97,97
865,29,10,2025-03-16,1,441,565,124,124
795,7,17,2025-03-20,9,48,69,21,189
824,13,14,2025-03-08,8,418,453,35,280
868,10,19,2025-03-06,19,454,641,187,3553
450,28,6,2025-03-24,16,317,453,136,2176
443,10,28,2025-03-14,5,281,366,85,425
553,12,27,2025-03-20,13,258,281,23,299
579,17,18,2025-03-15,19,270,356,86,1634
502,2,26,2025-03-05,17,127,170,43,731
748,18,14,2025-03-26,8,211,269,58,464
994,5,5,2025-03-25,7,126,171,45,315
634,21,3,2025-03-22,4,397,545,148,592
920,29,17,2025-03-06,6,329,438,109,654
813,21,28,2025-03-22,13,494,567,73,949
575,2,13,2025-03-02,18,156,232,76,1368
483,16,9,2025-03-13,4,387,540,153,612
983,4,10,2025-03-06,19,491,678,187,3553
416,12,20,2025-03-27,14,171,207,36,504
73,1,11,2025-03-14,6,167,180,13,78
908,24,14,2025-03-16,16,156,173,17,272
110,26,18,2025-03-15,15,495,545,50,750
289,9,26,2025-03-06,7,101,130,29,203
316,19,22,2025-03-25,9,265,316,51,459
614,12,26,2025-03-20,2,132,152,20,40
343,18,9,2025-03-10,7,500,694,194,1358
223,19,30,2025-03-27,18,137,154,17,306
449,23,15,2025-03-12,9,200,227,27,243
649,12,5,2025-03-13,17,29,42,13,221
92,26,12,2025-03-29,9,23,33,10,90
976,8,16,2025-03-02,18,443,489,46,828
762,6,3,2025-03-30,9,160,211,51,459
950,6,28,2025-03-26,7,207,253,46,322
10,21,25,2025-03-09,11,225,295,70,770
146,20,7,2025-03-05,20,339,435,96,1920
836,20,7,2025-03-15,16,209,298,89,1424
650,22,24,2025-03-22,18,249,269,20,360
568,30,10,2025-03-20,1,193,232,39,39
464,10,14,2025-03-19,7,251,372,121,847
686,12,24,2025-03-25,15,355,375,20,300
654,3,12,2025-03-08,5,226,335,109,545
44,25,9,2025-03-25,7,336,462,126,882
618,19,12,2025-03-27,10,330,418,88,880
106,30,17,2025-03-25,9,486,625,139,1251
876,11,18,2025-03-04,16,348,372,24,384
448,29,1,2025-03-05,14,173,194,21,294
128,17,5,2025-03-06,13,92,136,44,572
395,4,12,2025-03-08,16,183,237,54,864
894,24,26,2025-03-22,12,128,183,55,660
279,11,23,2025-03-15,12,273,289,16,192
1,24,8,2025-03-15,2,328,472,144,288
573,29,24,2025-03-16,1,434,625,191,191
744,6,2,2025-03-21,18,333,468,135,2430
603,19,9,2025-03-27,8,310,443,133,1064
821,25,10,2025-03-20,7,151,183,32,224
436,9,6,2025-03-12,6,193,215,22,132
423,25,2,2025-03-06,1,67,79,12,12
159,22,5,2025-03-16,4,364,418,54,216
521,1,1,2025-03-28,6,382,422,40,240
444,27,7,2025-03-15,17,83,102,19,323
788,6,29,2025-03-07,2,142,153,11,22
112,1,15,2025-03-05,7,47,64,17,119
78,26,17,2025-03-27,8,473,664,191,1528
922,30,24,2025-03-19,2,66,76,10,20
646,8,14,2025-03-06,10,160,201,41,410
91,10,19,2025-03-02,10,54,70,16,160
654,2,19,2025-03-17,13,92,129,37,481
963,27,26,2025-03-17,8,142,181,39,312
95,8,5,2025-03-12,4,417,587,170,680
846,5,27,2025-03-29,20,83,103,20,400
516,18,10,2025-03-13,15,34,47,13,195
36,24,23,2025-03-30,10,136,195,59,590
701,16,16,2025-03-27,13,433,617,184,2392
856,14,28,2025-03-30,11,111,148,37,407
23,10,9,2025-03-17,4,134,156,22,88
30,23,4,2025-03-13,6,91,136,45,270
410,16,12,2025-03-23,15,366,510,144,2160
621,27,9,2025-03-29,3,268,354,86,258
287,6,8,2025-03-03,16,71,80,9,144
125,2,8,2025-03-14,20,389,504,115,2300
558,20,18,2025-03-30,1,109,123,14,14
962,15,26,2025-03-08,19,53,66,13,247
398,6,19,2025-03-27,20,428,513,85,1700
77,10,26,2025-03-12,2,496,680,184,368
703,23,22,2025-03-21,6,41,55,14,84
463,1,10,2025-03-19,12,91,115,24,288
552,4,18,2025-03-27,10,102,134,32,320
300,20,8,2025-03-20,13,148,214,66,858
250,11,11,2025-03-04,16,312,462,150,2400
483,2,19,2025-03-06,6,201,222,21,126
658,27,5,2025-03-04,14,116,136,20,280
319,26,1,2025-03-23,13,156,200,44,572
411,10,28,2025-03-09,19,122,136,14,266
571,20,25,2025-03-04,9,179,249,70,630
916,18,29,2025-03-25,12,108,161,53,636
580,23,1,2025-03-23,14,41,54,13,182
844,13,16,2025-03-27,3,232,283,51,153
236,22,23,2025-03-12,5,236,265,29,145
826,24,18,2025-03-02,19,233,281,48,912
734,27,7,2025-03-08,5,25,34,9,45
439,12,10,2025-03-16,9,96,112,16,144
780,7,11,2025-03-23,5,100,136,36,180
568,9,13,2025-03-03,11,322,365,43,473
736,4,29,2025-03-10,13,338,374,36,468
178,16,3,2025-03-05,20,228,298,70,1400
997,8,10,2025-03-28,13,175,194,19,247
634,1,28,2025-03-22,20,226,271,45,900
283,12,30,2025-03-31,6,140,153,13,78
51,25,18,2025-03-24,14,223,246,23,322
323,6,2,2025-03-15,5,144,192,48,240
391,19,2,2025-03-18,15,195,277,82,1230
526,26,12,2025-03-03,1,386,482,96,96
228,11,1,2025-03-06,19,36,44,8,152
878,9,21,2025-03-24,11,473,525,52,572
494,14,3,2025-03-29,20,49,59,10,200
950,3,1,2025-03-24,1,198,230,32,32
923,5,30,2025-03-21,14,468,648,180,2520
744,10,16,2025-03-16,15,378,402,24,360
526,21,20,2025-03-17,14,195,215,20,280
446,8,20,2025-03-09,1,172,206,34,34
197,27,25,2025-03-18,16,45,48,3,48
577,20,12,2025-03-01,5,500,601,101,505
406,21,16,2025-03-09,7,417,622,205,1435
181,16,24,2025-03-30,17,119,178,59,1003
147,12,16,2025-03-19,14,189,273,84,1176
653,24,8,2025-03-22,9,346,435,89,801
61,10,5,2025-03-02,20,107,160,53,1060
551,23,19,2025-03-04,13,277,319,42,546
864,22,14,2025-03-10,17,411,536,125,2125
419,27,14,2025-03-23,19,495,725,230,4370
801,27,13,2025-03-31,18,68,101,33,594
241,15,13,2025-03-14,15,58,64,6,90
440,27,23,2025-03-03,12,247,357,110,1320
349,24,30,2025-03-31,17,139,182,43,731
692,6,8,2025-03-16,13,415,601,186,2418
353,21,7,2025-03-16,10,388,505,117,1170
476,3,19,2025-03-06,16,123,138,15,240
899,25,25,2025-03-11,2,159,170,11,22
807,29,24,2025-03-12,2,42,53,11,22
752,7,24,2025-03-08,4,222,299,77,308
77,4,14,2025-03-23,11,304,420,116,1276
998,25,25,2025-03-04,19,398,573,175,3325
770,2,6,2025-03-18,5,443,542,99,495
95,24,9,2025-03-30,1,210,241,31,31
469,29,18,2025-03-03,15,202,214,12,180
163,6,13,2025-03-22,11,197,267,70,770
190,16,11,2025-03-06,16,93,104,11,176
642,18,16,2025-03-09,9,283,327,44,396
7,24,19,2025-03-21,3,87,108,21,63
286,3,14,2025-03-25,13,492,702,210,2730
754,19,8,2025-03-28,15,391,439,48,720
90,28,24,2025-03-17,6,280,317,37,222
897,28,4,2025-03-25,3,439,517,78,234
153,9,13,2025-03-13,7,169,225,56,392
251,8,24,2025-03-07,17,399,471,72,1224
223,22,20,2025-03-28,19,423,587,164,3116
875,14,20,2025-03-22,3,204,278,74,222
880,2,19,2025-03-21,5,43,48,5,25
887,9,1,2025-03-01,16,221,260,39,624
92,27,24,2025-03-21,19,263,288,25,475
172,26,21,2025-03-01,2,364,412,48,96
991,14,25,2025-03-07,7,246,300,54,378
753,4,24,2025-03-09,3,326,469,143,429
273,19,8,2025-03-13,8,72,77,5,40
249,20,8,2025-03-17,19,100,119,19,361
42,15,28,2025-03-11,16,429,631,202,3232
783,25,13,2025-03-13,8,155,214,59,472
370,2,27,2025-03-11,11,444,656,212,2332
426,27,20,2025-03-17,11,59,77,18,198
84,18,10,2025-03-26,17,59,76,17,289
507,27,23,2025-03-18,19,305,351,46,874
556,17,3,2025-03-26,14,139,178,39,546
334,1,4,2025-03-24,9,170,228,58,522
834,13,19,2025-03-29,2,152,178,26,52
840,13,23,2025-03-01,6,488,572,84,504
88,9,7,2025-03-19,20,464,608,144,2880
686,26,12,2025-03-15,3,349,405,56,168
749,23,28,2025-03-21,5,38,47,9,45
611,26,29,2025-03-27,5,414,438,24,120
452,15,16,2025-03-18,3,148,197,49,147
340,5,23,2025-03-20,9,234,263,29,261
565,22,3,2025-03-29,7,314,390,76,532
531,1,13,2025-03-30,10,89,95,6,60
332,4,18,2025-03-30,13,296,424,128,1664
580,7,5,2025-03-13,11,179,207,28,308
564,4,10,2025-03-29,15,140,204,64,960
506,26,20,2025-03-19,13,433,537,104,1352
916,18,21,2025-03-27,6,475,640,165,990
172,1,5,2025-03-06,11,166,235,69,759
869,30,4,2025-03-19,2,177,229,52,104
386,28,8,2025-03-01,17,329,444,115,1955
560,24,28,2025-03-28,18,233,295,62,1116
793,23,8,2025-03-14,8,490,536,46,368
441,30,28,2025-03-13,16,210,307,97,1552
328,4,3,2025-03-06,13,359,454,95,1235
300,9,21,2025-03-06,19,294,426,132,2508
536,16,18,2025-03-02,18,121,140,19,342
105,25,4,2025-03-12,13,439,609,170,2210
625,24,11,2025-03-06,16,118,163,45,720
236,22,21,2025-03-23,11,28,31,3,33
419,3,19,2025-03-06,2,287,403,116,232
158,16,28,2025-03-24,9,125,159,34,306
370,9,3,2025-03-07,6,392,552,160,960
567,6,26,2025-03-19,5,94,131,37,185
474,27,16,2025-03-12,13,233,324,91,1183
680,25,4,2025-03-22,19,117,129,12,228
562,10,14,2025-03-16,5,85,115,30,150
998,15,26,2025-03-09,2,476,536,60,120
461,26,28,2025-03-15,10,78,105,27,270
798,18,20,2025-03-27,7,112,128,16,112
765,28,24,2025-03-31,1,194,270,76,76
130,17,10,2025-03-07,16,142,202,60,960
242,11,2,2025-03-31,1,465,599,134,134
601,7,19,2025-03-21,1,24,31,7,7
825,22,13,2025-03-14,6,495,570,75,450
30,26,27,2025-03-03,8,223,332,109,872
573,13,11,2025-03-15,17,404,560,156,2652
523,10,11,2025-03-22,14,296,312,16,224
449,18,18,2025-03-11,14,316,343,27,378
554,2,6,2025-03-15,5,44,56,12,60
138,9,9,2025-03-05,11,268,374,106,1166
672,6,12,2025-03-19,7,201,265,64,448
137,7,22,2025-03-16,11,438,641,203,2233
856,17,12,2025-03-02,13,41,48,7,91
251,21,17,2025-03-14,12,131,182,51,612
73,2,24,2025-03-06,10,42,49,7,70
139,3,21,2025-03-10,14,322,456,134,1876
346,22,15,2025-03-09,2,406,590,184,368
73,24,29,2025-03-08,17,143,167,24,408
553,28,17,2025-03-14,5,34,38,4,20
181,7,22,2025-03-25,18,250,352,102,1836
833,22,27,2025-03-13,6,428,569,141,846
402,8,13,2025-03-22,5,420,539,119,595
827,23,22,2025-03-28,4,191,244,53,212
669,8,24,2025-03-07,12,207,273,66,792
425,26,15,2025-03-21,7,194,217,23,161
939,5,15,2025-03-19,11,341,441,100,1100
669,3,22,2025-03-29,10,240,325,85,850
797,6,29,2025-03-31,2,493,603,110,220
703,29,2,2025-03-09,9,294,360,66,594
861,1,29,2025-03-22,8,399,483,84,672
788,20,15,2025-03-19,4,281,396,115,460
693,3,20,2025-03-26,19,411,580,169,3211
849,4,22,2025-03-05,18,163,225,62,1116
807,18,8,2025-03-17,3,320,394,74,222
380,19,22,2025-03-28,20,188,241,53,1060
538,12,13,2025-03-20,18,344,405,61,1098
889,5,18,2025-03-04,6,253,375,122,732
864,3,23,2025-03-10,19,321,378,57,1083
191,30,14,2025-03-06,19,101,108,7,133
425,4,21,2025-03-31,5,424,629,205,1025
453,25,29,2025-03-23,8,341,432,91,728
982,26,22,2025-03-12,9,485,668,183,1647
869,12,18,2025-03-21,15,444,485,41,615
169,24,2,2025-03-09,8,366,398,32,256
168,11,12,2025-03-06,4,177,212,35,140
556,2,18,2025-03-31,3,241,253,12,36
149,27,22,2025-03-18,12,63,80,17,204
570,10,27,2025-03-08,12,47,53,6,72
504,25,27,2025-03-25,20,163,182,19,380
616,23,24,2025-03-09,14,332,352,20,280
904,1,22,2025-03-05,6,229,274,45,270
253,15,2,2025-03-17,5,440,556,116,580
4,6,1,2025-03-10,14,257,340,83,1162
155,18,24,2025-03-03,10,325,383,58,580
201,12,30,2025-03-16,10,408,590,182,1820
797,7,6,2025-03-03,5,95,111,16,80
244,8,22,2025-03-21,10,62,89,27,270
99,19,13,2025-03-28,5,103,134,31,155
542,22,16,2025-03-19,16,383,492,109,1744
842,14,19,2025-03-28,7,350,511,161,1127
392,5,24,2025-03-07,9,395,549,154,1386
349,20,23,2025-03-29,13,77,105,28,364
202,4,17,2025-03-27,7,177,240,63,441
395,25,5,2025-03-20,1,142,184,42,42
601,27,28,2025-03-12,10,225,279,54,540
864,11,5,2025-03-24,19,446,496,50,950
156,4,30,2025-03-22,13,146,207,61,793
5,21,7,2025-03-31,2,170,248,78,156
952,7,25,2025-03-06,14,52,64,12,168
685,22,24,2025-03-24,17,197,271,74,1258
784,22,3,2025-03-03,18,460,607,147,2646
168,7,4,2025-03-15,20,425,545,120,2400
217,21,25,2025-03-26,15,63,94,31,465
119,13,23,2025-03-22,8,382,539,157,1256
991,19,5,2025-03-27,12,123,162,39,468
428,30,27,2025-03-23,2,478,544,66,132
269,4,15,2025-03-02,11,225,270,45,495
425,4,30,2025-03-12,11,326,474,148,1628
790,25,9,2025-03-13,16,379,528,149,2384
28,4,30,2025-03-16,6,434,533,99,594
766,17,6,2025-03-23,15,384,455,71,1065
605,18,1,2025-03-04,15,319,425,106,1590
456,16,26,2025-03-28,14,354,496,142,1988
445,1,20,2025-03-30,14,222,325,103,1442
381,24,18,2025-03-22,4,404,459,55,220
95,14,4,2025-03-19,9,414,620,206,1854
281,5,20,2025-03-13,8,426,549,123,984
773,1,23,2025-03-29,16,470,499,29,464
264,9,5,2025-03-22,14,184,235,51,714
351,2,7,2025-03-07,11,54,70,16,176
568,3,20,2025-03-14,9,132,183,51,459
830,3,23,2025-03-12,12,141,152,11,132
136,29,27,2025-03-04,8,397,562,165,1320
942,28,12,2025-03-29,10,491,529,38,380
658,25,23,2025-03-28,19,97,124,27,513
927,13,15,2025-03-17,11,63,89,26,286
355,18,10,2025-03-17,11,81,103,22,242
105,13,10,2025-03-02,17,187,223,36,612
567,21,7,2025-03-25,7,222,266,44,308
583,18,22,2025-03-07,20,455,570,115,2300
634,13,17,2025-03-07,6,344,472,128,768
372,26,2,2025-03-16,5,406,608,202,1010
531,23,16,2025-03-11,4,184,241,57,228
672,27,25,2025-03-17,12,199,251,52,624
551,3,1,2025-03-09,8,280,341,61,488
362,19,20,2025-03-22,8,67,92,25,200
266,2,11,2025-03-14,15,489,592,103,1545
999,2,2,2025-03-07,8,459,613,154,1232
518,1,9,2025-03-15,20,475,511,36,720
161,16,20,2025-03-31,3,365,433,68,204
742,16,8,2025-03-07,9,42,45,3,27
88,24,29,2025-03-11,15,315,446,131,1965
795,4,4,2025-03-10,7,317,379,62,434
975,4,12,2025-03-06,14,481,521,40,560
810,30,6,2025-03-04,9,323,455,132,1188
800,3,18,2025-03-29,9,459,608,149,1341
364,6,3,2025-03-07,15,479,697,218,3270
170,23,6,2025-03-26,4,435,458,23,92
843,6,25,2025-03-16,14,216,279,63,882
387,21,6,2025-03-05,13,63,76,13,169
197,6,21,2025-03-08,19,419,502,83,1577
833,3,21,2025-03-01,19,412,436,24,456
363,3,20,2025-03-27,17,458,564,106,1802
614,19,14,2025-03-24,7,130,182,52,364
632,14,17,2025-03-27,18,348,474,126,2268
375,7,5,2025-03-15,1,90,95,5,5
665,1,29,2025-03-17,14,371,519,148,2072
141,6,23,2025-03-02,15,241,361,120,1800
339,1,4,2025-03-27,4,380,469,89,356
834,15,14,2025-03-15,11,198,293,95,1045
823,22,8,2025-03-21,8,35,47,12,96
555,15,4,2025-03-15,4,71,102,31,124
218,4,9,2025-03-12,6,468,522,54,324
491,14,1,2025-03-09,4,86,104,18,72
128,5,23,2025-03-14,11,461,591,130,1430
871,23,18,2025-03-30,1,133,161,28,28
33,8,11,2025-03-11,7,73,106,33,231
882,18,9,2025-03-03,15,470,598,128,1920
381,12,15,2025-03-09,12,429,624,195,2340
310,9,3,2025-03-06,19,117,123,6,114
680,1,15,2025-03-30,12,110,131,21,252
647,30,30,2025-03-08,11,65,91,26,286
818,21,7,2025-03-10,1,380,482,102,102
508,17,21,2025-03-15,15,468,549,81,1215
885,10,26,2025-03-08,5,376,467,91,455
83,17,4,2025-03-29,20,162,174,12,240
905,27,14,2025-03-28,8,478,606,128,1024
299,2,10,2025-03-12,10,169,188,19,190
314,3,15,2025-03-23,10,60,85,25,250
381,3,9,2025-03-07,7,53,75,22,154
622,18,6,2025-03-28,13,485,625,140,1820
758,16,21,2025-03-10,5,461,641,180,900
460,6,11,2025-03-09,11,102,147,45,495
527,4,6,2025-03-11,7,58,76,18,126
916,10,7,2025-03-05,13,486,668,182,2366
981,28,30,2025-03-20,6,448,631,183,1098
215,26,28,2025-03-17,16,137,176,39,624
669,29,15,2025-03-26,4,111,163,52,208
905,9,13,2025-03-10,6,311,332,21,126
327,19,3,2025-03-23,6,201,262,61,366
560,18,5,2025-03-23,17,29,38,9,153
638,15,27,2025-03-09,17,202,256,54,918
896,18,2,2025-03-22,9,383,537,154,1386
299,24,14,2025-03-28,17,127,169,42,714
451,2,29,2025-03-30,7,239,267,28,196
47,18,20,2025-03-18,16,45,59,14,224
722,20,9,2025-03-24,19,489,626,137,2603
190,9,23,2025-03-20,8,110,125,15,120
376,11,12,2025-03-10,7,410,520,110,770
602,5,1,2025-03-05,14,196,293,97,1358
124,2,13,2025-03-18,19,302,403,101,1919
708,17,22,2025-03-06,8,408,489,81,648
998,18,5,2025-03-19,1,21,29,8,8
497,3,5,2025-03-19,10,80,114,34,340
688,18,15,2025-03-15,15,132,162,30,450
185,11,10,2025-03-20,17,226,317,91,1547
808,25,22,2025-03-04,8,401,549,148,1184
825,28,26,2025-03-25,3,258,305,47,141
543,21,16,2025-03-02,20,193,264,71,1420
454,23,16,2025-03-04,12,175,260,85,1020
981,3,15,2025-03-13,1,427,566,139,139
534,9,21,2025-03-18,9,326,382,56,504
686,21,2,2025-03-17,19,420,607,187,3553
183,5,10,2025-03-07,17,277,361,84,1428
288,9,11,2025-03-25,9,281,399,118,1062
110,1,19,2025-03-28,14,261,309,48,672
482,19,10,2025-03-04,13,419,491,72,936
933,29,11,2025-03-24,8,241,313,72,576
763,19,21,2025-03-05,20,245,292,47,940
87,9,26,2025-03-09,15,456,643,187,2805
42,15,14,2025-03-22,18,377,464,87,1566
992,15,27,2025-03-05,1,399,484,85,85
359,17,23,2025-03-31,2,491,523,32,64
987,28,16,2025-03-12,2,392,443,51,102
96,16,22,2025-03-22,5,318,414,96,480
51,6,17,2025-03-26,10,298,423,125,1250
703,17,6,2025-03-22,17,476,625,149,2533
695,12,14,2025-03-14,1,40,55,15,15
776,14,26,2025-03-15,18,455,508,53,954
118,27,8,2025-03-09,11,184,251,67,737
547,3,3,2025-03-02,5,57,60,3,15
933,6,5,2025-03-06,10,63,78,15,150
870,9,9,2025-03-07,7,29,35,6,42
63,14,18,2025-03-25,18,453,513,60,1080
350,4,26,2025-03-16,4,466,516,50,200
152,11,14,2025-03-07,15,101,120,19,285
552,1,2,2025-03-11,9,277,343,66,594
943,7,4,2025-03-09,2,203,275,72,144
689,3,20,2025-03-23,15,262,297,35,525
339,11,2,2025-03-20,19,455,586,131,2489
913,18,21,2025-03-13,16,373,397,24,384
18,18,9,2025-03-24,14,492,626,134,1876
199,14,8,2025-03-17,16,263,295,32,512
104,20,8,2025-03-06,11,195,281,86,946
479,16,12,2025-03-24,3,420,621,201,603
316,4,11,2025-03-13,1,79,90,11,11
732,11,8,2025-03-11,3,202,280,78,234
175,6,16,2025-03-06,5,293,345,52,260
444,23,12,2025-03-09,1,248,276,28,28
956,24,8,2025-03-18,3,299,336,37,111
643,7,10,2025-03-19,7,212,242,30,210
57,5,14,2025-03-09,1,393,425,32,32
616,23,15,2025-03-09,4,260,336,76,304
350,20,6,2025-03-23,2,99,146,47,94
387,22,18,2025-03-26,16,92,113,21,336
423,18,26,2025-03-28,11,428,474,46,506
851,20,23,2025-03-29,16,279,407,128,2048
284,19,6,2025-03-31,13,63,81,18,234
595,19,12,2025-03-12,16,123,131,8,128
289,18,10,2025-03-23,16,192,278,86,1376
257,17,12,2025-03-30,9,70,78,8,72
579,24,20,2025-03-15,15,198,219,21,315
939,8,17,2025-03-14,5,41,52,11,55
234,24,7,2025-03-02,1,46,60,14,14
383,16,18,2025-03-18,10,428,622,194,1940
646,5,30,2025-03-02,1,467,651,184,184
691,12,29,2025-03-21,9,372,400,28,252
269,20,29,2025-03-13,2,229,293,64,128
272,28,5,2025-03-15,15,385,432,47,705
174,30,11,2025-03-15,15,435,639,204,3060
215,3,3,2025-03-30,17,271,311,40,680
734,5,29,2025-03-04,9,195,241,46,414
606,20,17,2025-03-20,9,442,656,214,1926
748,17,28,2025-03-19,6,281,311,30,180
341,20,3,2025-03-04,12,375,487,112,1344
46,15,16,2025-03-21,7,257,297,40,280
725,2,27,2025-03-04,9,225,245,20,180
900,5,2,2025-03-29,18,390,577,187,3366
383,29,8,2025-03-08,9,213,284,71,639
808,27,3,2025-03-31,20,128,165,37,740
199,23,15,2025-03-16,17,250,298,48,816
319,4,28,2025-03-22,14,301,378,77,1078
811,30,18,2025-03-26,5,468,685,217,1085
771,21,2,2025-03-01,5,482,549,67,335
839,14,27,2025-03-02,1,227,259,32,32
22,4,13,2025-03-28,8,441,612,171,1368
446,1,12,2025-03-13,6,75,93,18,108
436,30,16,2025-03-15,15,369,469,100,1500
282,19,8,2025-03-12,15,143,163,20,300
796,2,5,2025-03-25,8,296,315,19,152
711,2,9,2025-03-02,1,321,398,77,77
723,6,11,2025-03-01,1,206,305,99,99
490,7,30,2025-03-27,15,269,394,125,1875
603,5,11,2025-03-25,5,414,435,21,105
101,19,14,2025-03-17,3,303,344,41,123
298,5,11,2025-03-22,20,34,50,16,320
329,2,4,2025-03-16,4,45,55,10,40
308,6,11,2025-03-02,4,196,257,61,244
15,4,28,2025-03-01,7,214,263,49,343
872,10,29,2025-03-15,7,28,42,14,98
105,1,5,2025-03-17,11,144,200,56,616
89,19,7,2025-03-03,1,480,517,37,37
349,21,11,2025-03-26,3,120,170,50,150
801,27,29,2025-03-03,7,149,205,56,392
285,27,7,2025-03-16,6,493,648,155,930
885,26,14,2025-03-21,7,462,544,82,574
982,24,5,2025-03-08,12,339,492,153,1836
828,22,20,2025-03-26,11,257,385,128,1408
278,7,6,2025-03-03,8,426,450,24,192
921,22,5,2025-03-04,10,328,472,144,1440
684,15,12,2025-03-07,7,298,385,87,609
979,27,8,2025-03-27,20,337,445,108,2160
630,15,6,2025-03-15,5,41,61,20,100
306,23,2,2025-03-24,9,393,575,182,1638
79,27,25,2025-03-25,6,28,31,3,18
946,4,12,2025-03-08,2,463,614,151,302
143,21,26,2025-03-11,9,115,141,26,234
941,23,23,2025-03-21,16,108,162,54,864
51,5,17,2025-03-23,1,298,439,141,141
368,18,21,2025-03-06,6,249,348,99,594
238,12,14,2025-03-06,17,491,687,196,3332
948,1,28,2025-03-29,9,401,476,75,675
39,27,21,2025-03-22,8,319,470,151,1208
190,4,2,2025-03-03,19,83,103,20,380
49,11,27,2025-03-01,11,170,188,18,198
985,21,26,2025-03-28,9,468,671,203,1827
94,14,12,2025-03-08,14,299,433,134,1876
171,6,5,2025-03-28,11,279,363,84,924
576,28,23,2025-03-22,16,34,45,11,176
638,24,11,2025-03-20,2,432,555,123,246
352,1,18,2025-03-23,15,28,39,11,165
474,18,6,2025-03-24,7,265,336,71,497
131,13,12,2025-03-24,13,233,311,78,1014
772,8,29,2025-03-27,4,207,254,47,188
152,6,14,2025-03-23,13,479,630,151,1963
445,6,13,2025-03-17,13,347,429,82,1066
108,23,2,2025-03-24,17,20,22,2,34
400,23,16,2025-03-25,11,182,264,82,902
436,30,22,2025-03-17,2,225,314,89,178
893,22,7,2025-03-13,10,129,141,12,120
774,24,17,2025-03-18,4,175,204,29,116
490,20,28,2025-03-26,17,130,183,53,901
443,19,8,2025-03-12,4,322,366,44,176
28,14,23,2025-03-26,16,105,147,42,672
791,22,15,2025-03-01,10,66,90,24,240
66,1,21,2025-03-25,11,489,638,149,1639
770,23,13,2025-03-16,8,211,296,85,680
996,12,28,2025-03-25,20,369,406,37,740
156,17,12,2025-03-20,4,494,610,116,464
289,23,14,2025-03-04,17,190,217,27,459
611,24,15,2025-03-10,18,389,560,171,3078
449,1,22,2025-03-05,12,394,529,135,1620
828,16,8,2025-03-15,3,117,130,13,39
581,22,3,2025-03-18,6,307,409,102,612
993,18,8,2025-03-31,10,408,540,132,1320
326,25,30,2025-03-05,10,73,91,18,180
970,18,11,2025-03-28,20,97,113,16,320
940,17,17,2025-03-31,11,121,153,32,352
794,26,27,2025-03-07,15,137,178,41,615
742,25,24,2025-03-24,20,77,110,33,660
127,4,9,2025-03-11,13,479,608,129,1677
810,9,19,2025-03-28,7,238,316,78,546
921,1,29,2025-03-19,8,216,294,78,624
11,13,22,2025-03-22,15,383,469,86,1290
147,22,8,2025-03-30,18,440,610,170,3060
307,5,25,2025-03-31,9,497,565,68,612
523,1,29,2025-03-22,2,222,243,21,42
562,27,17,2025-03-15,5,173,211,38,190
61,30,1,2025-03-08,15,144,172,28,420
964,2,11,2025-03-10,13,319,392,73,949
111,14,30,2025-03-30,8,242,289,47,376
90,6,20,2025-03-30,8,175,203,28,224
417,6,28,2025-03-30,11,222,283,61,671
700,4,7,2025-03-24,12,428,547,119,1428
461,30,28,2025-03-26,18,432,516,84,1512
381,4,3,2025-03-09,10,214,310,96,960
764,21,1,2025-03-27,17,22,29,7,119
389,30,21,2025-03-31,10,299,354,55,550
29,13,20,2025-03-07,6,122,136,14,84
611,23,8,2025-03-16,14,261,365,104,1456
943,19,24,2025-03-25,17,431,611,180,3060
445,23,28,2025-03-03,3,49,70,21,63
721,22,10,2025-03-02,5,262,365,103,515
827,8,7,2025-03-01,5,459,615,156,780
839,29,11,2025-03-16,8,396,555,159,1272
341,15,19,2025-03-16,16,71,75,4,64
269,9,8,2025-03-12,2,375,450,75,150
230,19,15,2025-03-20,11,320,356,36,396
431,5,29,2025-03-11,20,80,86,6,120
1,8,18,2025-03-04,2,442,609,167,334
135,27,19,2025-03-14,4,480,712,232,928
580,28,18,2025-03-28,3,48,61,13,39
863,17,1,2025-03-28,6,344,394,50,300
676,13,22,2025-03-24,1,328,407,79,79
446,25,15,2025-03-05,2,166,186,20,40
522,24,28,2025-03-25,13,368,445,77,1001
396,6,23,2025-03-02,1,304,420,116,116
756,29,4,2025-03-01,16,205,216,11,176
75,22,18,2025-03-20,13,488,648,160,2080
762,24,6,2025-03-08,16,421,549,128,2048
437,28,27,2025-03-09,18,351,373,22,396
170,27,25,2025-03-08,4,79,102,23,92
213,15,22,2025-03-19,4,53,57,4,16
272,16,15,2025-03-20,18,279,388,109,1962
366,8,30,2025-03-24,7,22,28,6,42
947,11,2,2025-03-16,20,270,299,29,580
53,26,17,2025-03-18,1,416,581,165,165
980,8,30,2025-03-29,10,114,162,48,480
536,7,4,2025-03-20,3,316,339,23,69
487,3,5,2025-03-21,13,362,542,180,2340
857,16,15,2025-03-12,16,305,346,41,656
723,20,17,2025-03-28,8,91,118,27,216
388,18,22,2025-03-21,12,346,445,99,1188
145,20,3,2025-03-20,12,56,69,13,156
371,30,17,2025-03-02,17,313,403,90,1530
746,27,26,2025-03-13,4,146,166,20,80
166,25,22,2025-03-13,20,341,506,165,3300
461,23,20,2025-03-14,9,245,278,33,297
496,30,6,2025-03-09,19,459,548,89,1691
825,7,19,2025-03-13,20,403,466,63,1260
573,9,7,2025-03-28,10,184,247,63,630
469,14,26,2025-03-27,13,253,310,57,741
510,26,14,2025-03-08,15,444,657,213,3195
845,14,21,2025-03-08,10,199,266,67,670
323,11,10,2025-03-06,12,182,212,30,360
419,1,3,2025-03-17,2,455,505,50,100
248,27,18,2025-03-08,5,450,580,130,650
514,21,25,2025-03-05,18,70,104,34,612
702,7,13,2025-03-19,2,189,274,85,170
27,15,21,2025-03-10,7,146,184,38,266
41,20,8,2025-03-31,2,291,334,43,86
414,30,27,2025-03-12,10,233,247,14,140
929,23,13,2025-03-24,17,441,466,25,425
465,28,29,2025-03-05,10,263,339,76,760
449,18,16,2025-03-17,11,43,61,18,198
356,27,24,2025-03-15,7,241,278,37,259
205,17,11,2025-03-13,4,492,645,153,612
263,25,15,2025-03-23,19,132,182,50,950
968,25,29,2025-03-12,14,267,381,114,1596
105,29,10,2025-03-23,8,362,528,166,1328
799,17,5,2025-03-22,3,420,532,112,336
954,16,8,2025-03-01,12,191,218,27,324
15,1,27,2025-03-07,19,453,498,45,855
574,11,22,2025-03-15,7,444,603,159,1113
340,27,30,2025-03-01,14,213,244,31,434
491,14,14,2025-03-15,16,29,33,4,64
241,30,7,2025-03-02,9,39,53,14,126
689,21,11,2025-03-27,4,209,272,63,252
374,19,15,2025-03-03,14,252,361,109,1526
710,24,1,2025-03-27,20,173,251,78,1560
869,7,10,2025-03-23,2,411,492,81,162
837,4,24,2025-03-31,15,452,527,75,1125
383,18,18,2025-03-24,1,488,643,155,155
827,14,16,2025-03-04,11,480,558,78,858
365,7,19,2025-03-19,11,498,551,53,583
478,29,22,2025-03-29,10,481,648,167,1670
695,13,20,2025-03-22,8,497,617,120,960
453,7,16,2025-03-10,10,124,183,59,590
719,21,30,2025-03-01,12,479,606,127,1524
231,4,25,2025-03-19,19,492,668,176,3344
809,4,29,2025-03-26,8,270,367,97,776
102,10,12,2025-03-09,17,63,69,6,102
990,29,14,2025-03-06,12,290,418,128,1536
69,26,5,2025-03-31,1,113,148,35,35
652,25,17,2025-03-12,8,108,140,32,256
762,1,12,2025-03-24,2,353,462,109,218
93,4,3,2025-03-22,19,148,196,48,912
237,26,20,2025-03-20,10,53,56,3,30
344,28,5,2025-03-29,6,102,114,12,72
223,2,7,2025-03-21,1,96,113,17,17
728,19,11,2025-03-01,2,474,591,117,234
662,17,30,2025-03-31,4,493,675,182,728
829,8,27,2025-03-17,20,339,433,94,1880
477,23,29,2025-03-16,13,372,528,156,2028
768,20,6,2025-03-01,6,49,58,9,54
678,5,11,2025-03-12,8,413,518,105,840
392,3,15,2025-03-12,13,375,460,85,1105
705,12,24,2025-03-21,10,436,500,64,640
388,1,9,2025-03-27,11,285,413,128,1408
610,28,14,2025-03-29,11,354,381,27,297
254,15,6,2025-03-06,7,399,529,130,910
280,17,15,2025-03-30,3,500,712,212,636
198,16,1,2025-03-19,3,416,538,122,366
778,23,11,2025-03-24,3,452,475,23,69
625,22,30,2025-03-02,12,380,449,69,828
490,18,15,2025-03-04,5,166,188,22,110
440,15,18,2025-03-17,12,264,353,89,1068
197,29,28,2025-03-10,20,132,149,17,340
772,20,18,2025-03-19,5,350,387,37,185
7,20,21,2025-03-20,11,47,50,3,33
588,19,22,2025-03-16,6,273,375,102,612
381,23,20,2025-03-25,16,281,315,34,544
886,1,23,2025-03-18,10,152,164,12,120
524,24,28,2025-03-26,3,254,372,118,354
977,9,6,2025-03-12,4,116,127,11,44
321,23,11,2025-03-21,15,346,376,30,450
536,4,19,2025-03-19,8,371,502,131,1048
321,5,3,2025-03-06,13,32,38,6,78
612,7,24,2025-03-06,12,341,365,24,288
642,8,26,2025-03-22,13,171,214,43,559
355,6,28,2025-03-10,2,131,190,59,118
310,11,11,2025-03-17,4,35,45,10,40
855,30,25,2025-03-11,2,367,526,159,318
814,20,19,2025-03-04,6,386,467,81,486
841,23,28,2025-03-19,9,239,256,17,153
356,16,1,2025-03-02,8,446,491,45,360
526,22,25,2025-03-14,14,349,488,139,1946
939,26,8,2025-03-04,11,41,50,9,99
611,13,4,2025-03-07,11,360,382,22,242
402,3,11,2025-03-24,12,404,596,192,2304
9,16,10,2025-03-16,16,368,426,58,928
168,17,27,2025-03-07,14,95,113,18,252
464,23,12,2025-03-10,2,89,99,10,20
967,18,18,2025-03-23,1,287,382,95,95
466,23,20,2025-03-06,11,235,349,114,1254
804,2,12,2025-03-01,11,203,278,75,825
515,9,7,2025-03-03,1,170,247,77,77
487,14,25,2025-03-26,15,357,525,168,2520
659,12,2,2025-03-04,8,76,84,8,64
845,20,14,2025-03-11,17,63,84,21,357
184,25,19,2025-03-31,16,381,562,181,2896
199,26,10,2025-03-11,13,111,141,30,390
317,2,27,2025-03-06,3,200,269,69,207
623,25,19,2025-03-09,14,253,275,22,308
974,21,14,2025-03-22,19,396,522,126,2394
936,12,10,2025-03-10,1,452,578,126,126
605,9,20,2025-03-15,3,138,159,21,63
575,5,28,2025-03-30,11,109,133,24,264
500,9,9,2025-03-07,9,483,652,169,1521
64,26,20,2025-03-14,6,385,494,109,654
322,15,28,2025-03-19,14,434,533,99,1386
614,12,17,2025-03-09,1,380,497,117,117
898,21,4,2025-03-04,10,56,73,17,170
797,6,17,2025-03-03,8,266,380,114,912
800,27,29,2025-03-18,12,424,570,146,1752
533,26,25,2025-03-11,2,110,163,53,106
94,12,27,2025-03-26,14,47,53,6,84
843,10,7,2025-03-13,20,307,347,40,800
884,14,7,2025-03-16,5,334,402,68,340
459,12,13,2025-03-09,20,403,573,170,3400
994,11,18,2025-03-26,10,388,557,169,1690
234,25,2,2025-03-16,1,50,69,19,19
24,21,27,2025-03-28,7,294,391,97,679
751,10,1,2025-03-16,11,337,385,48,528
910,5,1,2025-03-06,8,471,691,220,1760
93,24,1,2025-03-22,15,193,225,32,480
275,28,21,2025-03-10,13,165,234,69,897
774,19,19,2025-03-01,19,302,378,76,1444
772,17,25,2025-03-19,12,77,84,7,84
651,21,18,2025-03-16,5,408,480,72,360
668,14,9,2025-03-09,18,48,67,19,342
994,13,2,2025-03-25,16,392,436,44,704
213,12,27,2025-03-17,8,287,336,49,392
13,5,21,2025-03-31,3,76,96,20,60
644,15,14,2025-03-06,15,452,675,223,3345
73,25,12,2025-03-27,18,180,243,63,1134
989,14,20,2025-03-11,2,90,120,30,60
916,14,11,2025-03-01,11,481,508,27,297
821,10,9,2025-03-13,19,125,163,38,722
306,30,6,2025-03-16,1,122,172,50,50
553,28,15,2025-03-10,16,227,244,17,272
927,25,18,2025-03-11,20,57,80,23,460
996,19,17,2025-03-05,9,247,275,28,252
464,25,18,2025-03-07,11,188,273,85,935
280,7,5,2025-03-27,3,415,516,101,303
703,17,15,2025-03-17,9,121,154,33,297
248,7,9,2025-03-29,2,20,26,6,12
409,2,24,2025-03-03,16,151,162,11,176
540,27,2,2025-03-06,8,428,515,87,696
127,30,1,2025-03-31,5,129,143,14,70
530,22,5,2025-03-21,11,124,153,29,319
755,18,1,2025-03-06,18,273,328,55,990
30,5,13,2025-03-25,15,326,474,148,2220
397,2,4,2025-03-15,18,339,476,137,2466
477,5,7,2025-03-01,5,420,611,191,955
549,25,3,2025-03-01,7,485,687,202,1414
399,24,3,2025-03-14,9,397,431,34,306
321,30,25,2025-03-23,3,464,605,141,423
593,14,15,2025-03-27,9,244,350,106,954
643,2,5,2025-03-21,4,148,171,23,92
974,30,22,2025-03-29,16,356,381,25,400
4,17,4,2025-03-18,16,430,486,56,896
50,28,4,2025-03-26,10,147,205,58,580
617,13,15,2025-03-28,11,138,160,22,242
735,28,8,2025-03-27,14,100,123,23,322
682,9,12,2025-03-05,19,49,54,5,95
615,29,17,2025-03-04,13,23,26,3,39
819,15,1,2025-03-16,7,317,437,120,840
452,20,7,2025-03-25,11,168,237,69,759
590,25,21,2025-03-22,15,497,679,182,2730
283,30,30,2025-03-02,2,241,326,85,170
41,16,5,2025-03-09,6,265,281,16,96
461,7,8,2025-03-09,17,225,314,89,1513
656,15,30,2025-03-12,17,423,601,178,3026
802,28,30,2025-03-23,9,330,356,26,234
27,8,6,2025-03-26,5,164,193,29,145
322,22,6,2025-03-18,12,345,374,29,348
695,30,9,2025-03-29,10,199,222,23,230
33,11,6,2025-03-05,9,145,174,29,261
621,16,1,2025-03-17,13,103,113,10,130
294,4,3,2025-03-26,12,124,136,12,144
200,12,25,2025-03-26,11,179,191,12,132
723,19,22,2025-03-20,4,422,533,111,444
334,1,4,2025-03-22,1,146,183,37,37
505,16,7,2025-03-07,15,95,111,16,240
212,28,24,2025-03-02,9,228,294,66,594
727,12,30,2025-03-20,13,450,670,220,2860
883,22,25,2025-03-02,4,332,456,124,496
236,26,30,2025-03-31,4,430,587,157,628
783,27,27,2025-03-26,11,127,142,15,165
836,26,28,2025-03-22,18,98,136,38,684
655,10,22,2025-03-22,16,487,547,60,960
192,14,6,2025-03-18,1,194,241,47,47
279,4,13,2025-03-31,6,143,202,59,354
561,22,17,2025-03-10,8,299,422,123,984
573,13,13,2025-03-18,18,235,328,93,1674
468,17,28,2025-03-04,14,295,437,142,1988
855,17,28,2025-03-13,18,403,533,130,2340
498,27,30,2025-03-01,14,143,173,30,420
109,27,30,2025-03-30,13,146,210,64,832
268,27,23,2025-03-19,14,239,328,89,1246
590,3,12,2025-03-16,19,486,710,224,4256
399,22,27,2025-03-29,20,65,75,10,200
108,24,5,2025-03-16,18,134,175,41,738
857,3,9,2025-03-30,12,483,572,89,1068
577,20,12,2025-03-03,4,445,522,77,308
129,12,16,2025-03-01,18,68,86,18,324
409,20,18,2025-03-30,3,55,67,12,36
830,14,25,2025-03-16,10,81,102,21,210
285,7,30,2025-03-31,6,146,212,66,396
491,24,2,2025-03-08,20,379,417,38,760
111,5,17,2025-03-05,6,335,353,18,108
332,17,15,2025-03-09,5,216,239,23,115
374,9,16,2025-03-04,7,214,257,43,301
923,7,9,2025-03-26,8,104,136,32,256
446,3,26,2025-03-20,18,339,507,168,3024
81,21,26,2025-03-30,19,335,426,91,1729
212,15,20,2025-03-21,16,169,237,68,1088
597,19,12,2025-03-19,14,419,478,59,826
953,9,17,2025-03-04,2,381,438,57,114
51,30,26,2025-03-18,13,120,176,56,728
511,27,21,2025-03-03,18,441,636,195,3510
29,30,18,2025-03-26,4,41,48,7,28
998,30,11,2025-03-02,13,269,394,125,1625
352,8,1,2025-03-23,20,302,435,133,2660
950,2,16,2025-03-26,13,144,215,71,923
83,5,7,2025-03-12,9,227,265,38,342
668,30,7,2025-03-18,4,499,739,240,960
628,14,24,2025-03-07,12,40,59,19,228
583,19,10,2025-03-07,8,107,140,33,264
516,4,12,2025-03-07,10,300,363,63,630
777,1,20,2025-03-14,11,394,570,176,1936
789,9,11,2025-03-03,2,207,276,69,138
919,18,5,2025-03-01,16,378,409,31,496
257,17,7,2025-03-03,16,157,221,64,1024
246,13,19,2025-03-22,16,491,729,238,3808
398,8,4,2025-03-20,4,439,651,212,848
920,23,10,2025-03-02,4,200,276,76,304
752,15,23,2025-03-07,9,271,395,124,1116
499,30,21,2025-03-05,10,270,333,63,630
955,23,20,2025-03-18,17,413,565,152,2584
382,21,1,2025-03-28,12,495,738,243,2916
191,12,19,2025-03-19,11,171,200,29,319
24,20,26,2025-03-10,2,306,406,100,200
407,28,26,2025-03-31,8,195,285,90,720
17,1,19,2025-03-17,9,350,400,50,450
614,18,8,2025-03-11,17,465,683,218,3706
166,5,28,2025-03-21,1,180,265,85,85
546,13,27,2025-03-14,13,135,176,41,533
23,14,10,2025-03-24,2,253,289,36,72
839,17,17,2025-03-28,5,263,347,84,420
999,20,5,2025-03-20,17,303,410,107,1819
78,21,27,2025-03-04,17,26,32,6,102
172,18,2,2025-03-24,15,415,529,114,1710
41,7,30,2025-03-18,13,189,250,61,793
177,25,7,2025-03-25,6,44,60,16,96
439,23,20,2025-03-16,20,463,560,97,1940
902,4,3,2025-03-08,4,97,123,26,104
299,26,24,2025-03-19,13,388,429,41,533
411,26,22,2025-03-07,4,251,320,69,276
361,16,21,2025-03-01,4,204,240,36,144
385,27,8,2025-03-17,14,90,123,33,462
118,16,27,2025-03-31,3,401,455,54,162
303,1,13,2025-03-11,10,404,428,24,240
972,10,3,2025-03-29,9,260,301,41,369
770,24,18,2025-03-26,4,74,95,21,84
153,28,10,2025-03-23,4,229,311,82,328
261,5,8,2025-03-10,4,310,414,104,416
668,8,30,2025-03-07,14,25,29,4,56
101,4,28,2025-03-10,4,469,520,51,204
961,10,10,2025-03-24,15,80,112,32,480
534,16,23,2025-03-06,14,187,276,89,1246
25,17,11,2025-03-09,6,391,519,128,768
104,17,24,2025-03-03,6,190,226,36,216
929,25,26,2025-03-11,4,343,483,140,560
348,17,6,2025-03-20,1,309,442,133,133
969,9,27,2025-03-18,13,488,624,136,1768
385,8,5,2025-03-08,4,357,389,32,128
976,2,9,2025-03-28,9,227,267,40,360
630,2,12,2025-03-30,12,442,560,118,1416
5,10,9,2025-03-13,6,137,168,31,186
909,18,4,2025-03-06,5,39,49,10,50
641,19,26,2025-03-09,19,382,439,57,1083
265,21,20,2025-03-08,18,470,673,203,3654
721,5,17,2025-03-17,16,417,474,57,912
273,1,4,2025-03-17,1,119,146,27,27
988,22,14,2025-03-11,5,474,608,134,670
477,30,8,2025-03-25,11,238,340,102,1122
960,26,4,2025-03-06,13,161,215,54,702
739,15,8,2025-03-22,9,270,288,18,162
534,24,6,2025-03-11,13,442,480,38,494
920,13,26,2025-03-22,10,162,205,43,430
393,12,27,2025-03-04,18,365,469,104,1872
56,16,24,2025-03-21,18,421,586,165,2970
993,22,20,2025-03-23,10,482,555,73,730
351,25,9,2025-03-18,6,221,267,46,276
884,16,11,2025-03-01,14,486,698,212,2968
508,11,20,2025-03-27,18,277,361,84,1512
808,30,18,2025-03-29,13,79,111,32,416
101,13,9,2025-03-24,13,212,291,79,1027
140,12,8,2025-03-27,11,210,272,62,682
113,4,18,2025-03-01,7,349,485,136,952
474,7,10,2025-03-25,13,330,357,27,351
374,4,17,2025-03-23,12,447,634,187,2244
177,3,27,2025-03-12,11,275,289,14,154
881,19,18,2025-03-12,9,466,603,137,1233
352,26,8,2025-03-03,9,407,471,64,576
475,21,28,2025-03-07,16,352,377,25,400
513,2,25,2025-03-23,19,85,122,37,703
579,4,26,2025-03-17,10,181,239,58,580
829,5,11,2025-03-08,7,58,74,16,112
810,20,14,2025-03-09,6,164,238,74,444
282,29,6,2025-03-07,6,342,497,155,930
857,6,1,2025-03-08,7,260,276,16,112
913,12,1,2025-03-14,19,258,330,72,1368
997,22,2,2025-03-14,18,177,246,69,1242
708,4,28,2025-03-18,17,177,191,14,238
719,6,13,2025-03-20,13,484,527,43,559
927,19,29,2025-03-08,6,185,257,72,432
173,7,9,2025-03-29,18,500,609,109,1962
811,15,4,2025-03-16,15,319,412,93,1395
850,20,8,2025-03-04,17,139,206,67,1139
260,24,5,2025-03-01,10,480,704,224,2240
637,23,19,2025-03-22,10,50,67,17,170
448,10,15,2025-03-09,13,304,432,128,1664
984,9,23,2025-03-11,16,370,456,86,1376
545,22,26,2025-03-04,15,243,352,109,1635
448,7,3,2025-03-02,12,240,324,84,1008
463,10,17,2025-03-12,16,205,270,65,1040
497,9,25,2025-03-01,16,38,55,17,272
290,19,29,2025-03-08,6,143,155,12,72
65,23,20,2025-03-19,1,225,286,61,61
991,13,4,2025-03-17,4,267,299,32,128
324,28,20,2025-03-03,8,324,359,35,280
585,6,18,2025-03-04,5,238,312,74,370
251,20,4,2025-03-13,16,361,438,77,1232
674,1,12,2025-03-07,12,393,519,126,1512
728,6,24,2025-03-23,1,282,375,93,93
630,2,6,2025-03-10,15,284,308,24,360
368,16,25,2025-03-16,7,251,318,67,469
126,18,6,2025-03-24,2,154,207,53,106
548,22,30,2025-03-06,3,472,621,149,447
812,5,11,2025-03-05,8,184,212,28,224
396,29,3,2025-03-01,14,337,503,166,2324
733,15,24,2025-03-07,17,248,307,59,1003
949,1,27,2025-03-05,14,330,454,124,1736
797,23,4,2025-03-16,9,80,114,34,306
530,16,26,2025-03-05,17,111,162,51,867
663,9,5,2025-03-08,4,372,436,64,256
69,20,20,2025-03-18,3,114,166,52,156
239,13,2,2025-03-26,15,50,74,24,360
848,9,13,2025-03-31,8,135,147,12,96
562,1,25,2025-03-21,11,315,409,94,1034
68,5,7,2025-03-30,6,62,83,21,126
847,26,27,2025-03-07,15,101,117,16,240
632,14,22,2025-03-30,3,326,343,17,51
906,22,13,2025-03-10,12,74,100,26,312
273,7,21,2025-03-17,12,237,322,85,1020
904,12,26,2025-03-05,10,290,363,73,730
228,12,20,2025-03-29,15,325,370,45,675
691,3,14,2025-03-03,17,436,481,45,765
264,22,2,2025-03-30,16,82,123,41,656
313,20,25,2025-03-15,10,402,471,69,690
349,24,23,2025-03-11,6,476,712,236,1416
320,22,22,2025-03-17,14,20,25,5,70
668,14,5,2025-03-22,7,379,563,184,1288
940,20,9,2025-03-20,20,85,111,26,520
315,9,26,2025-03-15,15,279,306,27,405
231,5,11,2025-03-22,10,307,385,78,780
241,18,4,2025-03-16,9,496,586,90,810
472,2,9,2025-03-15,1,250,366,116,116
455,14,3,2025-03-02,20,187,239,52,1040
542,17,5,2025-03-09,6,486,654,168,1008
454,2,4,2025-03-15,14,216,309,93,1302
912,28,16,2025-03-28,14,276,383,107,1498
903,21,24,2025-03-01,14,432,566,134,1876
948,23,25,2025-03-19,19,270,390,120,2280
861,23,23,2025-03-08,17,222,290,68,1156
183,20,13,2025-03-17,15,90,95,5,75
906,21,11,2025-03-08,17,200,234,34,578
999,6,23,2025-03-18,14,160,207,47,658
886,29,1,2025-03-03,3,227,276,49,147
316,18,1,2025-03-31,8,142,210,68,544
430,24,25,2025-03-25,11,134,165,31,341
877,24,14,2025-03-26,9,186,267,81,729
737,16,3,2025-03-17,14,459,660,201,2814
929,5,12,2025-03-02,12,386,559,173,2076
149,11,21,2025-03-01,19,368,420,52,988
405,25,11,2025-03-02,5,107,115,8,40
545,18,4,2025-03-15,1,312,351,39,39
789,5,20,2025-03-07,8,221,256,35,280
421,27,9,2025-03-04,1,378,434,56,56
934,30,9,2025-03-24,10,489,611,122,1220
714,10,13,2025-03-28,16,318,448,130,2080
967,18,6,2025-03-30,20,174,245,71,1420
86,26,4,2025-03-30,11,69,96,27,297
843,11,29,2025-03-20,9,477,551,74,666
200,2,13,2025-03-08,17,98,104,6,102
429,27,4,2025-03-24,15,371,411,40,600
142,12,30,2025-03-13,19,162,203,41,779
917,24,6,2025-03-29,13,416,486,70,910
988,27,15,2025-03-20,14,187,252,65,910
163,15,5,2025-03-21,1,248,316,68,68
198,13,6,2025-03-19,19,168,237,69,1311
781,5,23,2025-03-01,11,445,526,81,891
511,24,5,2025-03-09,16,282,326,44,704
736,22,2,2025-03-27,11,153,172,19,209
146,2,24,2025-03-25,15,349,396,47,705
798,18,8,2025-03-29,14,465,548,83,1162
19,3,11,2025-03-28,1,376,516,140,140
735,11,20,2025-03-08,8,404,600,196,1568
191,12,11,2025-03-31,20,338,434,96,1920
816,24,10,2025-03-03,13,135,200,65,845
778,2,18,2025-03-27,7,469,588,119,833
271,28,2,2025-03-23,13,235,336,101,1313
980,13,8,2025-03-13,20,138,192,54,1080
951,28,4,2025-03-30,13,192,220,28,364
676,1,17,2025-03-06,8,39,47,8,64
472,8,7,2025-03-26,6,466,599,133,798
110,12,3,2025-03-19,6,112,161,49,294
96,21,22,2025-03-28,15,450,588,138,2070
489,17,15,2025-03-12,11,148,177,29,319
95,21,14,2025-03-03,17,294,356,62,1054
788,4,8,2025-03-11,2,364,462,98,196
99,2,14,2025-03-04,7,37,44,7,49
851,10,2,2025-03-02,4,27,28,1,4
738,29,10,2025-03-11,19,426,588,162,3078
323,17,16,2025-03-19,6,433,456,23,138
657,14,13,2025-03-03,1,84,122,38,38
179,22,18,2025-03-31,16,458,645,187,2992
578,5,29,2025-03-15,1,445,637,192,192
747,25,12,2025-03-18,2,367,517,150,300
288,5,21,2025-03-22,5,289,411,122,610
561,19,23,2025-03-18,5,113,163,50,250
291,29,26,2025-03-24,11,490,666,176,1936
213,20,14,2025-03-24,11,416,543,127,1397
134,30,1,2025-03-10,15,410,556,146,2190
188,8,11,2025-03-14,12,460,636,176,2112
124,17,16,2025-03-15,12,216,276,60,720
108,1,27,2025-03-16,9,427,452,25,225
374,6,13,2025-03-01,8,57,81,24,192
367,14,2,2025-03-19,4,473,588,115,460
638,18,21,2025-03-21,9,455,608,153,1377
87,12,30,2025-03-21,18,424,624,200,3600
768,20,24,2025-03-20,1,405,428,23,23
516,25,23,2025-03-29,16,396,537,141,2256
795,17,1,2025-03-08,20,343,398,55,1100
707,3,25,2025-03-24,16,182,261,79,1264
89,30,26,2025-03-22,18,22,33,11,198
714,6,20,2025-03-04,6,175,197,22,132
589,2,8,2025-03-23,17,200,267,67,1139
351,18,18,2025-03-14,10,46,60,14,140
267,7,20,2025-03-12,14,207,284,77,1078
611,27,10,2025-03-08,3,204,230,26,78
70,7,11,2025-03-02,16,74,79,5,80
927,6,29,2025-03-05,2,181,199,18,36
36,1,12,2025-03-12,15,241,316,75,1125
647,24,17,2025-03-28,11,99,135,36,396
922,25,10,2025-03-01,12,83,90,7,84
674,4,13,2025-03-12,11,276,388,112,1232
247,13,12,2025-03-15,11,379,439,60,660
284,25,8,2025-03-18,11,462,613,151,1661
931,4,2,2025-03-26,5,97,139,42,210
683,6,23,2025-03-08,17,82,120,38,646
130,7,29,2025-03-01,7,329,435,106,742
859,11,21,2025-03-16,2,500,671,171,342
908,22,9,2025-03-25,5,318,373,55,275
914,5,1,2025-03-13,2,221,331,110,220
859,8,25,2025-03-03,5,234,279,45,225
415,20,8,2025-03-27,16,374,532,158,2528
956,20,10,2025-03-30,3,363,497,134,402
795,1,6,2025-03-20,6,23,26,3,18
5,29,29,2025-03-11,15,431,614,183,2745
921,3,13,2025-03-23,1,59,64,5,5
430,2,14,2025-03-16,5,89,132,43,215
44,11,4,2025-03-31,7,224,245,21,147
203,11,17,2025-03-13,1,500,642,142,142
242,22,23,2025-03-24,10,160,234,74,740
609,22,20,2025-03-26,14,151,204,53,742
841,27,17,2025-03-26,14,123,157,34,476
415,27,7,2025-03-22,11,277,332,55,605
94,11,6,2025-03-08,15,62,77,15,225
628,7,3,2025-03-02,12,442,504,62,744
621,17,29,2025-03-25,15,315,431,116,1740
513,21,24,2025-03-07,16,240,339,99,1584
73,23,6,2025-03-23,8,295,386,91,728
154,3,17,2025-03-29,5,187,270,83,415
1000,5,4,2025-03-12,2,268,380,112,224
15,23,15,2025-03-06,11,66,70,4,44
155,17,2,2025-03-30,17,57,72,15,255
259,18,17,2025-03-03,16,63,94,31,496
570,15,2,2025-03-28,7,196,231,35,245
419,15,17,2025-03-28,12,391,546,155,1860
122,29,30,2025-03-12,5,337,415,78,390
879,17,18,2025-03-25,20,322,366,44,880
932,26,17,2025-03-24,18,380,507,127,2286
692,26,18,2025-03-24,7,330,424,94,658
112,21,24,2025-03-18,16,62,88,26,416
526,21,12,2025-03-31,11,175,216,41,451
594,23,1,2025-03-09,4,496,629,133,532
533,3,12,2025-03-31,3,187,241,54,162
348,19,7,2025-03-17,20,124,143,19,380
455,11,15,2025-03-30,1,200,298,98,98
918,30,20,2025-03-18,18,438,542,104,1872
671,12,18,2025-03-24,15,407,509,102,1530
552,6,26,2025-03-17,6,273,340,67,402
902,26,25,2025-03-29,10,272,394,122,1220
406,28,14,2025-03-04,16,213,267,54,864
223,15,22,2025-03-31,1,145,203,58,58
226,24,26,2025-03-30,12,251,362,111,1332
647,11,15,2025-03-16,1,188,203,15,15
991,14,17,2025-03-05,11,106,129,23,253
962,19,26,2025-03-29,15,97,105,8,120
749,13,19,2025-03-06,19,171,216,45,855
596,23,19,2025-03-16,4,89,112,23,92
80,10,15,2025-03-13,17,267,354,87,1479
59,21,17,2025-03-19,4,435,576,141,564
607,23,23,2025-03-23,12,106,129,23,276
659,1,9,2025-03-06,12,205,285,80,960
753,9,19,2025-03-12,9,127,176,49,441
364,24,20,2025-03-09,10,322,352,30,300
632,10,26,2025-03-12,20,41,52,11,220
421,25,26,2025-03-15,8,117,148,31,248
245,13,30,2025-03-31,15,99,140,41,615
21,4,6,2025-03-20,5,276,393,117,585
569,5,7,2025-03-16,1,118,129,11,11
665,30,7,2025-03-04,1,369,461,92,92
53,3,7,2025-03-22,18,165,237,72,1296
155,20,11,2025-03-10,3,186,271,85,255
740,23,2,2025-03-11,8,254,340,86,688
473,7,12,2025-03-07,2,442,552,110,220
511,26,1,2025-03-04,16,401,545,144,2304
217,28,18,2025-03-06,4,410,480,70,280
36,9,2,2025-03-05,15,278,335,57,855
87,7,4,2025-03-06,10,341,463,122,1220
111,29,21,2025-03-06,19,309,373,64,1216
856,11,23,2025-03-09,1,354,432,78,78
667,25,30,2025-03-16,5,305,347,42,210
795,8,24,2025-03-17,11,118,175,57,627
827,30,5,2025-03-10,3,428,502,74,222
336,30,23,2025-03-07,2,253,349,96,192
807,16,15,2025-03-31,17,282,411,129,2193
319,17,17,2025-03-02,19,192,282,90,1710
222,1,17,2025-03-04,11,425,584,159,1749
665,5,16,2025-03-18,8,220,302,82,656
361,16,24,2025-03-01,16,366,491,125,2000
476,19,20,2025-03-07,9,277,365,88,792
94,22,8,2025-03-29,9,94,133,39,351
914,24,11,2025-03-08,18,244,304,60,1080
258,1,23,2025-03-11,19,23,32,9,171
280,20,13,2025-03-01,3,184,213,29,87
351,25,25,2025-03-08,19,163,177,14,266
491,13,26,2025-03-31,4,365,396,31,124
593,24,29,2025-03-10,7,394,454,60,420
935,1,12,2025-03-30,19,300,412,112,2128
266,2,17,2025-03-31,8,385,443,58,464
870,7,20,2025-03-12,10,67,98,31,310
103,28,10,2025-03-23,17,40,50,10,170
50,29,3,2025-03-14,14,359,474,115,1610
832,30,14,2025-03-23,18,205,288,83,1494
995,27,25,2025-03-23,4,397,593,196,784
509,11,23,2025-03-30,4,234,322,88,352
946,27,9,2025-03-03,6,58,77,19,114
98,17,27,2025-03-01,12,490,570,80,960
549,23,9,2025-03-28,17,83,91,8,136
628,29,28,2025-03-07,13,329,413,84,1092
3,27,6,2025-03-13,6,74,93,19,114
174,19,30,2025-03-06,6,69,73,4,24
706,27,30,2025-03-14,2,32,44,12,24
985,21,30,2025-03-28,16,49,60,11,176
395,29,6,2025-03-06,20,398,467,69,1380
402,25,24,2025-03-27,7,164,197,33,231
991,12,5,2025-03-09,16,463,661,198,3168
804,18,22,2025-03-10,12,446,610,164,1968
471,19,15,2025-03-22,7,464,567,103,721
142,18,28,2025-03-01,20,308,459,151,3020
108,8,5,2025-03-27,9,454,666,212,1908
794,16,7,2025-03-02,2,110,130,20,40
751,16,5,2025-03-29,7,302,341,39,273
498,20,8,2025-03-13,14,69,87,18,252
350,13,6,2025-03-13,12,281,411,130,1560
768,13,11,2025-03-17,1,142,195,53,53
948,1,6,2025-03-30,16,423,516,93,1488
845,12,15,2025-03-05,9,132,163,31,279
874,8,15,2025-03-05,7,299,323,24,168
8,20,7,2025-03-11,8,32,34,2,16
131,16,3,2025-03-03,17,367,483,116,1972
8,4,19,2025-03-18,15,499,644,145,2175
986,21,5,2025-03-13,7,317,458,141,987
620,5,27,2025-03-09,13,363,394,31,403
24,17,18,2025-03-08,9,59,86,27,243
381,20,26,2025-03-07,13,393,572,179,2327
827,22,14,2025-03-19,16,368,550,182,2912
824,11,29,2025-03-28,12,186,235,49,588
878,9,8,2025-03-28,1,79,83,4,4
730,3,17,2025-03-06,9,144,189,45,405
429,14,13,2025-03-21,3,31,34,3,9
650,3,8,2025-03-10,12,491,642,151,1812
934,10,28,2025-03-24,17,377,559,182,3094
23,14,23,2025-03-23,10,37,45,8,80
752,24,11,2025-03-13,9,444,474,30,270
147,26,7,2025-03-31,12,366,532,166,1992
950,10,14,2025-03-14,2,233,277,44,88
162,3,4,2025-03-20,17,433,529,96,1632
945,1,16,2025-03-14,6,198,250,52,312
504,14,28,2025-03-25,6,49,54,5,30
965,19,23,2025-03-29,17,496,541,45,765
129,30,13,2025-03-02,12,437,501,64,768
930,21,3,2025-03-03,12,91,123,32,384
905,12,19,2025-03-08,8,187,269,82,656
832,27,4,2025-03-24,1,310,391,81,81
246,25,30,2025-03-27,9,212,247,35,315
457,17,25,2025-03-21,3,491,602,111,333
155,9,27,2025-03-28,1,59,63,4,4
134,22,12,2025-03-07,15,163,227,64,960
561,19,6,2025-03-24,18,326,399,73,1314
286,30,29,2025-03-24,7,32,42,10,70
918,10,10,2025-03-25,11,35,51,16,176
753,13,26,2025-03-28,5,368,540,172,860
186,8,13,2025-03-11,11,347,379,32,352
326,12,4,2025-03-23,17,139,154,15,255
531,3,9,2025-03-20,16,354,385,31,496
294,25,24,2025-03-12,11,157,228,71,781
330,13,25,2025-03-21,1,76,89,13,13
819,21,23,2025-03-05,18,498,711,213,3834
955,13,5,2025-03-30,16,173,259,86,1376
817,21,19,2025-03-17,6,295,355,60,360
437,2,18,2025-03-31,2,389,492,103,206
942,17,21,2025-03-16,18,349,418,69,1242
52,20,14,2025-03-08,8,288,336,48,384
499,29,20,2025-03-28,5,26,36,10,50
386,20,11,2025-03-20,15,294,375,81,1215
677,3,20,2025-03-09,3,295,421,126,378
730,26,5,2025-03-22,17,180,226,46,782
745,29,27,2025-03-30,11,460,515,55,605
553,3,27,2025-03-16,19,166,201,35,665
9,11,20,2025-03-31,14,249,299,50,700
740,11,25,2025-03-13,12,226,259,33,396
139,8,27,2025-03-24,2,152,206,54,108
249,25,28,2025-03-16,17,405,586,181,3077
834,10,13,2025-03-30,12,115,141,26,312
864,18,12,2025-03-29,15,175,257,82,1230
285,30,7,2025-03-10,9,306,435,129,1161
280,21,10,2025-03-18,11,199,211,12,132
4,3,19,2025-03-01,19,499,633,134,2546
12,12,17,2025-03-04,18,306,399,93,1674
731,14,18,2025-03-13,17,296,368,72,1224
52,7,17,2025-03-20,18,242,327,85,1530
52,14,24,2025-03-11,1,33,39,6,6
768,25,26,2025-03-06,16,251,309,58,928
573,3,12,2025-03-06,2,202,281,79,158
154,23,25,2025-03-15,15,381,452,71,1065
765,16,17,2025-03-21,19,435,620,185,3515
829,26,30,2025-03-10,5,126,147,21,105
798,19,6,2025-03-10,19,276,314,38,722
210,8,30,2025-03-23,16,127,176,49,784
620,8,8,2025-03-31,20,231,336,105,2100
887,17,26,2025-03-30,13,130,170,40,520
728,8,16,2025-03-12,15,477,561,84,1260
414,1,13,2025-03-11,6,190,284,94,564
955,13,27,2025-03-20,18,143,164,21,378
714,18,24,2025-03-15,12,304,419,115,1380
642,12,5,2025-03-25,17,344,440,96,1632
188,13,10,2025-03-07,6,476,701,225,1350
351,22,27,2025-03-21,6,121,153,32,192
197,28,21,2025-03-10,18,28,31,3,54
85,28,18,2025-03-30,13,349,473,124,1612
783,27,24,2025-03-27,7,85,98,13,91
583,7,19,2025-03-04,6,282,362,80,480
736,9,6,2025-03-26,5,110,156,46,230
185,14,26,2025-03-25,20,462,610,148,2960
92,19,23,2025-03-01,13,182,205,23,299
436,24,20,2025-03-01,5,123,180,57,285
358,26,8,2025-03-01,12,466,543,77,924
925,17,29,2025-03-05,8,91,126,35,280
678,17,13,2025-03-10,13,347,513,166,2158
291,2,14,2025-03-23,15,368,512,144,2160
720,29,10,2025-03-29,17,416,477,61,1037
961,21,8,2025-03-19,8,146,188,42,336
346,1,3,2025-03-29,17,389,462,73,1241
566,8,29,2025-03-20,1,383,463,80,80
112,26,27,2025-03-21,7,253,379,126,882
145,12,6,2025-03-31,3,410,555,145,435
998,27,6,2025-03-18,17,460,537,77,1309
45,24,17,2025-03-28,6,99,117,18,108
784,8,22,2025-03-23,1,364,454,90,90
29,10,11,2025-03-09,18,35,38,3,54
149,22,21,2025-03-27,6,408,570,162,972
988,6,1,2025-03-01,7,458,547,89,623
963,30,14,2025-03-13,3,326,423,97,291
655,12,29,2025-03-23,5,27,32,5,25
538,26,25,2025-03-19,11,418,589,171,1881
626,10,25,2025-03-17,2,415,513,98,196
129,21,29,2025-03-07,1,37,55,18,18
907,23,20,2025-03-10,7,106,116,10,70
795,25,12,2025-03-19,5,24,27,3,15
804,11,15,2025-03-17,3,124,157,33,99
958,4,2,2025-03-02,20,218,299,81,1620
770,25,9,2025-03-22,20,275,348,73,1460
470,4,12,2025-03-24,11,205,294,89,979
26,1,6,2025-03-29,20,96,103,7,140
534,22,15,2025-03-27,2,271,402,131,262
600,5,2,2025-03-26,8,142,175,33,264
703,21,10,2025-03-28,19,486,553,67,1273
151,23,10,2025-03-19,2,29,39,10,20
187,11,21,2025-03-27,15,161,179,18,270
845,8,13,2025-03-18,18,147,196,49,882
72,19,7,2025-03-20,9,398,481,83,747
722,15,10,2025-03-17,15,274,340,66,990
989,1,17,2025-03-03,7,239,334,95,665
537,7,1,2025-03-18,14,362,499,137,1918
695,4,22,2025-03-14,15,122,180,58,870
1000,23,14,2025-03-04,11,214,245,31,341
223,29,15,2025-03-23,15,21,26,5,75
94,15,20,2025-03-06,11,192,253,61,671
831,29,29,2025-03-08,11,209,266,57,627
205,24,18,2025-03-26,9,307,355,48,432
294,25,16,2025-03-03,11,270,369,99,1089
635,17,5,2025-03-17,6,84,105,21,126
354,23,26,2025-03-29,9,365,457,92,828
794,25,6,2025-03-13,2,107,118,11,22
987,29,27,2025-03-23,1,408,603,195,195
782,2,23,2025-03-04,10,360,480,120,1200
999,17,2,2025-03-30,16,97,134,37,592
506,2,8,2025-03-07,13,382,505,123,1599
428,16,7,2025-03-01,14,235,327,92,1288
841,3,26,2025-03-06,3,193,216,23,69
256,23,10,2025-03-17,8,357,478,121,968
971,21,26,2025-03-13,5,160,240,80,400
166,6,27,2025-03-13,3,487,679,192,576
152,25,2,2025-03-12,9,82,97,15,135
800,3,8,2025-03-21,1,478,525,47,47
667,6,4,2025-03-04,10,341,476,135,1350
83,13,23,2025-03-21,8,203,277,74,592
79,2,11,2025-03-10,15,206,289,83,1245
284,2,11,2025-03-22,7,467,501,34,238
905,22,21,2025-03-12,12,486,631,145,1740
280,19,6,2025-03-22,5,305,351,46,230
307,25,21,2025-03-05,16,318,357,39,624
502,30,12,2025-03-17,10,158,189,31,310
80,19,29,2025-03-29,10,466,661,195,1950
585,3,15,2025-03-06,19,469,561,92,1748
731,27,24,2025-03-12,16,380,423,43,688
648,6,7,2025-03-21,3,287,331,44,132
926,20,1,2025-03-12,11,217,268,51,561
727,3,25,2025-03-21,15,432,567,135,2025
673,4,9,2025-03-27,16,144,167,23,368
110,29,20,2025-03-23,15,457,578,121,1815
253,11,18,2025-03-13,2,219,232,13,26
446,2,12,2025-03-25,15,161,175,14,210
130,5,17,2025-03-09,18,268,376,108,1944
124,9,28,2025-03-02,4,497,541,44,176
330,7,25,2025-03-24,7,189,276,87,609
297,7,27,2025-03-24,5,275,380,105,525
180,17,18,2025-03-09,16,138,146,8,128
243,4,15,2025-03-12,11,108,124,16,176
971,1,1,2025-03-09,1,383,406,23,23
798,17,5,2025-03-05,11,41,58,17,187
927,13,7,2025-03-22,2,145,213,68,136
401,22,20,2025-03-02,12,211,289,78,936
780,1,18,2025-03-22,11,35,44,9,99
940,5,19,2025-03-07,6,328,368,40,240
64,27,29,2025-03-05,15,440,558,118,1770
604,6,26,2025-03-07,16,452,564,112,1792
155,15,23,2025-03-31,13,219,268,49,637
649,6,9,2025-03-29,3,428,627,199,597
881,10,14,2025-03-04,13,367,541,174,2262
454,2,1,2025-03-19,14,363,456,93,1302
936,21,21,2025-03-11,16,46,58,12,192
724,22,26,2025-03-13,20,239,343,104,2080
998,26,2,2025-03-25,2,140,156,16,32
996,26,23,2025-03-10,15,70,101,31,465
404,9,27,2025-03-16,20,499,529,30,600
986,20,23,2025-03-31,17,245,273,28,476
7,15,24,2025-03-27,11,435,612,177,1947
171,10,1,2025-03-13,7,271,367,96,672
103,20,25,2025-03-17,15,188,282,94,1410
234,3,20,2025-03-22,13,243,348,105,1365
908,23,14,2025-03-22,8,413,577,164,1312
865,27,25,2025-03-09,5,379,407,28,140
599,8,10,2025-03-02,19,60,77,17,323
404,4,27,2025-03-10,12,310,387,77,924
278,21,14,2025-03-06,1,352,487,135,135
851,11,29,2025-03-27,8,265,322,57,456
136,8,26,2025-03-07,9,105,113,8,72
937,19,12,2025-03-01,1,103,152,49,49
414,24,22,2025-03-13,3,431,537,106,318
372,7,13,2025-03-21,17,244,335,91,1547
562,29,10,2025-03-29,10,109,154,45,450
267,26,22,2025-03-20,11,102,121,19,209
935,23,29,2025-03-08,12,441,645,204,2448
784,22,17,2025-03-23,18,73,106,33,594
824,24,28,2025-03-08,10,34,38,4,40
374,22,2,2025-03-15,19,106,123,17,323
119,19,24,2025-03-02,20,290,322,32,640
719,20,23,2025-03-04,15,21,24,3,45
892,25,10,2025-03-19,11,448,648,200,2200
42,4,11,2025-03-08,16,369,533,164,2624
714,9,20,2025-03-06,1,293,423,130,130
557,9,14,2025-03-05,9,324,391,67,603
337,15,16,2025-03-07,7,420,469,49,343
600,5,4,2025-03-10,1,479,618,139,139
285,22,23,2025-03-20,2,87,99,12,24
654,25,21,2025-03-09,7,291,354,63,441
936,26,8,2025-03-24,4,89,103,14,56
640,23,3,2025-03-25,15,449,605,156,2340
774,18,15,2025-03-26,19,104,109,5,95
979,4,25,2025-03-02,17,357,451,94,1598
627,1,20,2025-03-20,17,82,109,27,459
81,5,6,2025-03-04,7,306,337,31,217
523,24,4,2025-03-02,14,25,33,8,112
94,22,9,2025-03-09,18,415,491,76,1368
953,26,12,2025-03-26,9,38,56,18,162
653,17,7,2025-03-15,15,396,482,86,1290
455,18,5,2025-03-29,5,25,33,8,40
216,10,18,2025-03-15,13,274,325,51,663
39,27,25,2025-03-08,7,483,597,114,798
595,1,3,2025-03-19,6,365,446,81,486
865,2,10,2025-03-22,9,243,361,118,1062
687,9,26,2025-03-12,17,434,486,52,884
222,1,13,2025-03-06,1,53,77,24,24
576,27,2,2025-03-08,6,94,106,12,72
273,27,2,2025-03-16,16,389,479,90,1440
144,29,25,2025-03-29,14,33,38,5,70
159,28,5,2025-03-18,5,305,420,115,575
826,4,22,2025-03-06,12,409,532,123,1476
372,13,12,2025-03-14,16,431,593,162,2592
872,12,8,2025-03-14,5,83,96,13,65
35,13,25,2025-03-18,6,360,479,119,714
267,18,28,2025-03-01,20,139,172,33,660
760,6,8,2025-03-31,16,413,461,48,768
367,29,30,2025-03-23,14,402,490,88,1232
36,26,12,2025-03-07,3,184,272,88,264
638,23,28,2025-03-20,11,240,309,69,759
677,19,30,2025-03-02,11,481,605,124,1364
855,20,24,2025-03-20,1,405,577,172,172
684,23,19,2025-03-21,20,411,482,71,1420
816,2,7,2025-03-09,8,146,168,22,176
952,16,9,2025-03-25,11,97,142,45,495
219,17,23,2025-03-20,3,303,323,20,60
804,1,25,2025-03-31,2,377,539,162,324
661,8,6,2025-03-05,17,494,697,203,3451
483,17,17,2025-03-18,9,75,87,12,108
915,16,14,2025-03-08,18,485,726,241,4338
520,10,7,2025-03-01,7,236,255,19,133
18,17,23,2025-03-18,4,51,72,21,84
214,8,5,2025-03-14,18,283,316,33,594
424,2,22,2025-03-04,16,143,209,66,1056
958,15,19,2025-03-09,6,26,36,10,60
282,13,20,2025-03-19,7,465,567,102,714
946,14,16,2025-03-25,4,491,636,145,580
42,18,16,2025-03-01,7,360,521,161,1127
483,1,22,2025-03-16,11,61,78,17,187
848,16,5,2025-03-29,11,244,297,53,583
488,22,3,2025-03-18,17,344,395,51,867
331,7,1,2025-03-21,18,415,555,140,2520
578,21,4,2025-03-11,2,461,589,128,256
605,26,10,2025-03-03,8,329,360,31,248
14,15,24,2025-03-23,6,182,218,36,216
289,3,28,2025-03-31,11,134,174,40,440
388,27,24,2025-03-29,5,361,501,140,700
285,21,30,2025-03-20,10,296,409,113,1130
320,7,28,2025-03-21,19,260,325,65,1235
1000,16,7,2025-03-09,4,341,496,155,620
772,12,29,2025-03-11,15,484,636,152,2280
918,22,8,2025-03-11,2,342,375,33,66
479,2,22,2025-03-04,7,55,74,19,133
860,30,30,2025-03-01,3,469,677,208,624
63,4,22,2025-03-05,3,324,460,136,408
617,18,9,2025-03-30,6,381,444,63,378
756,25,13,2025-03-08,13,174,213,39,507
221,18,19,2025-03-22,8,423,517,94,752
436,7,23,2025-03-23,3,444,522,78,234
603,27,29,2025-03-12,8,41,48,7,56
512,21,16,2025-03-21,9,150,220,70,630
787,24,21,2025-03-20,17,370,529,159,2703
568,2,27,2025-03-05,8,372,472,100,800
258,22,7,2025-03-01,7,300,402,102,714
602,20,5,2025-03-31,13,62,89,27,351
653,17,6,2025-03-24,20,107,121,14,280
312,9,23,2025-03-30,6,25,37,12,72
661,18,2,2025-03-08,14,348,448,100,1400
142,20,25,2025-03-14,16,149,218,69,1104
283,12,28,2025-03-06,1,336,376,40,40
67,2,17,2025-03-09,18,258,328,70,1260
89,10,2,2025-03-10,20,44,49,5,100
827,12,28,2025-03-10,12,150,187,37,444
521,22,16,2025-03-20,16,476,672,196,3136
609,19,9,2025-03-23,4,20,26,6,24
119,19,13,2025-03-11,16,445,578,133,2128
168,21,14,2025-03-20,12,488,606,118,1416
872,18,9,2025-03-25,16,28,32,4,64
488,27,20,2025-03-11,10,398,577,179,1790
520,30,18,2025-03-23,7,27,38,11,77
111,5,26,2025-03-27,14,293,333,40,560
331,6,6,2025-03-21,17,290,395,105,1785
506,6,4,2025-03-19,6,131,142,11,66
687,13,14,2025-03-26,1,125,165,40,40
818,12,16,2025-03-05,3,406,481,75,225
828,3,25,2025-03-28,16,322,411,89,1424
863,19,15,2025-03-27,20,160,178,18,360
631,23,22,2025-03-23,18,125,153,28,504
345,9,3,2025-03-30,2,163,186,23,46
536,3,12,2025-03-06,9,399,552,153,1377
677,12,19,2025-03-04,12,491,691,200,2400
727,16,29,2025-03-25,3,404,535,131,393
868,29,27,2025-03-14,4,266,320,54,216
624,11,2,2025-03-19,5,306,437,131,655
560,4,3,2025-03-24,9,369,440,71,639
953,27,28,2025-03-31,3,106,147,41,123
489,24,18,2025-03-30,7,97,105,8,56
646,4,7,2025-03-06,19,209,279,70,1330
346,13,3,2025-03-20,14,148,181,33,462
290,24,27,2025-03-03,10,307,414,107,1070
873,28,25,2025-03-28,13,223,298,75,975
455,21,4,2025-03-18,18,353,461,108,1944
584,26,1,2025-03-03,20,126,146,20,400
931,21,24,2025-03-07,6,294,362,68,408
167,15,27,2025-03-12,9,257,314,57,513
254,27,30,2025-03-29,18,387,562,175,3150
670,8,23,2025-03-14,18,195,214,19,342
713,16,30,2025-03-11,9,360,441,81,729
322,8,16,2025-03-01,1,481,663,182,182
48,19,28,2025-03-15,1,169,188,19,19
381,26,29,2025-03-08,3,175,194,19,57
334,4,15,2025-03-12,17,183,222,39,663
146,15,3,2025-03-10,6,396,563,167,1002
993,12,11,2025-03-23,4,226,288,62,248
571,26,30,2025-03-19,3,406,506,100,300
8,16,27,2025-03-31,2,75,100,25,50
632,4,10,2025-03-19,20,419,619,200,4000
331,3,22,2025-03-27,15,347,473,126,1890
484,7,27,2025-03-27,8,31,36,5,40
499,29,19,2025-03-13,15,236,257,21,315
261,28,20,2025-03-15,10,122,133,11,110
49,4,6,2025-03-09,16,82,89,7,112
303,1,16,2025-03-07,18,356,395,39,702
624,17,19,2025-03-06,19,268,306,38,722
561,16,16,2025-03-01,4,45,58,13,52
557,24,27,2025-03-28,17,462,670,208,3536
442,2,25,2025-03-22,7,210,285,75,525
615,5,12,2025-03-12,16,102,123,21,336
493,19,22,2025-03-17,3,73,88,15,45
821,4,14,2025-03-10,12,166,180,14,168
352,16,4,2025-03-04,13,117,164,47,611
124,27,28,2025-03-20,3,267,301,34,102
63,15,28,2025-03-28,6,262,350,88,528
357,25,23,2025-03-10,15,198,227,29,435
40,18,26,2025-03-09,14,180,232,52,728
658,11,3,2025-03-02,2,330,492,162,324
47,14,12,2025-03-08,19,182,236,54,1026
442,30,15,2025-03-01,4,433,621,188,752
357,20,16,2025-03-22,14,284,424,140,1960
444,16,19,2025-03-27,14,495,553,58,812
189,5,4,2025-03-19,7,228,277,49,343
312,8,25,2025-03-31,7,74,95,21,147
17,7,14,2025-03-27,19,367,428,61,1159
400,22,7,2025-03-11,5,261,370,109,545
77,27,19,2025-03-30,6,317,438,121,726
730,8,15,2025-03-15,9,420,442,22,198
974,12,27,2025-03-26,9,48,66,18,162
676,1,25,2025-03-29,8,315,337,22,176
905,29,26,2025-03-04,7,42,61,19,133
197,5,7,2025-03-15,2,98,130,32,64
201,17,19,2025-03-30,15,499,703,204,3060
361,30,23,2025-03-08,4,72,85,13,52
75,10,11,2025-03-09,12,377,515,138,1656
780,26,29,2025-03-28,3,111,133,22,66
252,5,5,2025-03-31,11,450,572,122,1342
152,16,14,2025-03-02,11,109,151,42,462
646,6,27,2025-03-12,16,329,387,58,928
933,23,30,2025-03-15,17,251,340,89,1513
578,18,30,2025-03-18,1,335,442,107,107
899,27,12,2025-03-19,16,254,323,69,1104
206,11,13,2025-03-15,15,150,171,21,315
497,8,16,2025-03-19,6,333,478,145,870
787,6,27,2025-03-29,3,35,47,12,36
313,2,13,2025-03-07,3,327,460,133,399
457,22,8,2025-03-03,14,465,669,204,2856
586,22,12,2025-03-15,5,212,272,60,300
890,13,10,2025-03-28,4,171,194,23,92
783,10,30,2025-03-17,7,431,482,51,357
459,15,26,2025-03-15,10,409,598,189,1890
462,25,5,2025-03-16,4,408,553,145,580
477,16,20,2025-03-07,4,158,226,68,272
385,10,10,2025-03-26,10,342,472,130,1300
430,25,23,2025-03-22,7,302,359,57,399
441,25,16,2025-03-02,7,486,637,151,1057
480,5,18,2025-03-05,2,44,57,13,26
34,25,20,2025-03-15,7,310,424,114,798
299,19,13,2025-03-24,6,301,360,59,354
232,8,7,2025-03-18,16,193,210,17,272
818,15,4,2025-03-17,15,467,508,41,615
700,25,26,2025-03-04,6,477,662,185,1110
698,15,19,2025-03-02,3,439,464,25,75
579,12,15,2025-03-10,19,410,465,55,1045
616,3,22,2025-03-10,4,282,322,40,160
868,25,2,2025-03-20,13,328,367,39,507
212,4,13,2025-03-13,5,488,655,167,835
23,25,27,2025-03-31,5,225,327,102,510
356,4,8,2025-03-31,15,44,52,8,120
106,13,14,2025-03-22,9,93,123,30,270
246,18,8,2025-03-31,4,246,330,84,336
434,9,4,2025-03-23,15,499,693,194,2910
735,10,22,2025-03-02,2,267,378,111,222
720,2,6,2025-03-15,7,500,675,175,1225
621,20,30,2025-03-21,13,194,249,55,715
453,16,26,2025-03-18,11,260,384,124,1364
436,23,22,2025-03-01,17,243,364,121,2057
168,12,8,2025-03-03,6,122,150,28,168
140,12,14,2025-03-24,15,156,220,64,960
965,23,2,2025-03-12,9,464,589,125,1125
755,8,1,2025-03-31,13,476,646,170,2210
449,21,5,2025-03-11,5,373,465,92,460
971,11,12,2025-03-05,11,57,72,15,165
963,11,22,2025-03-16,10,173,258,85,850
643,17,7,2025-03-14,17,231,328,97,1649
87,24,8,2025-03-11,3,464,647,183,549
469,5,17,2025-03-14,17,474,612,138,2346
421,20,2,2025-03-15,18,41,57,16,288
578,21,15,2025-03-22,19,128,154,26,494
908,18,20,2025-03-24,8,359,409,50,400
23,28,23,2025-03-04,5,253,303,50,250
505,24,10,2025-03-06,16,469,547,78,1248
304,6,5,2025-03-26,4,366,515,149,596
40,12,25,2025-03-16,13,126,152,26,338
807,21,17,2025-03-23,4,406,502,96,384
77,19,27,2025-03-22,18,247,305,58,1044
808,4,25,2025-03-14,3,353,516,163,489
1,1,20,2025-03-29,8,369,488,119,952
661,5,14,2025-03-29,8,47,64,17,136
830,24,4,2025-03-21,19,424,634,210,3990
52,10,3,2025-03-28,16,418,499,81,1296
658,14,16,2025-03-29,1,256,295,39,39
587,9,18,2025-03-05,9,481,565,84,756
387,21,22,2025-03-17,7,250,368,118,826
966,14,25,2025-03-13,10,213,318,105,1050
797,19,20,2025-03-07,16,377,407,30,480
941,23,26,2025-03-19,10,29,32,3,30
609,15,14,2025-03-22,5,461,635,174,870
892,5,19,2025-03-14,20,190,267,77,1540
782,25,5,2025-03-05,5,111,136,25,125
21,4,14,2025-03-21,10,400,449,49,490
88,14,3,2025-03-27,10,314,404,90,900
479,17,23,2025-03-28,18,170,221,51,918
805,22,14,2025-03-23,6,282,407,125,750
529,22,6,2025-03-03,3,459,601,142,426
985,30,11,2025-03-22,19,112,133,21,399
537,20,16,2025-03-18,20,394,541,147,2940
851,30,4,2025-03-16,15,324,369,45,675
364,10,24,2025-03-20,1,213,273,60,60
248,15,25,2025-03-11,2,84,114,30,60
406,16,19,2025-03-27,12,151,182,31,372
223,24,29,2025-03-27,12,195,212,17,204
138,2,17,2025-03-19,3,331,481,150,450
895,27,2,2025-03-07,1,472,708,236,236
730,26,3,2025-03-02,11,31,40,9,99
545,24,17,2025-03-04,1,282,338,56,56
2,12,4,2025-03-25,3,106,140,34,102
966,9,27,2025-03-04,15,229,291,62,930
905,14,22,2025-03-11,20,231,345,114,2280
95,15,30,2025-03-24,8,204,288,84,672
726,15,10,2025-03-10,20,367,400,33,660
358,24,13,2025-03-31,19,241,345,104,1976
239,18,1,2025-03-18,10,225,331,106,1060
734,26,2,2025-03-22,14,345,363,18,252
834,15,18,2025-03-17,7,76,93,17,119
902,26,24,2025-03-31,4,364,517,153,612
644,28,30,2025-03-17,6,330,456,126,756
189,4,29,2025-03-03,9,353,435,82,738
411,3,19,2025-03-16,3,464,627,163,489
583,20,26,2025-03-31,5,420,509,89,445
211,29,18,2025-03-08,4,104,145,41,164
1,20,8,2025-03-31,18,472,505,33,594
827,13,7,2025-03-16,11,84,97,13,143
211,20,11,2025-03-12,12,288,400,112,1344
887,19,11,2025-03-04,12,222,306,84,1008
719,12,17,2025-03-31,3,222,246,24,72
610,29,10,2025-03-08,12,143,194,51,612
916,15,19,2025-03-10,12,286,367,81,972
758,11,6,2025-03-02,3,167,196,29,87
922,16,11,2025-03-13,12,22,31,9,108
949,28,27,2025-03-27,1,217,273,56,56
79,30,27,2025-03-15,11,248,329,81,891
440,17,17,2025-03-14,13,423,509,86,1118
25,6,29,2025-03-09,11,151,181,30,330
124,21,19,2025-03-10,5,315,358,43,215
458,6,5,2025-03-05,18,302,353,51,918
241,7,27,2025-03-23,19,152,202,50,950
106,13,5,2025-03-17,7,345,378,33,231
655,16,26,2025-03-09,17,290,357,67,1139
889,11,1,2025-03-20,9,92,136,44,396
347,23,11,2025-03-09,11,62,79,17,187
940,30,30,2025-03-25,2,301,385,84,168
463,6,11,2025-03-20,4,209,269,60,240
766,5,20,2025-03-06,13,261,287,26,338
107,26,25,2025-03-02,7,492,531,39,273
516,11,22,2025-03-31,6,273,358,85,510
362,22,22,2025-03-13,14,135,176,41,574
865,12,19,2025-03-08,2,405,587,182,364
222,5,22,2025-03-02,14,144,172,28,392
69,6,26,2025-03-04,17,190,218,28,476
837,15,19,2025-03-30,15,380,470,90,1350
462,19,18,2025-03-20,14,45,57,12,168
403,12,15,2025-03-15,17,424,457,33,561
930,22,14,2025-03-21,1,396,433,37,37
14,28,21,2025-03-28,12,96,112,16,192
565,7,1,2025-03-15,17,391,439,48,816
825,12,27,2025-03-10,2,298,323,25,50
358,2,12,2025-03-22,8,104,153,49,392
494,7,17,2025-03-03,5,289,347,58,290
966,29,6,2025-03-03,17,146,190,44,748
823,21,25,2025-03-20,15,184,198,14,210
254,20,5,2025-03-02,4,149,183,34,136
732,26,13,2025-03-08,2,338,365,27,54
620,4,5,2025-03-16,18,102,141,39,702
807,22,11,2025-03-22,20,96,113,17,340
993,9,26,2025-03-03,13,80,104,24,312
891,4,19,2025-03-30,2,378,502,124,248
204,30,17,2025-03-14,5,494,686,192,960
392,18,19,2025-03-23,12,262,310,48,576
851,26,7,2025-03-23,4,474,533,59,236
298,27,20,2025-03-05,18,178,236,58,1044
924,4,27,2025-03-24,12,172,230,58,696
143,17,27,2025-03-08,16,348,446,98,1568
603,9,27,2025-03-10,5,88,107,19,95
430,18,27,2025-03-30,15,91,120,29,435
606,22,1,2025-03-10,13,445,664,219,2847
822,3,26,2025-03-07,5,180,226,46,230
437,7,11,2025-03-21,12,459,570,111,1332
65,27,28,2025-03-20,12,383,421,38,456
474,13,10,2025-03-06,5,452,631,179,895
48,29,8,2025-03-25,19,444,471,27,513
993,26,22,2025-03-25,20,195,234,39,780
84,23,24,2025-03-13,6,275,378,103,618
620,16,20,2025-03-20,13,401,438,37,481
158,5,11,2025-03-14,19,43,46,3,57
545,16,1,2025-03-13,9,367,536,169,1521
866,18,24,2025-03-16,11,138,200,62,682
769,9,25,2025-03-30,1,84,106,22,22
179,4,2,2025-03-27,6,207,228,21,126
713,23,2,2025-03-01,5,455,517,62,310
507,3,1,2025-03-02,18,79,99,20,360
463,10,2,2025-03-08,9,249,317,68,612
439,20,20,2025-03-25,12,445,501,56,672
138,7,16,2025-03-09,10,432,494,62,620
866,14,12,2025-03-14,18,337,453,116,2088
61,16,9,2025-03-13,1,375,407,32,32
359,25,19,2025-03-12,16,464,689,225,3600
130,24,15,2025-03-13,10,478,712,234,2340
193,30,2,2025-03-25,3,25,28,3,9
392,4,20,2025-03-31,8,442,518,76,608
687,11,5,2025-03-28,3,224,297,73,219
596,10,15,2025-03-01,9,117,162,45,405
654,5,15,2025-03-05,6,175,221,46,276
35,15,4,2025-03-21,9,117,153,36,324
350,15,7,2025-03-07,13,405,558,153,1989
965,22,25,2025-03-18,5,359,427,68,340
47,22,12,2025-03-07,15,37,51,14,210
296,22,20,2025-03-10,12,492,712,220,2640
673,5,27,2025-03-01,2,37,44,7,14
207,27,15,2025-03-28,16,78,84,6,96
928,3,7,2025-03-19,12,180,241,61,732
493,3,3,2025-03-22,18,122,130,8,144
500,11,7,2025-03-26,2,381,525,144,288
776,29,6,2025-03-10,20,90,117,27,540
63,13,6,2025-03-22,2,83,123,40,80
372,1,28,2025-03-06,13,353,495,142,1846
574,23,11,2025-03-20,13,462,531,69,897
20,25,29,2025-03-05,1,34,39,5,5
539,23,26,2025-03-11,18,67,90,23,414
971,10,2,2025-03-21,7,276,338,62,434
665,5,14,2025-03-28,20,262,276,14,280
715,3,17,2025-03-06,1,216,286,70,70
245,21,16,2025-03-31,17,297,439,142,2414
316,30,6,2025-03-28,11,473,708,235,2585
871,30,8,2025-03-14,2,216,317,101,202
465,19,7,2025-03-21,19,237,304,67,1273
379,9,12,2025-03-27,1,336,408,72,72
220,21,25,2025-03-13,12,374,424,50,600
353,2,11,2025-03-16,10,311,466,155,1550
377,24,23,2025-03-17,13,425,627,202,2626
353,7,7,2025-03-01,14,323,353,30,420
364,24,30,2025-03-17,13,68,95,27,351
451,24,26,2025-03-24,10,259,343,84,840
999,2,19,2025-03-30,20,140,196,56,1120
237,20,7,2025-03-30,19,230,303,73,1387
156,5,6,2025-03-07,13,113,165,52,676
642,3,11,2025-03-25,17,100,109,9,153
797,14,20,2025-03-15,17,488,689,201,3417
134,12,24,2025-03-11,18,88,104,16,288
18,19,6,2025-03-19,17,46,56,10,170
214,3,6,2025-03-04,3,487,699,212,636
461,8,20,2025-03-08,7,485,586,101,707
332,27,24,2025-03-30,4,292,335,43,172
10,15,5,2025-03-14,12,327,421,94,1128
493,14,30,2025-03-28,7,243,353,110,770
84,15,5,2025-03-13,20,95,106,11,220
240,25,3,2025-03-31,18,222,237,15,270
477,28,2,2025-03-20,10,458,647,189,1890
753,24,25,2025-03-01,13,472,511,39,507
801,10,26,2025-03-23,4,197,214,17,68
99,27,21,2025-03-02,10,390,515,125,1250
392,7,3,2025-03-17,8,272,342,70,560
804,16,7,2025-03-18,10,159,235,76,760
577,27,23,2025-03-19,15,300,405,105,1575
704,12,10,2025-03-13,20,434,468,34,680
223,27,22,2025-03-07,5,125,165,40,200
995,18,12,2025-03-10,10,347,463,116,1160
583,11,27,2025-03-10,14,325,345,20,280
54,5,13,2025-03-11,2,97,103,6,12
398,14,4,2025-03-01,12,419,481,62,744
172,29,16,2025-03-28,1,63,77,14,14
559,25,4,2025-03-25,16,365,388,23,368
887,2,21,2025-03-13,19,150,168,18,342
436,8,19,2025-03-31,1,397,491,94,94
777,1,20,2025-03-16,10,486,653,167,1670
846,5,11,2025-03-06,14,368,535,167,2338
