ID_zbozi,ID_lekarna,ID_vedouci,datum,pocet_prodanych_ks,nakupni_cena_CZK,prodejni_cena_CZK,marze_CZK,trzba_CZK
655,4,1,24.11.2024,9,138,153,15,1377
105,22,24,29.11.2024,18,62,77,15,1386
31,3,7,08.11.2024,17,309,402,93,6834
734,21,23,18.11.2024,14,126,165,39,2310
829,28,1,25.11.2024,6,355,427,72,2562
160,7,25,11.11.2024,4,65,71,6,284
868,12,20,09.11.2024,2,370,478,108,956
997,30,13,03.11.2024,18,161,214,53,3852
907,28,12,19.11.2024,7,358,383,25,2681
234,25,10,03.11.2024,8,436,532,96,4256
465,21,27,12.11.2024,6,198,226,28,1356
274,23,30,22.11.2024,3,312,352,40,1056
747,8,6,15.11.2024,13,150,219,69,2847
705,18,8,22.11.2024,11,425,594,169,6534
235,27,2,26.11.2024,11,213,230,17,2530
936,19,29,23.11.2024,11,122,156,34,1716
906,30,21,15.11.2024,5,147,171,24,855
575,18,9,24.11.2024,19,226,296,70,5624
371,8,5,17.11.2024,16,64,68,4,1088
113,5,21,06.11.2024,14,306,375,69,5250
611,15,17,09.11.2024,18,433,457,24,8226
739,4,22,29.11.2024,18,380,531,151,9558
349,4,10,14.11.2024,6,238,352,114,2112
897,24,9,17.11.2024,6,264,290,26,1740
641,10,27,21.11.2024,17,312,349,37,5933
781,6,18,25.11.2024,17,461,608,147,10336
501,1,4,30.11.2024,12,442,629,187,7548
315,8,2,08.11.2024,19,475,517,42,9823
498,27,3,25.11.2024,18,388,429,41,7722
487,18,6,09.11.2024,17,439,544,105,9248
217,30,18,25.11.2024,7,362,445,83,3115
688,21,12,15.11.2024,17,237,275,38,4675
66,11,1,19.11.2024,18,130,150,20,2700
73,23,21,02.11.2024,8,52,56,4,448
339,3,17,08.11.2024,9,341,391,50,3519
136,24,30,29.11.2024,19,297,344,47,6536
485,26,14,07.11.2024,4,67,83,16,332
434,14,15,28.11.2024,2,343,512,169,1024
101,2,13,24.11.2024,11,404,444,40,4884
197,7,18,15.11.2024,5,223,262,39,1310
256,28,30,03.11.2024,15,408,585,177,8775
101,2,21,18.11.2024,1,485,712,227,712
870,8,6,14.11.2024,16,251,361,110,5776
925,2,6,13.11.2024,1,493,576,83,576
803,26,15,10.11.2024,14,354,489,135,6846
803,18,22,23.11.2024,16,94,112,18,1792
992,2,19,24.11.2024,18,49,59,10,1062
52,19,16,17.11.2024,17,96,142,46,2414
83,28,6,03.11.2024,20,53,76,23,1520
414,4,29,19.11.2024,8,298,318,20,2544
84,14,22,19.11.2024,19,271,398,127,7562
210,22,23,11.11.2024,8,147,164,17,1312
661,10,15,11.11.2024,3,24,33,9,99
577,4,3,18.11.2024,7,263,292,29,2044
358,29,3,29.11.2024,8,197,221,24,1768
854,18,23,10.11.2024,20,492,696,204,13920
542,1,22,27.11.2024,18,164,221,57,3978
962,29,5,09.11.2024,4,447,619,172,2476
160,9,10,20.11.2024,7,364,416,52,2912
650,28,9,17.11.2024,16,141,205,64,3280
53,3,21,14.11.2024,9,41,49,8,441
134,21,9,06.11.2024,15,285,354,69,5310
10,4,3,29.11.2024,5,282,402,120,2010
597,18,5,14.11.2024,5,40,49,9,245
956,26,28,02.11.2024,12,121,140,19,1680
106,12,25,18.11.2024,14,487,676,189,9464
948,30,8,28.11.2024,6,489,691,202,4146
903,14,1,06.11.2024,11,396,489,93,5379
686,28,24,26.11.2024,8,148,208,60,1664
111,13,28,02.11.2024,16,127,180,53,2880
472,12,10,27.11.2024,8,127,171,44,1368
409,11,9,28.11.2024,3,484,569,85,1707
657,17,13,22.11.2024,18,179,190,11,3420
899,9,6,19.11.2024,9,38,51,13,459
354,24,26,11.11.2024,14,311,398,87,5572
395,29,19,07.11.2024,9,41,51,10,459
533,30,26,18.11.2024,7,195,211,16,1477
681,30,11,20.11.2024,11,338,374,36,4114
922,10,17,10.11.2024,14,177,241,64,3374
568,5,7,14.11.2024,13,345,503,158,6539
631,19,10,13.11.2024,18,420,499,79,8982
216,14,26,19.11.2024,20,334,421,87,8420
453,22,7,17.11.2024,16,401,594,193,9504
754,6,22,03.11.2024,10,267,357,90,3570
344,3,27,25.11.2024,8,343,395,52,3160
204,5,1,02.11.2024,8,492,652,160,5216
787,3,15,14.11.2024,19,113,155,42,2945
507,13,8,05.11.2024,1,448,645,197,645
907,4,25,14.11.2024,8,104,155,51,1240
531,15,2,18.11.2024,8,460,509,49,4072
137,26,15,22.11.2024,17,494,651,157,11067
973,25,29,15.11.2024,20,411,597,186,11940
437,27,30,18.11.2024,15,451,624,173,9360
487,15,9,25.11.2024,8,423,497,74,3976
797,17,16,21.11.2024,8,152,165,13,1320
293,8,9,11.11.2024,11,449,487,38,5357
155,8,13,23.11.2024,5,359,387,28,1935
418,11,18,15.11.2024,14,50,71,21,994
399,29,25,19.11.2024,1,431,601,170,601
390,16,1,12.11.2024,10,382,547,165,5470
977,27,14,18.11.2024,18,404,587,183,10566
500,8,9,14.11.2024,16,34,41,7,656
696,26,13,24.11.2024,6,423,620,197,3720
638,18,1,30.11.2024,13,304,410,106,5330
86,21,14,05.11.2024,15,107,125,18,1875
336,7,15,11.11.2024,11,385,470,85,5170
771,27,14,09.11.2024,3,246,341,95,1023
54,12,8,21.11.2024,3,395,531,136,1593
773,1,8,07.11.2024,1,318,368,50,368
485,22,4,19.11.2024,7,243,283,40,1981
378,6,20,20.11.2024,4,393,442,49,1768
319,4,19,01.11.2024,10,296,432,136,4320
385,13,23,07.11.2024,3,304,433,129,1299
249,4,23,25.11.2024,10,428,565,137,5650
124,26,19,26.11.2024,2,187,232,45,464
380,3,17,21.11.2024,11,26,32,6,352
502,4,14,12.11.2024,15,360,448,88,6720
752,17,21,09.11.2024,20,408,527,119,10540
496,15,14,27.11.2024,19,149,213,64,4047
851,30,3,09.11.2024,15,137,173,36,2595
625,22,13,11.11.2024,1,257,308,51,308
500,7,12,26.11.2024,9,183,265,82,2385
719,29,9,18.11.2024,1,268,304,36,304
248,24,14,16.11.2024,18,384,522,138,9396
662,23,16,15.11.2024,1,65,74,9,74
709,8,10,22.11.2024,19,197,256,59,4864
353,14,24,18.11.2024,11,189,237,48,2607
314,9,8,04.11.2024,7,171,237,66,1659
974,25,23,06.11.2024,7,124,157,33,1099
742,19,25,17.11.2024,20,156,171,15,3420
199,10,8,12.11.2024,6,165,226,61,1356
130,9,2,02.11.2024,18,160,236,76,4248
654,28,25,16.11.2024,4,439,574,135,2296
481,16,15,11.11.2024,6,483,563,80,3378
883,16,4,27.11.2024,3,212,230,18,690
645,22,2,05.11.2024,5,409,605,196,3025
88,8,4,18.11.2024,14,311,437,126,6118
232,25,17,13.11.2024,15,456,540,84,8100
603,14,10,19.11.2024,20,49,72,23,1440
102,25,7,21.11.2024,7,147,160,13,1120
246,6,18,03.11.2024,6,21,27,6,162
609,16,10,02.11.2024,8,158,186,28,1488
881,15,3,22.11.2024,8,463,651,188,5208
641,19,22,26.11.2024,7,224,290,66,2030
664,5,30,09.11.2024,5,54,61,7,305
315,20,24,27.11.2024,19,462,577,115,10963
480,23,10,23.11.2024,13,472,603,131,7839
506,15,3,20.11.2024,2,447,617,170,1234
619,9,1,03.11.2024,8,482,687,205,5496
590,19,1,25.11.2024,9,297,413,116,3717
180,16,17,21.11.2024,15,460,520,60,7800
600,14,21,27.11.2024,16,485,612,127,9792
419,11,11,22.11.2024,4,432,517,85,2068
711,16,10,22.11.2024,13,411,533,122,6929
466,3,11,09.11.2024,11,76,106,30,1166
886,17,27,01.11.2024,18,242,260,18,4680
531,12,20,25.11.2024,16,320,446,126,7136
209,9,18,05.11.2024,10,230,314,84,3140
125,1,21,20.11.2024,8,361,429,68,3432
15,18,14,03.11.2024,8,496,725,229,5800
473,4,21,27.11.2024,5,259,356,97,1780
522,23,9,14.11.2024,16,491,569,78,9104
565,5,13,07.11.2024,20,264,382,118,7640
885,3,9,25.11.2024,14,183,257,74,3598
274,27,1,10.11.2024,10,422,553,131,5530
676,16,28,05.11.2024,15,279,336,57,5040
566,25,18,13.11.2024,15,468,674,206,10110
715,8,19,13.11.2024,8,431,532,101,4256
326,24,16,23.11.2024,13,205,277,72,3601
841,21,5,16.11.2024,2,81,120,39,240
340,28,4,28.11.2024,15,68,99,31,1485
16,24,5,14.11.2024,5,56,78,22,390
272,11,20,23.11.2024,13,332,476,144,6188
873,22,28,18.11.2024,13,478,637,159,8281
909,25,16,28.11.2024,18,37,40,3,720
647,22,30,10.11.2024,8,378,471,93,3768
101,25,21,23.11.2024,4,233,317,84,1268
926,1,2,11.11.2024,2,161,196,35,392
150,8,17,14.11.2024,19,347,393,46,7467
180,3,20,28.11.2024,13,317,368,51,4784
935,19,5,08.11.2024,15,326,410,84,6150
683,1,29,26.11.2024,15,453,613,160,9195
162,3,15,12.11.2024,19,164,243,79,4617
707,9,15,28.11.2024,10,116,141,25,1410
495,4,8,13.11.2024,19,192,228,36,4332
717,10,1,27.11.2024,13,152,198,46,2574
703,25,24,02.11.2024,20,378,538,160,10760
925,10,25,26.11.2024,8,311,376,65,3008
652,7,20,09.11.2024,5,322,468,146,2340
662,2,10,26.11.2024,15,36,44,8,660
135,3,30,10.11.2024,11,379,428,49,4708
136,26,18,29.11.2024,12,275,402,127,4824
851,6,9,30.11.2024,16,484,573,89,9168
892,11,26,04.11.2024,15,482,537,55,8055
990,8,28,22.11.2024,13,484,684,200,8892
375,3,26,13.11.2024,1,147,162,15,162
378,22,24,22.11.2024,9,301,427,126,3843
963,12,4,22.11.2024,8,246,327,81,2616
966,18,11,30.11.2024,20,126,136,10,2720
844,15,30,23.11.2024,10,332,366,34,3660
47,2,10,16.11.2024,4,67,97,30,388
139,13,15,12.11.2024,18,221,306,85,5508
159,29,14,21.11.2024,4,420,558,138,2232
962,9,2,23.11.2024,12,124,155,31,1860
242,28,12,04.11.2024,12,281,419,138,5028
368,2,13,09.11.2024,7,485,716,231,5012
844,15,3,22.11.2024,7,328,433,105,3031
22,2,26,11.11.2024,8,495,695,200,5560
211,3,27,25.11.2024,18,119,137,18,2466
891,8,11,25.11.2024,5,399,525,126,2625
284,28,5,05.11.2024,18,140,158,18,2844
677,28,1,05.11.2024,1,192,270,78,270
603,11,1,06.11.2024,9,45,62,17,558
539,4,24,03.11.2024,16,235,285,50,4560
608,4,15,17.11.2024,8,474,507,33,4056
803,30,28,22.11.2024,17,165,221,56,3757
32,2,16,28.11.2024,13,225,247,22,3211
730,30,15,03.11.2024,3,175,195,20,585
130,9,20,21.11.2024,19,283,339,56,6441
612,17,10,15.11.2024,17,311,340,29,5780
719,4,28,21.11.2024,18,366,420,54,7560
463,29,8,14.11.2024,11,417,513,96,5643
748,4,11,14.11.2024,11,339,413,74,4543
157,22,30,16.11.2024,3,64,69,5,207
443,4,24,24.11.2024,12,410,533,123,6396
601,18,18,11.11.2024,4,217,313,96,1252
964,25,14,28.11.2024,2,485,640,155,1280
361,4,19,17.11.2024,7,94,119,25,833
868,4,12,28.11.2024,18,196,274,78,4932
588,8,26,14.11.2024,18,488,692,204,12456
629,22,21,18.11.2024,1,312,420,108,420
711,9,1,06.11.2024,9,357,425,68,3825
348,12,1,06.11.2024,5,292,359,67,1795
146,24,21,01.11.2024,3,378,434,56,1302
430,15,11,06.11.2024,12,170,203,33,2436
965,19,20,03.11.2024,2,95,132,37,264
51,22,3,09.11.2024,15,338,428,90,6420
453,14,9,07.11.2024,17,75,93,18,1581
291,22,22,19.11.2024,16,273,324,51,5184
226,13,20,02.11.2024,1,118,174,56,174
786,5,25,09.11.2024,10,178,187,9,1870
765,14,6,05.11.2024,13,276,318,42,4134
573,27,22,26.11.2024,12,55,79,24,948
44,14,1,15.11.2024,3,434,568,134,1704
588,13,23,21.11.2024,14,159,196,37,2744
990,11,6,26.11.2024,20,241,328,87,6560
371,3,14,28.11.2024,4,137,180,43,720
537,3,13,28.11.2024,10,378,435,57,4350
798,6,3,17.11.2024,4,275,312,37,1248
795,12,12,24.11.2024,5,133,149,16,745
203,6,20,05.11.2024,3,105,147,42,441
506,15,25,19.11.2024,19,235,345,110,6555
579,21,21,20.11.2024,11,435,579,144,6369
155,15,3,16.11.2024,15,323,455,132,6825
606,2,12,17.11.2024,3,169,212,43,636
59,12,27,10.11.2024,3,329,491,162,1473
93,20,20,17.11.2024,13,242,315,73,4095
811,24,29,02.11.2024,15,456,597,141,8955
193,11,20,16.11.2024,17,92,100,8,1700
106,26,29,27.11.2024,11,492,535,43,5885
662,6,2,08.11.2024,15,496,637,141,9555
625,6,12,12.11.2024,10,206,288,82,2880
696,20,2,26.11.2024,11,52,56,4,616
695,13,10,09.11.2024,20,439,527,88,10540
597,22,5,30.11.2024,12,169,227,58,2724
679,13,5,20.11.2024,3,169,206,37,618
811,11,27,05.11.2024,17,65,88,23,1496
521,12,1,12.11.2024,10,107,122,15,1220
971,25,16,07.11.2024,8,500,560,60,4480
303,28,26,04.11.2024,17,390,556,166,9452
905,17,2,22.11.2024,11,441,585,144,6435
612,13,5,06.11.2024,6,419,585,166,3510
829,29,6,24.11.2024,15,41,50,9,750
737,8,15,20.11.2024,10,381,535,154,5350
240,18,8,10.11.2024,16,454,516,62,8256
695,19,15,15.11.2024,10,394,502,108,5020
429,6,27,07.11.2024,20,86,100,14,2000
657,16,28,12.11.2024,18,468,642,174,11556
529,28,4,10.11.2024,3,386,453,67,1359
928,17,5,27.11.2024,14,64,93,29,1302
837,15,29,12.11.2024,1,219,269,50,269
383,8,13,03.11.2024,12,128,152,24,1824
102,27,23,21.11.2024,11,400,445,45,4895
294,30,27,16.11.2024,5,384,485,101,2425
631,1,29,03.11.2024,1,143,204,61,204
562,24,20,17.11.2024,14,73,87,14,1218
309,4,2,08.11.2024,14,327,435,108,6090
65,4,27,29.11.2024,16,306,324,18,5184
528,19,8,23.11.2024,5,160,168,8,840
362,8,19,14.11.2024,6,339,369,30,2214
999,12,3,17.11.2024,18,264,394,130,7092
568,1,13,28.11.2024,16,41,50,9,800
383,9,24,01.11.2024,12,398,480,82,5760
751,22,21,04.11.2024,19,373,447,74,8493
46,12,18,11.11.2024,6,419,568,149,3408
713,16,21,06.11.2024,5,50,70,20,350
469,2,10,07.11.2024,2,400,579,179,1158
324,30,10,17.11.2024,13,495,640,145,8320
260,2,25,21.11.2024,7,157,226,69,1582
49,28,21,11.11.2024,9,80,97,17,873
911,13,24,15.11.2024,13,183,207,24,2691
709,16,12,30.11.2024,17,148,161,13,2737
435,3,14,20.11.2024,6,282,337,55,2022
82,11,22,10.11.2024,10,234,321,87,3210
171,23,15,12.11.2024,15,40,58,18,870
362,20,14,09.11.2024,2,56,75,19,150
373,17,26,24.11.2024,6,477,532,55,3192
623,22,26,15.11.2024,2,81,93,12,186
661,12,12,13.11.2024,19,36,40,4,760
461,12,12,15.11.2024,3,295,381,86,1143
408,11,21,09.11.2024,8,481,511,30,4088
191,16,17,13.11.2024,18,77,107,30,1926
721,15,7,20.11.2024,10,353,529,176,5290
205,4,5,28.11.2024,3,237,345,108,1035
456,3,26,22.11.2024,11,341,466,125,5126
564,18,10,29.11.2024,10,429,587,158,5870
950,23,21,06.11.2024,12,264,292,28,3504
206,26,5,08.11.2024,16,33,42,9,672
378,15,26,18.11.2024,5,314,342,28,1710
317,13,23,24.11.2024,16,272,380,108,6080
844,19,3,05.11.2024,11,328,411,83,4521
697,17,12,05.11.2024,18,327,370,43,6660
990,5,14,17.11.2024,2,419,538,119,1076
312,6,6,11.11.2024,8,186,274,88,2192
917,10,28,03.11.2024,9,114,169,55,1521
282,5,21,10.11.2024,20,276,352,76,7040
173,19,19,05.11.2024,6,336,462,126,2772
620,11,27,30.11.2024,19,40,57,17,1083
84,2,21,25.11.2024,19,147,168,21,3192
586,14,20,21.11.2024,1,259,345,86,345
297,21,10,16.11.2024,8,406,552,146,4416
305,15,3,23.11.2024,2,96,119,23,238
476,7,11,20.11.2024,5,170,234,64,1170
752,28,12,13.11.2024,5,385,494,109,2470
109,11,8,15.11.2024,4,148,172,24,688
100,2,10,13.11.2024,20,221,327,106,6540
924,6,27,11.11.2024,19,366,416,50,7904
164,16,17,15.11.2024,16,442,563,121,9008
93,13,17,15.11.2024,8,123,149,26,1192
52,10,16,20.11.2024,16,157,166,9,2656
111,14,5,29.11.2024,9,369,515,146,4635
375,2,13,02.11.2024,19,290,351,61,6669
296,3,13,17.11.2024,15,387,455,68,6825
639,22,20,04.11.2024,5,488,599,111,2995
814,11,18,12.11.2024,5,116,148,32,740
513,2,2,02.11.2024,5,363,512,149,2560
532,15,5,20.11.2024,17,87,128,41,2176
327,6,13,20.11.2024,10,305,390,85,3900
522,18,16,23.11.2024,19,164,232,68,4408
378,11,22,04.11.2024,14,300,423,123,5922
743,28,23,21.11.2024,1,307,358,51,358
672,26,25,19.11.2024,19,129,139,10,2641
492,6,17,21.11.2024,20,392,478,86,9560
842,22,8,02.11.2024,19,475,522,47,9918
20,15,11,14.11.2024,5,218,249,31,1245
514,25,20,30.11.2024,16,439,606,167,9696
64,23,5,17.11.2024,7,289,434,145,3038
490,17,13,11.11.2024,6,241,310,69,1860
560,12,22,25.11.2024,9,313,356,43,3204
253,9,18,10.11.2024,8,472,704,232,5632
790,10,23,07.11.2024,16,172,208,36,3328
957,30,26,24.11.2024,9,158,207,49,1863
557,13,29,13.11.2024,12,478,675,197,8100
298,2,10,23.11.2024,3,186,233,47,699
263,24,16,07.11.2024,7,417,489,72,3423
576,23,9,05.11.2024,4,316,415,99,1660
249,2,22,29.11.2024,17,128,148,20,2516
103,14,11,23.11.2024,16,68,95,27,1520
6,18,30,06.11.2024,14,333,482,149,6748
488,16,21,07.11.2024,10,174,233,59,2330
930,25,3,21.11.2024,19,131,182,51,3458
871,30,2,30.11.2024,6,221,315,94,1890
957,30,2,27.11.2024,13,398,452,54,5876
767,28,30,10.11.2024,2,24,32,8,64
110,30,11,10.11.2024,15,495,640,145,9600
506,29,5,28.11.2024,17,245,278,33,4726
116,11,6,24.11.2024,15,331,455,124,6825
15,24,11,26.11.2024,10,293,407,114,4070
180,20,28,21.11.2024,13,417,534,117,6942
89,13,22,04.11.2024,6,491,621,130,3726
959,8,1,09.11.2024,13,133,185,52,2405
977,11,10,19.11.2024,19,25,34,9,646
710,8,2,22.11.2024,4,243,273,30,1092
703,17,30,29.11.2024,10,351,470,119,4700
964,10,12,20.11.2024,8,125,139,14,1112
157,15,24,20.11.2024,12,220,285,65,3420
483,25,18,26.11.2024,7,386,523,137,3661
611,28,26,03.11.2024,17,234,320,86,5440
80,30,19,04.11.2024,2,418,608,190,1216
208,19,18,05.11.2024,6,178,228,50,1368
120,22,7,23.11.2024,19,255,370,115,7030
457,26,2,15.11.2024,5,266,334,68,1670
60,18,15,22.11.2024,10,367,451,84,4510
837,1,24,07.11.2024,19,55,68,13,1292
718,3,18,02.11.2024,3,493,623,130,1869
294,14,6,25.11.2024,5,388,578,190,2890
662,14,12,29.11.2024,13,235,344,109,4472
387,13,3,22.11.2024,18,84,120,36,2160
122,6,18,13.11.2024,17,81,121,40,2057
855,1,25,01.11.2024,10,242,333,91,3330
435,18,13,27.11.2024,8,139,167,28,1336
283,7,30,29.11.2024,4,35,48,13,192
630,25,30,29.11.2024,1,136,146,10,146
609,2,15,20.11.2024,2,137,147,10,294
450,8,18,07.11.2024,2,87,131,44,262
240,27,30,24.11.2024,19,173,228,55,4332
689,27,11,08.11.2024,10,441,658,217,6580
534,8,14,10.11.2024,9,49,73,24,657
901,24,30,06.11.2024,14,287,307,20,4298
353,21,22,13.11.2024,17,173,214,41,3638
153,10,13,06.11.2024,18,247,354,107,6372
308,28,23,05.11.2024,15,459,598,139,8970
992,14,18,17.11.2024,5,206,240,34,1200
339,21,3,30.11.2024,15,427,466,39,6990
742,27,7,02.11.2024,9,201,266,65,2394
41,28,3,07.11.2024,19,368,479,111,9101
491,7,28,30.11.2024,11,166,242,76,2662
217,30,7,24.11.2024,4,379,526,147,2104
937,8,23,20.11.2024,7,210,244,34,1708
330,25,10,13.11.2024,15,276,335,59,5025
268,12,17,29.11.2024,16,244,344,100,5504
740,16,25,27.11.2024,11,459,558,99,6138
424,2,19,28.11.2024,8,376,397,21,3176
567,30,19,19.11.2024,14,162,184,22,2576
236,13,19,27.11.2024,8,260,349,89,2792
702,11,9,25.11.2024,16,484,648,164,10368
503,15,6,24.11.2024,12,101,139,38,1668
501,6,30,29.11.2024,18,495,734,239,13212
537,2,27,28.11.2024,3,474,640,166,1920
783,1,14,05.11.2024,8,53,59,6,472
224,17,15,12.11.2024,2,317,427,110,854
632,30,16,22.11.2024,16,28,36,8,576
422,1,1,17.11.2024,9,277,327,50,2943
515,27,23,22.11.2024,14,407,594,187,8316
110,30,4,17.11.2024,5,136,180,44,900
259,27,12,09.11.2024,13,58,86,28,1118
471,19,8,23.11.2024,8,164,233,69,1864
83,21,28,21.11.2024,2,65,79,14,158
566,16,2,21.11.2024,1,357,389,32,389
866,14,21,26.11.2024,11,292,419,127,4609
98,29,17,30.11.2024,2,130,190,60,380
709,29,19,16.11.2024,9,42,46,4,414
948,9,29,18.11.2024,19,336,380,44,7220
871,11,1,07.11.2024,19,89,127,38,2413
841,13,30,03.11.2024,10,98,113,15,1130
855,28,13,22.11.2024,18,179,249,70,4482
144,26,23,24.11.2024,3,260,388,128,1164
55,4,14,08.11.2024,3,183,256,73,768
978,20,13,25.11.2024,11,34,40,6,440
462,16,8,12.11.2024,18,472,587,115,10566
697,19,22,13.11.2024,3,391,462,71,1386
253,23,3,03.11.2024,9,94,129,35,1161
650,5,24,13.11.2024,11,193,211,18,2321
966,10,15,12.11.2024,9,69,75,6,675
442,15,18,18.11.2024,17,216,229,13,3893
363,18,3,20.11.2024,20,397,570,173,11400
13,10,14,13.11.2024,3,368,479,111,1437
249,19,17,06.11.2024,13,101,119,18,1547
275,16,5,03.11.2024,6,229,283,54,1698
496,26,3,12.11.2024,9,473,650,177,5850
508,20,20,07.11.2024,15,71,85,14,1275
972,13,11,27.11.2024,20,202,291,89,5820
451,11,14,27.11.2024,20,85,102,17,2040
971,23,7,16.11.2024,11,105,129,24,1419
327,10,24,23.11.2024,16,485,679,194,10864
334,13,9,27.11.2024,13,195,287,92,3731
205,19,18,06.11.2024,18,33,45,12,810
966,23,7,15.11.2024,10,419,453,34,4530
869,26,26,14.11.2024,16,87,103,16,1648
259,22,5,23.11.2024,14,399,432,33,6048
613,16,19,13.11.2024,18,263,385,122,6930
709,14,18,02.11.2024,12,357,505,148,6060
609,21,30,03.11.2024,4,389,524,135,2096
364,6,21,20.11.2024,2,290,389,99,778
663,13,25,11.11.2024,14,71,78,7,1092
228,17,24,17.11.2024,18,299,391,92,7038
457,12,13,15.11.2024,19,351,393,42,7467
26,16,4,10.11.2024,14,462,503,41,7042
852,24,5,12.11.2024,10,185,259,74,2590
534,16,12,16.11.2024,4,230,314,84,1256
327,3,10,02.11.2024,4,31,37,6,148
112,22,26,06.11.2024,8,268,348,80,2784
339,18,14,15.11.2024,8,403,537,134,4296
191,21,22,14.11.2024,13,34,45,11,585
203,15,19,14.11.2024,13,22,25,3,325
286,25,23,26.11.2024,3,297,419,122,1257
550,6,12,11.11.2024,7,240,280,40,1960
884,16,17,21.11.2024,11,307,406,99,4466
602,4,12,12.11.2024,15,316,448,132,6720
723,26,10,30.11.2024,20,303,410,107,8200
321,4,8,10.11.2024,4,108,147,39,588
524,13,14,20.11.2024,5,296,367,71,1835
499,21,18,23.11.2024,6,286,364,78,2184
144,6,11,27.11.2024,15,317,457,140,6855
975,1,16,05.11.2024,7,411,610,199,4270
518,21,16,14.11.2024,16,220,313,93,5008
501,6,3,19.11.2024,1,402,462,60,462
34,9,8,18.11.2024,10,101,127,26,1270
761,25,25,16.11.2024,18,265,347,82,6246
275,25,18,27.11.2024,12,280,390,110,4680
779,24,15,18.11.2024,7,495,543,48,3801
850,21,25,08.11.2024,10,440,468,28,4680
270,12,28,27.11.2024,3,231,346,115,1038
795,26,8,07.11.2024,19,351,504,153,9576
625,21,14,06.11.2024,20,87,99,12,1980
212,26,2,19.11.2024,12,275,363,88,4356
173,11,23,10.11.2024,10,295,436,141,4360
527,29,22,27.11.2024,4,85,118,33,472
422,30,2,09.11.2024,5,357,396,39,1980
150,23,11,27.11.2024,8,386,522,136,4176
502,5,19,21.11.2024,9,321,392,71,3528
78,21,26,29.11.2024,3,213,296,83,888
712,30,29,12.11.2024,15,476,570,94,8550
3,28,25,28.11.2024,3,371,466,95,1398
681,23,12,28.11.2024,3,402,494,92,1482
992,14,27,07.11.2024,16,149,212,63,3392
346,18,19,05.11.2024,19,429,603,174,11457
916,22,25,02.11.2024,2,68,95,27,190
471,1,4,30.11.2024,6,232,243,11,1458
982,14,7,23.11.2024,5,443,526,83,2630
896,30,29,09.11.2024,3,334,389,55,1167
381,22,29,21.11.2024,6,45,60,15,360
744,23,25,08.11.2024,14,335,457,122,6398
2,7,16,03.11.2024,5,305,392,87,1960
456,1,1,23.11.2024,11,412,616,204,6776
433,23,5,16.11.2024,3,130,142,12,426
826,4,4,11.11.2024,12,443,492,49,5904
793,27,25,28.11.2024,5,328,444,116,2220
71,17,19,01.11.2024,20,332,414,82,8280
740,7,21,24.11.2024,5,462,613,151,3065
454,28,7,03.11.2024,4,87,96,9,384
748,13,12,14.11.2024,11,400,464,64,5104
661,3,8,18.11.2024,20,308,408,100,8160
798,23,1,28.11.2024,10,119,157,38,1570
194,24,13,10.11.2024,2,396,558,162,1116
246,16,13,04.11.2024,8,260,342,82,2736
541,29,1,12.11.2024,11,83,120,37,1320
583,14,12,18.11.2024,6,386,571,185,3426
789,3,1,19.11.2024,3,27,31,4,93
945,2,26,13.11.2024,17,158,216,58,3672
786,14,14,23.11.2024,13,60,77,17,1001
631,5,9,03.11.2024,10,58,85,27,850
998,26,5,18.11.2024,11,208,277,69,3047
855,21,22,21.11.2024,3,169,211,42,633
977,28,8,02.11.2024,8,61,76,15,608
465,20,20,02.11.2024,10,340,457,117,4570
180,4,1,23.11.2024,5,357,401,44,2005
976,12,17,17.11.2024,9,100,111,11,999
800,28,9,24.11.2024,4,390,415,25,1660
827,14,9,17.11.2024,3,146,218,72,654
643,3,16,15.11.2024,17,193,246,53,4182
581,6,12,06.11.2024,9,391,568,177,5112
691,24,4,08.11.2024,17,21,30,9,510
13,8,2,16.11.2024,12,204,228,24,2736
954,28,2,18.11.2024,14,128,148,20,2072
938,24,11,09.11.2024,3,294,325,31,975
690,29,2,06.11.2024,8,406,606,200,4848
977,13,3,29.11.2024,15,436,609,173,9135
319,11,3,18.11.2024,15,24,27,3,405
578,26,10,24.11.2024,20,136,166,30,3320
996,16,25,25.11.2024,7,372,482,110,3374
816,8,5,01.11.2024,14,31,41,10,574
652,27,23,29.11.2024,1,476,501,25,501
674,13,28,24.11.2024,10,70,90,20,900
244,14,16,02.11.2024,5,362,395,33,1975
944,8,29,28.11.2024,17,218,317,99,5389
470,24,3,19.11.2024,4,263,351,88,1404
404,3,19,19.11.2024,2,229,340,111,680
243,10,9,28.11.2024,11,465,570,105,6270
852,24,11,11.11.2024,15,151,163,12,2445
208,5,25,25.11.2024,19,72,79,7,1501
461,15,11,14.11.2024,4,277,411,134,1644
213,15,10,15.11.2024,9,429,468,39,4212
827,22,10,27.11.2024,20,39,56,17,1120
336,5,3,23.11.2024,8,485,596,111,4768
51,22,10,09.11.2024,6,35,43,8,258
464,18,24,18.11.2024,8,65,72,7,576
813,5,4,01.11.2024,2,419,625,206,1250
134,7,27,13.11.2024,12,349,514,165,6168
87,19,19,09.11.2024,3,30,33,3,99
925,21,15,26.11.2024,5,64,92,28,460
829,11,4,02.11.2024,15,44,65,21,975
444,27,24,13.11.2024,16,34,46,12,736
177,12,7,30.11.2024,6,152,190,38,1140
153,2,20,20.11.2024,20,138,163,25,3260
422,29,18,16.11.2024,2,62,76,14,152
430,7,21,29.11.2024,17,140,209,69,3553
557,26,1,13.11.2024,12,250,351,101,4212
353,30,19,17.11.2024,11,206,233,27,2563
327,20,8,01.11.2024,9,48,72,24,648
543,12,25,19.11.2024,8,488,534,46,4272
673,8,9,18.11.2024,2,387,571,184,1142
590,28,26,13.11.2024,12,469,702,233,8424
178,6,8,19.11.2024,11,407,555,148,6105
936,19,1,23.11.2024,12,475,619,144,7428
577,7,27,26.11.2024,16,280,316,36,5056
39,3,2,08.11.2024,20,125,161,36,3220
1,11,30,20.11.2024,7,407,490,83,3430
182,30,26,28.11.2024,11,49,54,5,594
722,30,5,25.11.2024,4,426,613,187,2452
984,3,12,23.11.2024,13,301,362,61,4706
331,5,6,24.11.2024,14,400,593,193,8302
665,11,6,23.11.2024,18,353,518,165,9324
806,12,8,22.11.2024,19,411,501,90,9519
752,23,10,05.11.2024,6,370,546,176,3276
972,19,13,28.11.2024,19,36,47,11,893
944,26,20,08.11.2024,19,70,89,19,1691
340,24,3,08.11.2024,12,492,553,61,6636
907,3,27,23.11.2024,11,234,274,40,3014
256,23,3,12.11.2024,9,398,547,149,4923
50,13,15,24.11.2024,14,485,703,218,9842
505,29,13,12.11.2024,18,200,285,85,5130
808,28,19,21.11.2024,8,98,106,8,848
867,2,10,01.11.2024,11,145,159,14,1749
351,6,29,13.11.2024,6,371,481,110,2886
920,3,11,20.11.2024,20,449,613,164,12260
442,21,6,20.11.2024,14,95,105,10,1470
211,7,14,23.11.2024,18,367,505,138,9090
272,22,10,10.11.2024,8,66,81,15,648
563,27,16,05.11.2024,2,193,240,47,480
302,27,22,21.11.2024,20,251,274,23,5480
212,6,21,10.11.2024,3,247,273,26,819
804,13,16,16.11.2024,9,64,83,19,747
190,12,29,13.11.2024,12,110,117,7,1404
451,15,9,08.11.2024,9,291,325,34,2925
714,22,4,03.11.2024,12,408,504,96,6048
775,19,8,18.11.2024,2,424,601,177,1202
429,18,22,28.11.2024,16,295,341,46,5456
307,3,13,29.11.2024,2,261,380,119,760
820,19,22,20.11.2024,5,78,108,30,540
178,6,7,26.11.2024,7,81,100,19,700
700,14,7,27.11.2024,5,420,490,70,2450
933,24,30,26.11.2024,3,62,80,18,240
566,11,28,09.11.2024,17,240,346,106,5882
806,23,20,19.11.2024,17,395,435,40,7395
154,5,19,19.11.2024,19,384,566,182,10754
948,4,19,25.11.2024,4,397,572,175,2288
902,12,29,14.11.2024,9,204,259,55,2331
624,16,2,06.11.2024,9,213,283,70,2547
698,23,13,02.11.2024,13,447,536,89,6968
244,2,24,16.11.2024,9,451,477,26,4293
838,26,10,10.11.2024,9,425,610,185,5490
702,4,28,08.11.2024,5,164,227,63,1135
793,27,11,09.11.2024,14,310,338,28,4732
453,7,30,27.11.2024,14,376,523,147,7322
889,12,27,02.11.2024,17,400,432,32,7344
727,17,13,05.11.2024,17,442,470,28,7990
198,29,27,07.11.2024,2,140,175,35,350
941,12,23,07.11.2024,9,197,248,51,2232
407,21,30,04.11.2024,1,136,173,37,173
457,6,28,16.11.2024,19,285,343,58,6517
858,29,9,24.11.2024,3,157,192,35,576
167,28,19,25.11.2024,7,431,579,148,4053
694,7,9,21.11.2024,14,266,383,117,5362
991,25,22,01.11.2024,16,458,614,156,9824
616,26,1,08.11.2024,9,312,460,148,4140
730,23,21,09.11.2024,14,450,645,195,9030
471,9,7,15.11.2024,10,345,490,145,4900
407,19,4,01.11.2024,17,500,742,242,12614
860,12,18,21.11.2024,20,312,370,58,7400
111,16,3,11.11.2024,9,327,471,144,4239
268,21,23,29.11.2024,10,110,142,32,1420
247,29,2,26.11.2024,20,214,255,41,5100
144,24,1,21.11.2024,16,499,582,83,9312
429,13,13,24.11.2024,2,300,449,149,898
836,7,11,24.11.2024,8,349,467,118,3736
488,30,22,12.11.2024,17,164,185,21,3145
674,29,18,06.11.2024,10,67,74,7,740
265,24,26,18.11.2024,6,475,690,215,4140
671,3,8,12.11.2024,8,377,448,71,3584
808,29,11,12.11.2024,9,301,379,78,3411
121,16,2,28.11.2024,19,299,397,98,7543
484,29,7,17.11.2024,4,436,533,97,2132
306,14,2,28.11.2024,5,86,98,12,490
420,19,29,30.11.2024,15,89,128,39,1920
185,25,3,16.11.2024,11,323,365,42,4015
650,2,1,15.11.2024,9,121,168,47,1512
591,25,6,16.11.2024,3,82,102,20,306
440,13,14,16.11.2024,13,22,29,7,377
749,12,1,29.11.2024,11,383,494,111,5434
19,22,1,21.11.2024,8,129,186,57,1488
320,5,4,13.11.2024,17,303,340,37,5780
844,2,10,10.11.2024,15,369,487,118,7305
346,14,29,22.11.2024,5,185,269,84,1345
368,25,7,06.11.2024,13,29,34,5,442
135,7,24,01.11.2024,19,262,290,28,5510
729,21,26,02.11.2024,13,441,514,73,6682
548,20,2,20.11.2024,2,338,454,116,908
21,2,23,04.11.2024,14,233,258,25,3612
259,16,23,05.11.2024,7,354,472,118,3304
309,14,22,04.11.2024,17,150,198,48,3366
141,14,27,29.11.2024,4,266,353,87,1412
290,4,26,04.11.2024,16,115,131,16,2096
270,27,17,07.11.2024,12,358,423,65,5076
41,18,16,30.11.2024,7,350,444,94,3108
241,1,1,22.11.2024,3,455,649,194,1947
686,16,5,03.11.2024,17,56,77,21,1309
927,9,21,08.11.2024,15,495,585,90,8775
476,2,4,27.11.2024,6,440,630,190,3780
369,26,22,11.11.2024,14,375,409,34,5726
777,29,2,01.11.2024,5,338,381,43,1905
367,29,15,20.11.2024,9,442,482,40,4338
835,11,6,04.11.2024,13,212,266,54,3458
856,13,23,28.11.2024,16,404,542,138,8672
817,6,4,05.11.2024,2,491,702,211,1404
107,14,30,19.11.2024,16,405,549,144,8784
186,20,13,25.11.2024,12,313,451,138,5412
902,27,24,29.11.2024,5,252,320,68,1600
909,14,15,02.11.2024,3,146,173,27,519
722,28,22,17.11.2024,19,367,423,56,8037
979,22,28,11.11.2024,17,271,370,99,6290
98,14,22,24.11.2024,8,251,339,88,2712
657,13,5,27.11.2024,18,448,594,146,10692
12,21,30,06.11.2024,17,427,613,186,10421
891,6,3,25.11.2024,16,174,208,34,3328
285,2,17,08.11.2024,18,329,405,76,7290
241,3,15,15.11.2024,19,235,337,102,6403
458,11,4,16.11.2024,1,69,86,17,86
571,18,1,27.11.2024,3,400,593,193,1779
653,10,29,17.11.2024,18,119,161,42,2898
974,11,12,27.11.2024,2,412,589,177,1178
340,18,25,20.11.2024,20,247,333,86,6660
734,15,4,04.11.2024,8,21,25,4,200
649,26,10,18.11.2024,17,199,219,20,3723
919,6,16,05.11.2024,14,71,95,24,1330
193,4,30,28.11.2024,13,123,175,52,2275
196,23,11,04.11.2024,14,42,57,15,798
689,19,4,25.11.2024,15,240,315,75,4725
517,5,16,01.11.2024,17,373,485,112,8245
444,27,19,16.11.2024,17,395,576,181,9792
709,19,6,24.11.2024,5,70,94,24,470
621,29,11,17.11.2024,13,221,293,72,3809
710,25,8,09.11.2024,13,483,717,234,9321
464,26,5,05.11.2024,14,309,448,139,6272
525,10,27,23.11.2024,18,433,594,161,10692
958,18,21,07.11.2024,7,121,165,44,1155
704,12,30,22.11.2024,5,491,659,168,3295
982,6,17,18.11.2024,11,361,503,142,5533
576,16,19,19.11.2024,14,344,499,155,6986
547,10,29,28.11.2024,14,408,524,116,7336
26,13,5,02.11.2024,2,116,161,45,322
165,10,22,09.11.2024,5,423,575,152,2875
303,7,25,18.11.2024,2,192,241,49,482
631,28,22,24.11.2024,18,435,602,167,10836
575,13,8,17.11.2024,10,353,378,25,3780
391,13,14,26.11.2024,11,484,519,35,5709
762,9,7,20.11.2024,15,418,611,193,9165
722,23,21,12.11.2024,19,282,373,91,7087
795,24,7,10.11.2024,15,105,143,38,2145
192,6,24,17.11.2024,4,201,250,49,1000
570,9,5,06.11.2024,19,426,448,22,8512
478,23,30,05.11.2024,2,94,112,18,224
53,25,30,21.11.2024,20,425,504,79,10080
809,19,18,12.11.2024,3,396,473,77,1419
226,6,17,03.11.2024,17,97,125,28,2125
414,3,12,08.11.2024,7,338,406,68,2842
301,7,25,20.11.2024,17,248,323,75,5491
771,21,1,04.11.2024,12,234,341,107,4092
629,30,20,08.11.2024,2,348,415,67,830
938,26,4,13.11.2024,9,279,329,50,2961
934,17,27,25.11.2024,12,267,341,74,4092
499,2,10,29.11.2024,7,174,189,15,1323
99,6,25,18.11.2024,18,24,25,1,450
687,21,25,07.11.2024,14,421,481,60,6734
849,23,29,24.11.2024,14,330,487,157,6818
765,22,5,01.11.2024,15,364,389,25,5835
76,2,6,26.11.2024,9,288,377,89,3393
234,30,9,14.11.2024,13,237,291,54,3783
324,1,13,22.11.2024,4,277,370,93,1480
634,3,25,24.11.2024,19,42,60,18,1140
367,30,17,04.11.2024,10,398,472,74,4720
89,10,25,30.11.2024,15,203,288,85,4320
32,16,6,18.11.2024,8,85,105,20,840
817,28,18,10.11.2024,5,163,236,73,1180
989,26,28,24.11.2024,12,480,506,26,6072
896,18,5,04.11.2024,2,22,30,8,60
551,18,3,10.11.2024,7,379,552,173,3864
353,7,14,29.11.2024,17,88,100,12,1700
632,27,9,07.11.2024,4,107,151,44,604
873,2,28,25.11.2024,18,241,313,72,5634
298,22,3,09.11.2024,4,115,150,35,600
975,11,12,05.11.2024,8,68,90,22,720
922,7,11,16.11.2024,15,178,239,61,3585
711,19,5,19.11.2024,19,195,232,37,4408
439,6,1,11.11.2024,8,397,544,147,4352
657,14,9,27.11.2024,12,84,117,33,1404
899,16,15,15.11.2024,12,392,497,105,5964
112,6,21,20.11.2024,3,424,609,185,1827
144,29,18,07.11.2024,9,372,496,124,4464
745,3,29,01.11.2024,17,323,458,135,7786
593,13,25,19.11.2024,7,455,591,136,4137
557,29,18,16.11.2024,5,196,225,29,1125
791,19,24,28.11.2024,10,84,107,23,1070
93,13,12,17.11.2024,1,338,484,146,484
826,20,22,06.11.2024,17,87,98,11,1666
580,19,22,28.11.2024,5,373,473,100,2365
368,2,8,25.11.2024,16,131,153,22,2448
240,2,22,07.11.2024,17,456,553,97,9401
481,30,15,29.11.2024,2,39,53,14,106
106,23,17,21.11.2024,9,421,492,71,4428
558,19,6,13.11.2024,13,195,263,68,3419
856,3,17,09.11.2024,13,487,560,73,7280
416,12,27,28.11.2024,12,254,321,67,3852
619,1,17,29.11.2024,5,231,267,36,1335
527,21,9,07.11.2024,5,110,133,23,665
735,27,4,22.11.2024,8,219,263,44,2104
117,16,22,16.11.2024,16,121,136,15,2176
854,14,1,08.11.2024,2,81,107,26,214
138,21,17,02.11.2024,19,91,102,11,1938
945,6,17,13.11.2024,20,485,649,164,12980
900,24,24,22.11.2024,10,475,545,70,5450
622,16,28,16.11.2024,6,125,155,30,930
147,26,19,27.11.2024,6,319,408,89,2448
172,24,22,11.11.2024,15,306,331,25,4965
388,13,5,04.11.2024,1,117,168,51,168
517,22,14,27.11.2024,5,311,351,40,1755
924,20,20,02.11.2024,18,262,289,27,5202
494,22,5,29.11.2024,20,279,293,14,5860
961,25,22,21.11.2024,14,271,329,58,4606
45,23,17,14.11.2024,8,470,596,126,4768
788,13,12,19.11.2024,19,67,74,7,1406
489,25,8,30.11.2024,3,156,225,69,675
419,9,7,01.11.2024,1,297,328,31,328
8,13,21,07.11.2024,11,216,237,21,2607
437,21,19,09.11.2024,9,430,534,104,4806
375,20,9,22.11.2024,13,382,473,91,6149
803,18,16,06.11.2024,12,288,366,78,4392
315,19,12,25.11.2024,13,373,535,162,6955
676,4,24,08.11.2024,15,396,585,189,8775
103,7,17,13.11.2024,11,404,536,132,5896
701,23,2,06.11.2024,13,483,508,25,6604
94,27,5,16.11.2024,20,229,247,18,4940
228,12,3,20.11.2024,2,368,540,172,1080
411,20,21,17.11.2024,10,362,477,115,4770
969,25,27,06.11.2024,16,231,263,32,4208
673,30,26,17.11.2024,10,113,159,46,1590
523,17,23,08.11.2024,20,101,108,7,2160
245,21,1,06.11.2024,3,498,698,200,2094
362,22,13,13.11.2024,19,116,123,7,2337
721,3,30,03.11.2024,18,157,223,66,4014
937,19,12,12.11.2024,9,129,191,62,1719
466,30,13,19.11.2024,1,145,179,34,179
110,18,3,17.11.2024,10,183,202,19,2020
526,9,29,18.11.2024,19,140,175,35,3325
387,19,16,25.11.2024,8,384,569,185,4552
470,22,15,29.11.2024,19,434,550,116,10450
265,3,13,21.11.2024,8,345,398,53,3184
324,14,12,17.11.2024,18,25,35,10,630
255,10,3,13.11.2024,11,56,83,27,913
488,11,12,07.11.2024,19,149,220,71,4180
700,30,30,07.11.2024,16,374,432,58,6912
248,28,9,07.11.2024,8,117,136,19,1088
634,12,5,25.11.2024,4,78,84,6,336
979,22,16,20.11.2024,1,387,500,113,500
44,28,16,12.11.2024,20,171,249,78,4980
903,29,19,28.11.2024,9,256,382,126,3438
938,17,9,13.11.2024,8,380,421,41,3368
539,26,14,16.11.2024,18,36,43,7,774
882,22,25,06.11.2024,15,489,667,178,10005
472,11,23,01.11.2024,1,344,419,75,419
104,11,12,20.11.2024,9,110,128,18,1152
276,16,20,11.11.2024,12,108,134,26,1608
430,23,25,12.11.2024,12,430,506,76,6072
185,19,5,19.11.2024,8,411,565,154,4520
824,8,18,14.11.2024,13,114,161,47,2093
757,5,16,26.11.2024,1,105,134,29,134
915,28,21,17.11.2024,18,366,513,147,9234
308,9,18,28.11.2024,19,43,47,4,893
168,2,7,27.11.2024,9,249,332,83,2988
461,24,11,09.11.2024,12,193,251,58,3012
830,9,12,01.11.2024,14,78,113,35,1582
987,20,7,19.11.2024,19,332,429,97,8151
800,10,12,11.11.2024,17,254,351,97,5967
911,3,13,20.11.2024,10,243,359,116,3590
890,6,21,26.11.2024,11,222,295,73,3245
415,28,30,03.11.2024,3,98,113,15,339
325,21,10,23.11.2024,9,311,381,70,3429
909,15,25,28.11.2024,12,379,487,108,5844
462,14,6,06.11.2024,1,80,92,12,92
258,24,23,24.11.2024,3,121,149,28,447
98,3,30,29.11.2024,16,283,301,18,4816
407,17,25,03.11.2024,4,146,163,17,652
671,30,29,13.11.2024,10,130,180,50,1800
454,21,5,05.11.2024,17,422,449,27,7633
680,12,28,30.11.2024,11,435,548,113,6028
892,18,30,09.11.2024,18,234,347,113,6246
715,18,6,19.11.2024,20,239,332,93,6640
899,19,14,17.11.2024,18,169,203,34,3654
553,8,26,03.11.2024,15,168,207,39,3105
160,10,1,01.11.2024,17,411,589,178,10013
353,10,16,18.11.2024,1,350,445,95,445
774,16,10,01.11.2024,14,403,531,128,7434
816,1,18,12.11.2024,7,218,283,65,1981
405,8,6,23.11.2024,13,418,480,62,6240
82,14,21,08.11.2024,17,387,565,178,9605
827,23,22,09.11.2024,10,331,427,96,4270
276,14,7,28.11.2024,3,108,127,19,381
653,15,20,15.11.2024,9,356,453,97,4077
329,1,5,02.11.2024,18,31,46,15,828
289,9,5,23.11.2024,15,369,426,57,6390
155,1,16,07.11.2024,11,222,311,89,3421
511,12,15,23.11.2024,2,179,255,76,510
975,5,2,09.11.2024,13,54,68,14,884
197,29,27,09.11.2024,13,418,461,43,5993
787,23,8,13.11.2024,15,139,208,69,3120
204,15,24,25.11.2024,4,270,403,133,1612
485,13,22,10.11.2024,11,96,132,36,1452
763,30,18,17.11.2024,4,142,189,47,756
204,12,29,02.11.2024,7,487,563,76,3941
445,11,1,06.11.2024,9,301,369,68,3321
249,1,2,19.11.2024,16,350,392,42,6272
790,3,8,06.11.2024,16,64,85,21,1360
954,25,21,02.11.2024,2,191,213,22,426
550,26,4,05.11.2024,16,132,196,64,3136
808,21,25,12.11.2024,15,372,394,22,5910
387,12,24,05.11.2024,9,451,573,122,5157
449,18,10,18.11.2024,16,111,126,15,2016
357,11,24,15.11.2024,9,436,576,140,5184
882,18,6,03.11.2024,17,94,112,18,1904
270,18,12,15.11.2024,1,392,501,109,501
752,6,29,01.11.2024,20,431,603,172,12060
245,11,24,03.11.2024,18,413,469,56,8442
700,16,25,18.11.2024,5,314,376,62,1880
657,11,4,04.11.2024,17,336,360,24,6120
961,5,6,28.11.2024,2,117,148,31,296
102,2,19,21.11.2024,13,336,432,96,5616
719,19,9,02.11.2024,12,126,173,47,2076
14,30,30,07.11.2024,16,466,663,197,10608
480,26,21,02.11.2024,12,288,424,136,5088
426,27,12,26.11.2024,2,415,486,71,972
42,24,3,27.11.2024,10,57,66,9,660
532,4,4,24.11.2024,8,275,312,37,2496
539,22,8,19.11.2024,6,288,375,87,2250
765,4,25,21.11.2024,19,192,241,49,4579
682,14,29,04.11.2024,6,400,519,119,3114
517,11,22,06.11.2024,18,499,624,125,11232
361,29,11,18.11.2024,11,426,526,100,5786
649,14,27,24.11.2024,11,312,407,95,4477
220,13,25,18.11.2024,9,193,242,49,2178
983,13,1,24.11.2024,2,492,648,156,1296
531,5,29,10.11.2024,1,164,189,25,189
877,11,1,25.11.2024,9,461,590,129,5310
585,30,19,05.11.2024,4,38,46,8,184
142,9,12,29.11.2024,19,140,163,23,3097
308,3,19,13.11.2024,19,461,636,175,12084
741,11,26,16.11.2024,6,254,370,116,2220
720,19,27,30.11.2024,4,306,362,56,1448
749,26,19,13.11.2024,3,394,578,184,1734
343,12,29,27.11.2024,14,220,317,97,4438
891,25,8,24.11.2024,20,466,622,156,12440
648,13,2,10.11.2024,17,40,51,11,867
154,11,17,23.11.2024,8,94,127,33,1016
403,15,25,20.11.2024,19,262,302,40,5738
297,26,13,05.11.2024,5,181,229,48,1145
764,2,18,13.11.2024,9,61,78,17,702
793,23,5,25.11.2024,5,251,286,35,1430
405,21,19,07.11.2024,18,316,436,120,7848
253,8,3,09.11.2024,14,175,257,82,3598
92,4,22,14.11.2024,14,195,222,27,3108
353,20,21,01.11.2024,10,101,122,21,1220
842,26,15,20.11.2024,5,231,339,108,1695
240,7,22,12.11.2024,5,384,550,166,2750
116,24,2,08.11.2024,20,465,670,205,13400
840,10,1,11.11.2024,4,166,210,44,840
340,7,24,18.11.2024,7,118,151,33,1057
265,18,16,20.11.2024,5,354,478,124,2390
386,19,29,22.11.2024,17,41,46,5,782
291,7,26,23.11.2024,20,150,189,39,3780
968,1,3,13.11.2024,9,338,494,156,4446
369,28,4,01.11.2024,10,436,586,150,5860
237,13,17,23.11.2024,4,454,576,122,2304
612,18,3,06.11.2024,7,260,327,67,2289
949,23,1,02.11.2024,8,463,549,86,4392
502,13,24,06.11.2024,1,186,225,39,225
641,10,8,17.11.2024,9,410,546,136,4914
900,13,29,27.11.2024,1,473,699,226,699
231,5,11,29.11.2024,13,335,365,30,4745
392,17,22,20.11.2024,8,220,288,68,2304
437,10,30,20.11.2024,11,236,261,25,2871
669,5,19,18.11.2024,7,434,516,82,3612
723,29,17,30.11.2024,5,226,330,104,1650
789,5,21,30.11.2024,19,460,549,89,10431
571,18,24,04.11.2024,6,172,249,77,1494
745,1,25,11.11.2024,14,481,571,90,7994
764,30,27,29.11.2024,9,93,105,12,945
135,6,1,25.11.2024,20,316,418,102,8360
628,8,20,08.11.2024,8,350,424,74,3392
705,25,16,05.11.2024,17,426,537,111,9129
666,12,6,28.11.2024,13,256,285,29,3705
198,8,2,14.11.2024,1,464,686,222,686
228,24,22,07.11.2024,7,52,76,24,532
450,28,20,16.11.2024,11,436,632,196,6952
438,13,25,02.11.2024,20,373,455,82,9100
321,13,20,24.11.2024,19,305,392,87,7448
897,23,26,02.11.2024,17,72,91,19,1547
899,2,29,08.11.2024,17,278,415,137,7055
41,18,13,17.11.2024,2,111,139,28,278
906,10,25,27.11.2024,10,241,299,58,2990
628,30,2,23.11.2024,17,454,571,117,9707
662,15,3,24.11.2024,17,74,104,30,1768
961,29,23,18.11.2024,5,209,249,40,1245
26,6,15,19.11.2024,7,444,484,40,3388
332,23,21,30.11.2024,6,365,403,38,2418
117,23,15,21.11.2024,12,61,83,22,996
745,26,17,20.11.2024,6,202,246,44,1476
787,6,30,11.11.2024,19,438,630,192,11970
167,28,5,06.11.2024,2,221,263,42,526
788,15,10,21.11.2024,6,76,85,9,510
208,1,20,25.11.2024,9,26,33,7,297
511,18,26,01.11.2024,20,444,513,69,10260
603,22,16,15.11.2024,14,232,307,75,4298
7,8,29,18.11.2024,9,317,413,96,3717
846,7,2,06.11.2024,5,46,56,10,280
149,28,2,22.11.2024,19,422,500,78,9500
943,3,2,04.11.2024,14,497,558,61,7812
292,20,22,23.11.2024,20,295,384,89,7680
990,15,24,19.11.2024,12,467,510,43,6120
307,11,12,29.11.2024,13,414,576,162,7488
864,18,3,10.11.2024,16,85,115,30,1840
282,11,17,14.11.2024,17,121,138,17,2346
60,4,19,24.11.2024,17,494,626,132,10642
706,20,30,26.11.2024,10,225,322,97,3220
266,17,19,20.11.2024,12,465,617,152,7404
509,17,24,21.11.2024,16,256,290,34,4640
625,8,23,10.11.2024,7,21,22,1,154
641,26,4,24.11.2024,7,404,606,202,4242
424,2,11,12.11.2024,18,407,466,59,8388
656,7,23,10.11.2024,9,399,475,76,4275
519,18,11,25.11.2024,1,75,90,15,90
406,24,19,20.11.2024,1,419,477,58,477
854,11,30,22.11.2024,16,460,648,188,10368
662,5,16,05.11.2024,15,448,579,131,8685
344,15,26,27.11.2024,14,465,500,35,7000
534,10,19,24.11.2024,11,286,303,17,3333
592,22,11,26.11.2024,12,52,58,6,696
861,1,11,13.11.2024,18,424,555,131,9990
399,6,20,04.11.2024,10,359,427,68,4270
33,9,14,03.11.2024,16,441,537,96,8592
850,10,7,17.11.2024,10,104,127,23,1270
39,25,7,30.11.2024,3,233,247,14,741
495,29,17,05.11.2024,7,183,232,49,1624
895,17,10,25.11.2024,11,89,128,39,1408
842,17,22,05.11.2024,7,368,462,94,3234
731,28,17,04.11.2024,1,169,181,12,181
869,20,28,03.11.2024,11,244,261,17,2871
534,25,22,24.11.2024,10,31,43,12,430
655,29,7,11.11.2024,7,112,132,20,924
327,25,15,22.11.2024,4,151,169,18,676
118,1,20,18.11.2024,17,69,89,20,1513
563,11,9,05.11.2024,10,296,333,37,3330
319,20,29,11.11.2024,18,233,258,25,4644
483,29,22,02.11.2024,4,204,222,18,888
402,6,23,20.11.2024,19,322,438,116,8322
457,20,12,10.11.2024,11,412,565,153,6215
687,26,18,03.11.2024,15,293,319,26,4785
822,30,23,15.11.2024,4,239,324,85,1296
728,25,15,16.11.2024,8,475,529,54,4232
918,20,9,30.11.2024,12,208,284,76,3408
682,11,26,28.11.2024,11,238,253,15,2783
487,4,12,16.11.2024,15,426,501,75,7515
357,20,19,05.11.2024,17,69,98,29,1666
816,4,11,18.11.2024,3,400,516,116,1548
411,19,14,08.11.2024,20,137,154,17,3080
494,13,3,11.11.2024,7,411,540,129,3780
804,14,19,26.11.2024,11,281,325,44,3575
679,22,3,24.11.2024,19,422,464,42,8816
611,15,11,18.11.2024,4,415,468,53,1872
979,13,3,20.11.2024,4,349,460,111,1840
840,13,11,16.11.2024,2,63,90,27,180
909,19,29,25.11.2024,1,383,517,134,517
464,18,10,13.11.2024,20,297,338,41,6760
698,29,11,10.11.2024,19,401,544,143,10336
941,30,14,23.11.2024,12,495,650,155,7800
627,17,13,28.11.2024,5,429,463,34,2315
923,18,2,01.11.2024,18,414,502,88,9036
882,10,28,01.11.2024,8,227,299,72,2392
641,11,23,13.11.2024,13,203,263,60,3419
679,6,16,05.11.2024,7,287,410,123,2870
369,27,14,05.11.2024,10,499,674,175,6740
138,1,3,21.11.2024,1,89,129,40,129
674,14,5,03.11.2024,5,328,406,78,2030
467,29,26,23.11.2024,20,467,621,154,12420
466,17,14,18.11.2024,15,205,236,31,3540
435,20,1,19.11.2024,16,426,493,67,7888
514,9,14,30.11.2024,18,297,316,19,5688
39,19,16,23.11.2024,12,74,94,20,1128
708,3,5,24.11.2024,17,492,735,243,12495
798,9,15,17.11.2024,3,271,359,88,1077
252,16,21,24.11.2024,3,348,450,102,1350
594,10,20,02.11.2024,11,277,292,15,3212
465,17,29,16.11.2024,19,372,461,89,8759
984,26,10,10.11.2024,6,37,54,17,324
768,10,24,26.11.2024,19,145,193,48,3667
593,6,19,02.11.2024,10,408,543,135,5430
294,16,3,05.11.2024,17,57,80,23,1360
259,5,20,09.11.2024,9,432,456,24,4104
115,20,6,30.11.2024,19,375,505,130,9595
379,26,6,09.11.2024,8,253,356,103,2848
883,2,11,03.11.2024,5,306,434,128,2170
858,16,25,14.11.2024,13,134,168,34,2184
653,6,7,19.11.2024,12,46,54,8,648
840,4,2,06.11.2024,15,211,251,40,3765
765,25,30,18.11.2024,8,202,277,75,2216
486,9,5,17.11.2024,14,26,38,12,532
460,13,22,11.11.2024,17,348,372,24,6324
940,18,21,12.11.2024,14,313,421,108,5894
280,11,9,09.11.2024,4,143,187,44,748
473,25,22,24.11.2024,8,372,490,118,3920
200,17,11,22.11.2024,6,170,180,10,1080
9,27,3,01.11.2024,14,67,73,6,1022
457,12,8,24.11.2024,10,141,150,9,1500
635,3,2,20.11.2024,7,476,637,161,4459
726,4,3,28.11.2024,20,82,111,29,2220
922,21,19,26.11.2024,6,450,613,163,3678
260,10,15,22.11.2024,3,327,479,152,1437
284,25,14,23.11.2024,11,144,201,57,2211
284,25,2,13.11.2024,13,180,194,14,2522
979,27,9,06.11.2024,15,53,79,26,1185
206,20,13,06.11.2024,16,72,93,21,1488
442,7,20,21.11.2024,4,458,628,170,2512
106,2,3,03.11.2024,19,369,517,148,9823
20,29,16,05.11.2024,1,468,631,163,631
273,5,23,11.11.2024,13,296,379,83,4927
963,25,16,16.11.2024,14,214,295,81,4130
832,26,3,18.11.2024,8,22,32,10,256
838,25,16,04.11.2024,19,277,414,137,7866
342,22,10,13.11.2024,2,323,479,156,958
93,12,18,28.11.2024,11,59,74,15,814
785,10,21,07.11.2024,6,286,425,139,2550
677,7,10,23.11.2024,13,450,601,151,7813
368,16,3,29.11.2024,15,373,415,42,6225
198,1,24,19.11.2024,8,255,275,20,2200
554,21,10,16.11.2024,18,483,684,201,12312
990,1,2,11.11.2024,2,182,250,68,500
416,4,7,26.11.2024,17,240,325,85,5525
896,18,5,24.11.2024,19,132,143,11,2717
754,5,16,21.11.2024,1,246,360,114,360
47,8,23,21.11.2024,5,27,36,9,180
927,10,27,26.11.2024,4,239,269,30,1076
606,3,27,27.11.2024,4,75,99,24,396
631,8,3,26.11.2024,7,225,318,93,2226
756,22,13,11.11.2024,4,488,639,151,2556
141,11,27,26.11.2024,7,387,509,122,3563
344,3,4,09.11.2024,5,384,432,48,2160
379,18,6,15.11.2024,8,464,496,32,3968
103,26,28,21.11.2024,20,201,225,24,4500
901,16,3,01.11.2024,1,106,116,10,116
668,19,29,10.11.2024,14,353,496,143,6944
488,23,5,07.11.2024,5,327,420,93,2100
422,8,6,20.11.2024,2,306,420,114,840
627,3,21,27.11.2024,10,187,197,10,1970
242,7,4,17.11.2024,4,317,456,139,1824
553,17,8,15.11.2024,7,153,174,21,1218
816,5,22,28.11.2024,16,259,290,31,4640
945,2,2,21.11.2024,12,157,195,38,2340
343,20,26,29.11.2024,15,41,56,15,840
948,18,6,06.11.2024,1,253,279,26,279
917,8,24,15.11.2024,19,298,369,71,7011
766,22,29,11.11.2024,8,394,471,77,3768
101,8,24,14.11.2024,7,200,230,30,1610
483,19,16,02.11.2024,14,90,131,41,1834
466,6,13,12.11.2024,5,240,273,33,1365
368,9,7,11.11.2024,5,35,46,11,230
288,5,4,28.11.2024,15,240,271,31,4065
352,8,29,10.11.2024,20,95,134,39,2680
976,20,29,06.11.2024,19,486,697,211,13243
89,14,28,17.11.2024,16,434,498,64,7968
485,27,15,09.11.2024,1,370,512,142,512
253,8,11,14.11.2024,19,127,186,59,3534
969,5,30,19.11.2024,1,221,236,15,236
482,24,25,17.11.2024,2,224,275,51,550
830,26,23,27.11.2024,4,237,275,38,1100
572,25,1,23.11.2024,14,476,528,52,7392
303,8,21,03.11.2024,1,250,297,47,297
721,15,28,19.11.2024,19,32,40,8,760
791,5,28,23.11.2024,13,109,157,48,2041
642,15,23,21.11.2024,1,433,468,35,468
915,23,11,17.11.2024,2,162,225,63,450
715,20,18,19.11.2024,7,398,433,35,3031
902,11,24,30.11.2024,2,267,390,123,780
373,29,2,04.11.2024,13,195,260,65,3380
375,12,6,21.11.2024,18,358,467,109,8406
793,7,5,11.11.2024,8,279,374,95,2992
756,25,19,28.11.2024,7,382,531,149,3717
329,12,29,09.11.2024,17,347,407,60,6919
65,12,12,15.11.2024,16,261,371,110,5936
482,23,18,22.11.2024,18,452,566,114,10188
377,26,22,23.11.2024,3,110,160,50,480
90,3,13,29.11.2024,6,158,235,77,1410
112,6,9,04.11.2024,5,258,373,115,1865
534,21,1,10.11.2024,14,485,628,143,8792
136,16,12,14.11.2024,15,374,396,22,5940
194,3,1,28.11.2024,8,421,540,119,4320
344,14,19,11.11.2024,11,253,342,89,3762
543,27,18,15.11.2024,15,166,184,18,2760
809,10,6,26.11.2024,9,129,157,28,1413
296,25,28,02.11.2024,5,190,238,48,1190
171,20,30,06.11.2024,18,157,233,76,4194
860,23,23,29.11.2024,5,97,107,10,535
325,19,5,15.11.2024,9,197,226,29,2034
725,2,22,11.11.2024,12,91,114,23,1368
999,6,18,10.11.2024,4,462,569,107,2276
512,25,5,15.11.2024,11,95,141,46,1551
560,17,11,21.11.2024,10,247,292,45,2920
967,25,19,22.11.2024,5,404,556,152,2780
945,15,11,23.11.2024,4,371,540,169,2160
143,22,18,04.11.2024,10,32,42,10,420
226,15,12,03.11.2024,11,46,62,16,682
598,17,8,26.11.2024,9,114,124,10,1116
870,15,22,22.11.2024,3,488,600,112,1800
503,11,20,20.11.2024,17,473,690,217,11730
370,13,5,23.11.2024,14,197,240,43,3360
292,12,12,10.11.2024,15,440,479,39,7185
746,29,15,24.11.2024,14,406,479,73,6706
826,24,29,14.11.2024,14,87,114,27,1596
89,5,7,10.11.2024,16,494,636,142,10176
344,3,30,19.11.2024,13,62,77,15,1001
937,9,14,06.11.2024,18,242,316,74,5688
937,5,7,06.11.2024,13,159,202,43,2626
843,27,10,27.11.2024,19,166,216,50,4104
475,8,1,26.11.2024,1,94,111,17,111
656,27,21,16.11.2024,4,334,485,151,1940
428,6,16,30.11.2024,8,34,47,13,376
505,3,20,24.11.2024,12,299,390,91,4680
890,9,21,22.11.2024,16,488,692,204,11072
383,17,24,19.11.2024,1,426,478,52,478
60,5,11,15.11.2024,5,192,206,14,1030
370,14,21,30.11.2024,12,43,51,8,612
655,30,3,17.11.2024,7,388,439,51,3073
97,20,25,06.11.2024,18,175,208,33,3744
866,22,26,10.11.2024,9,349,475,126,4275
99,18,19,12.11.2024,5,26,34,8,170
382,25,16,14.11.2024,11,462,519,57,5709
224,5,17,08.11.2024,7,402,523,121,3661
707,27,17,28.11.2024,18,362,495,133,8910
822,4,14,15.11.2024,3,76,84,8,252
18,16,12,10.11.2024,12,87,108,21,1296
612,17,25,11.11.2024,6,361,383,22,2298
835,4,8,05.11.2024,5,350,416,66,2080
215,5,3,14.11.2024,4,57,80,23,320
776,14,2,07.11.2024,4,36,48,12,192
608,2,16,04.11.2024,9,41,48,7,432
11,25,4,26.11.2024,4,462,527,65,2108
923,7,6,22.11.2024,12,34,38,4,456
765,9,19,12.11.2024,12,97,124,27,1488
747,20,8,17.11.2024,19,53,75,22,1425
782,1,17,07.11.2024,7,483,544,61,3808
773,18,1,24.11.2024,4,464,679,215,2716
872,23,16,12.11.2024,19,109,147,38,2793
110,6,27,12.11.2024,13,224,286,62,3718
418,4,25,11.11.2024,4,244,313,69,1252
508,25,12,23.11.2024,10,287,307,20,3070
336,16,4,13.11.2024,10,239,331,92,3310
704,27,15,08.11.2024,18,216,322,106,5796
439,7,28,03.11.2024,16,471,572,101,9152
14,22,16,22.11.2024,4,210,270,60,1080
693,3,4,05.11.2024,13,212,279,67,3627
105,24,30,29.11.2024,6,51,76,25,456
347,7,20,28.11.2024,13,79,113,34,1469
743,16,9,25.11.2024,19,305,424,119,8056
821,21,13,12.11.2024,16,340,502,162,8032
497,17,9,05.11.2024,15,72,84,12,1260
510,8,21,05.11.2024,1,68,73,5,73
70,16,22,01.11.2024,6,204,276,72,1656
157,10,20,20.11.2024,4,385,519,134,2076
533,25,16,26.11.2024,15,117,158,41,2370
503,17,9,18.11.2024,11,409,528,119,5808
19,25,2,14.11.2024,4,204,243,39,972
386,15,15,02.11.2024,2,105,141,36,282
799,10,29,23.11.2024,6,256,284,28,1704
733,13,16,25.11.2024,4,293,372,79,1488
568,22,18,19.11.2024,16,248,356,108,5696
519,2,13,09.11.2024,16,304,371,67,5936
693,12,25,10.11.2024,11,49,65,16,715
132,27,12,12.11.2024,19,33,48,15,912
350,13,4,14.11.2024,12,496,613,117,7356
58,22,8,08.11.2024,8,331,436,105,3488
933,23,3,28.11.2024,10,75,84,9,840
552,11,2,15.11.2024,14,293,426,133,5964
274,1,23,16.11.2024,19,31,37,6,703
585,13,11,19.11.2024,4,408,447,39,1788
692,7,11,16.11.2024,17,410,553,143,9401
171,20,10,12.11.2024,14,117,156,39,2184
998,26,3,27.11.2024,18,123,144,21,2592
305,19,13,26.11.2024,8,320,474,154,3792
735,28,19,04.11.2024,19,182,196,14,3724
821,17,16,14.11.2024,7,187,202,15,1414
844,10,17,26.11.2024,10,228,295,67,2950
205,14,13,09.11.2024,20,267,362,95,7240
561,6,29,01.11.2024,17,434,568,134,9656
219,22,27,24.11.2024,15,149,199,50,2985
829,20,28,25.11.2024,14,469,645,176,9030
62,17,7,12.11.2024,15,91,102,11,1530
702,25,10,28.11.2024,14,217,312,95,4368
934,3,21,07.11.2024,14,148,175,27,2450
165,9,22,20.11.2024,8,215,237,22,1896
197,1,8,26.11.2024,10,243,316,73,3160
447,14,21,29.11.2024,2,117,137,20,274
30,9,26,26.11.2024,9,336,380,44,3420
873,2,24,16.11.2024,1,47,68,21,68
322,20,10,28.11.2024,3,452,558,106,1674
373,22,22,29.11.2024,3,211,301,90,903
863,5,8,04.11.2024,19,373,548,175,10412
535,22,27,19.11.2024,17,141,204,63,3468
244,20,4,25.11.2024,11,178,234,56,2574
400,26,24,24.11.2024,8,469,539,70,4312
110,6,7,09.11.2024,15,216,311,95,4665
58,16,18,12.11.2024,4,172,213,41,852
700,8,9,29.11.2024,5,194,267,73,1335
842,10,1,21.11.2024,20,37,51,14,1020
819,2,23,30.11.2024,8,141,173,32,1384
655,23,12,29.11.2024,4,277,320,43,1280
454,13,1,30.11.2024,13,465,681,216,8853
309,3,30,27.11.2024,8,163,234,71,1872
165,30,15,21.11.2024,11,442,617,175,6787
417,26,2,09.11.2024,3,415,612,197,1836
483,24,14,30.11.2024,11,364,526,162,5786
840,4,27,06.11.2024,9,263,318,55,2862
617,24,27,18.11.2024,11,238,252,14,2772
54,21,21,06.11.2024,15,400,444,44,6660
411,7,21,10.11.2024,11,296,326,30,3586
256,17,23,25.11.2024,5,427,579,152,2895
812,11,15,16.11.2024,5,145,197,52,985
847,11,26,10.11.2024,7,61,74,13,518
403,29,13,27.11.2024,19,128,189,61,3591
946,18,21,20.11.2024,8,455,678,223,5424
204,9,23,28.11.2024,6,44,58,14,348
615,9,5,03.11.2024,12,102,133,31,1596
15,23,17,14.11.2024,15,417,531,114,7965
230,23,7,07.11.2024,9,158,201,43,1809
134,14,28,07.11.2024,20,123,175,52,3500
745,22,7,14.11.2024,6,216,241,25,1446
298,9,8,20.11.2024,15,456,554,98,8310
701,21,15,03.11.2024,1,245,353,108,353
998,23,13,22.11.2024,7,362,496,134,3472
754,20,9,03.11.2024,4,287,308,21,1232
954,8,16,30.11.2024,12,498,734,236,8808
991,26,20,23.11.2024,2,23,29,6,58
391,10,13,22.11.2024,12,83,121,38,1452
43,19,6,09.11.2024,6,262,384,122,2304
899,15,5,03.11.2024,11,361,449,88,4939
267,4,11,02.11.2024,5,260,386,126,1930
288,24,12,30.11.2024,14,156,225,69,3150
628,27,25,30.11.2024,9,268,334,66,3006
169,11,24,16.11.2024,5,287,420,133,2100
652,26,15,02.11.2024,7,91,105,14,735
37,16,9,06.11.2024,15,229,344,115,5160
950,16,2,15.11.2024,12,495,644,149,7728
469,16,4,28.11.2024,5,79,87,8,435
890,10,6,27.11.2024,6,380,540,160,3240
577,29,22,19.11.2024,7,300,446,146,3122
539,25,19,06.11.2024,14,462,536,74,7504
511,22,4,29.11.2024,11,32,44,12,484
697,4,13,12.11.2024,19,466,512,46,9728
332,5,1,03.11.2024,15,419,564,145,8460
465,21,9,20.11.2024,1,178,191,13,191
638,15,11,24.11.2024,19,82,118,36,2242
821,21,10,11.11.2024,2,377,489,112,978
617,13,3,13.11.2024,9,105,157,52,1413
887,13,3,01.11.2024,7,98,138,40,966
292,21,25,21.11.2024,5,78,99,21,495
443,24,26,30.11.2024,10,454,600,146,6000
368,22,4,27.11.2024,12,266,338,72,4056
907,13,16,09.11.2024,19,308,336,28,6384
433,26,12,20.11.2024,6,228,284,56,1704
42,17,11,15.11.2024,8,331,454,123,3632
954,16,17,21.11.2024,17,60,76,16,1292
82,30,26,16.11.2024,10,91,101,10,1010
925,10,27,08.11.2024,17,225,294,69,4998
565,3,30,02.11.2024,17,72,89,17,1513
97,15,22,24.11.2024,19,410,496,86,9424
600,3,25,17.11.2024,1,75,101,26,101
184,26,6,27.11.2024,13,42,52,10,676
722,10,11,19.11.2024,15,384,480,96,7200
828,9,11,30.11.2024,6,121,132,11,792
619,9,28,22.11.2024,4,228,241,13,964
405,4,1,06.11.2024,16,241,297,56,4752
674,24,20,24.11.2024,16,165,234,69,3744
632,12,23,22.11.2024,13,406,443,37,5759
139,1,7,04.11.2024,1,354,402,48,402
28,7,16,21.11.2024,5,332,414,82,2070
642,28,26,18.11.2024,7,61,86,25,602
152,16,14,01.11.2024,4,100,112,12,448
720,15,16,16.11.2024,1,433,568,135,568
207,10,19,27.11.2024,13,44,47,3,611
646,28,23,14.11.2024,14,427,590,163,8260
611,24,18,10.11.2024,2,254,322,68,644
606,24,20,30.11.2024,16,131,141,10,2256
20,14,19,11.11.2024,18,50,73,23,1314
428,29,16,04.11.2024,16,319,428,109,6848
460,23,14,01.11.2024,6,158,180,22,1080
353,15,8,17.11.2024,8,302,410,108,3280
944,20,28,27.11.2024,15,83,98,15,1470
729,13,14,27.11.2024,12,402,567,165,6804
865,6,20,07.11.2024,10,352,383,31,3830
495,5,6,07.11.2024,6,311,340,29,2040
426,16,10,08.11.2024,7,287,431,144,3017
368,29,9,12.11.2024,6,104,149,45,894
516,2,26,03.11.2024,11,227,301,74,3311
124,18,8,16.11.2024,9,497,697,200,6273
788,2,25,29.11.2024,18,148,166,18,2988
707,28,17,20.11.2024,4,359,527,168,2108
449,26,15,27.11.2024,4,488,684,196,2736
625,26,28,04.11.2024,18,40,44,4,792
646,4,28,07.11.2024,12,95,113,18,1356
453,25,17,16.11.2024,4,94,114,20,456
839,5,4,28.11.2024,7,231,285,54,1995
788,1,8,27.11.2024,16,184,235,51,3760
88,9,12,23.11.2024,14,193,261,68,3654
156,25,25,17.11.2024,14,398,442,44,6188
440,14,30,14.11.2024,15,477,611,134,9165
699,12,1,15.11.2024,5,390,535,145,2675
530,3,3,11.11.2024,11,213,297,84,3267
445,2,13,25.11.2024,2,337,451,114,902
925,19,2,21.11.2024,17,487,603,116,10251
908,22,23,18.11.2024,10,366,436,70,4360
353,1,27,09.11.2024,17,313,349,36,5933
414,15,21,07.11.2024,18,320,425,105,7650
453,23,12,29.11.2024,13,392,567,175,7371
87,2,18,11.11.2024,13,368,509,141,6617
130,17,18,10.11.2024,7,65,84,19,588
534,11,25,21.11.2024,6,31,45,14,270
553,19,9,08.11.2024,10,369,551,182,5510
114,24,2,27.11.2024,12,145,185,40,2220
127,2,25,21.11.2024,4,235,308,73,1232
6,15,11,08.11.2024,19,291,423,132,8037
643,22,18,28.11.2024,20,132,157,25,3140
683,26,27,23.11.2024,19,343,470,127,8930
533,24,8,04.11.2024,11,268,305,37,3355
798,12,15,04.11.2024,5,362,514,152,2570
84,3,2,14.11.2024,5,249,311,62,1555
379,22,17,13.11.2024,19,288,404,116,7676
893,9,19,16.11.2024,14,498,678,180,9492
971,16,24,14.11.2024,6,89,99,10,594
729,15,5,23.11.2024,17,434,479,45,8143
218,15,16,02.11.2024,6,473,575,102,3450
975,4,20,28.11.2024,14,73,89,16,1246
297,2,17,05.11.2024,4,198,297,99,1188
311,10,16,01.11.2024,5,88,116,28,580
50,30,29,10.11.2024,10,123,175,52,1750
501,1,4,18.11.2024,12,52,56,4,672
493,19,10,19.11.2024,15,452,634,182,9510
487,27,24,27.11.2024,20,84,93,9,1860
652,15,25,15.11.2024,15,92,126,34,1890
92,26,20,22.11.2024,20,217,250,33,5000
405,11,18,02.11.2024,15,373,500,127,7500
887,6,23,01.11.2024,19,322,451,129,8569
317,18,21,04.11.2024,18,61,90,29,1620
555,19,25,02.11.2024,19,270,375,105,7125
515,29,1,04.11.2024,18,106,113,7,2034
806,7,8,27.11.2024,19,233,330,97,6270
622,11,13,19.11.2024,2,256,376,120,752
349,14,6,14.11.2024,1,433,516,83,516
264,3,4,04.11.2024,18,101,112,11,2016
262,25,3,05.11.2024,10,477,647,170,6470
61,20,11,06.11.2024,1,362,429,67,429
102,11,5,14.11.2024,11,144,212,68,2332
922,4,2,07.11.2024,8,381,501,120,4008
505,17,25,17.11.2024,13,476,557,81,7241
326,15,18,14.11.2024,3,252,311,59,933
240,30,29,01.11.2024,9,286,376,90,3384
104,8,25,18.11.2024,5,166,205,39,1025
86,28,21,17.11.2024,7,396,441,45,3087
554,6,26,08.11.2024,18,477,708,231,12744
569,15,2,01.11.2024,15,481,640,159,9600
669,6,1,02.11.2024,16,151,176,25,2816
697,13,12,27.11.2024,7,301,385,84,2695
47,6,24,18.11.2024,19,54,58,4,1102
716,4,27,05.11.2024,18,499,722,223,12996
216,20,17,26.11.2024,11,444,656,212,7216
651,9,25,23.11.2024,15,151,204,53,3060
330,11,7,15.11.2024,20,178,260,82,5200
137,21,30,01.11.2024,20,249,362,113,7240
689,6,14,18.11.2024,16,386,499,113,7984
807,29,21,21.11.2024,3,279,404,125,1212
836,22,15,22.11.2024,4,189,268,79,1072
848,20,12,13.11.2024,6,423,598,175,3588
9,4,15,12.11.2024,7,233,268,35,1876
21,25,9,22.11.2024,12,112,159,47,1908
641,10,26,23.11.2024,8,132,168,36,1344
372,2,9,16.11.2024,20,120,137,17,2740
841,21,13,04.11.2024,9,293,373,80,3357
566,7,22,24.11.2024,19,343,453,110,8607
180,3,19,05.11.2024,3,81,119,38,357
877,8,29,17.11.2024,9,112,152,40,1368
994,23,22,18.11.2024,20,141,184,43,3680
465,1,14,21.11.2024,2,430,514,84,1028
865,14,9,04.11.2024,17,244,296,52,5032
778,2,29,24.11.2024,8,43,62,19,496
546,15,11,01.11.2024,13,113,123,10,1599
586,26,1,24.11.2024,8,489,607,118,4856
77,30,8,07.11.2024,6,178,192,14,1152
641,4,1,16.11.2024,14,408,537,129,7518
642,30,11,27.11.2024,9,139,175,36,1575
982,11,27,02.11.2024,11,269,312,43,3432
75,25,20,20.11.2024,15,387,515,128,7725
593,4,3,02.11.2024,2,201,292,91,584
711,3,26,05.11.2024,2,461,576,115,1152
309,20,21,14.11.2024,3,69,74,5,222
54,10,28,13.11.2024,13,66,92,26,1196
239,28,20,26.11.2024,20,25,31,6,620
815,14,29,20.11.2024,20,69,92,23,1840
692,26,1,15.11.2024,17,178,202,24,3434
106,1,20,23.11.2024,3,305,435,130,1305
927,19,5,21.11.2024,17,143,177,34,3009
743,20,15,06.11.2024,8,86,92,6,736
131,10,19,14.11.2024,17,481,668,187,11356
319,19,29,18.11.2024,5,91,108,17,540
352,10,12,01.11.2024,17,301,409,108,6953
59,8,17,27.11.2024,18,432,536,104,9648
201,7,21,30.11.2024,7,397,478,81,3346
684,16,23,23.11.2024,15,308,369,61,5535
593,19,11,20.11.2024,10,221,248,27,2480
466,29,26,30.11.2024,2,258,378,120,756
655,8,23,08.11.2024,15,319,370,51,5550
753,25,27,11.11.2024,13,119,134,15,1742
7,12,1,03.11.2024,12,34,38,4,456
298,15,7,21.11.2024,19,458,555,97,10545
999,1,7,07.11.2024,10,104,150,46,1500
737,6,11,28.11.2024,18,138,157,19,2826
181,27,9,30.11.2024,4,30,41,11,164
389,21,26,29.11.2024,4,182,209,27,836
468,8,12,26.11.2024,12,337,497,160,5964
819,20,29,14.11.2024,3,77,111,34,333
134,26,7,07.11.2024,18,202,246,44,4428
614,14,21,08.11.2024,2,386,508,122,1016
875,18,10,26.11.2024,5,177,190,13,950
815,9,28,05.11.2024,17,485,702,217,11934
215,24,3,26.11.2024,16,400,530,130,8480
172,17,13,25.11.2024,17,200,256,56,4352
184,11,23,12.11.2024,17,353,485,132,8245
507,16,9,19.11.2024,13,326,459,133,5967
666,2,7,08.11.2024,7,237,274,37,1918
224,10,14,29.11.2024,13,294,433,139,5629
384,9,18,03.11.2024,5,381,450,69,2250
532,12,8,19.11.2024,2,243,324,81,648
437,15,15,14.11.2024,14,196,250,54,3500
280,13,1,06.11.2024,15,132,177,45,2655
368,29,3,10.11.2024,17,266,357,91,6069
805,9,30,08.11.2024,4,77,93,16,372
560,7,11,07.11.2024,11,140,194,54,2134
787,22,28,09.11.2024,7,359,538,179,3766
876,25,23,24.11.2024,18,458,483,25,8694
307,10,27,12.11.2024,13,474,673,199,8749
776,21,1,16.11.2024,17,495,731,236,12427
887,13,8,08.11.2024,7,248,318,70,2226
805,18,25,15.11.2024,15,184,200,16,3000
867,7,14,25.11.2024,14,121,151,30,2114
572,1,12,05.11.2024,19,439,522,83,9918
756,1,16,26.11.2024,12,183,227,44,2724
703,25,13,25.11.2024,18,164,215,51,3870
582,26,2,30.11.2024,5,94,139,45,695
339,19,21,26.11.2024,20,459,600,141,12000
401,13,7,13.11.2024,3,277,314,37,942
112,11,19,15.11.2024,10,65,71,6,710
567,6,2,27.11.2024,20,255,289,34,5780
72,30,13,10.11.2024,7,132,178,46,1246
72,15,2,12.11.2024,17,25,30,5,510
932,14,13,06.11.2024,4,82,102,20,408
761,3,13,29.11.2024,7,82,94,12,658
443,27,23,22.11.2024,16,96,126,30,2016
318,19,7,17.11.2024,15,152,160,8,2400
147,15,3,27.11.2024,13,310,360,50,4680
337,30,19,29.11.2024,16,241,315,74,5040
755,3,10,21.11.2024,15,186,266,80,3990
812,10,13,20.11.2024,6,219,248,29,1488
633,24,14,15.11.2024,13,457,518,61,6734
583,4,13,23.11.2024,2,135,195,60,390
281,29,21,18.11.2024,10,340,367,27,3670
744,24,29,07.11.2024,16,217,303,86,4848
125,12,3,25.11.2024,4,262,367,105,1468
420,15,6,09.11.2024,7,263,331,68,2317
75,21,23,22.11.2024,15,203,281,78,4215
877,7,13,02.11.2024,1,140,192,52,192
140,11,22,24.11.2024,15,253,273,20,4095
562,22,8,23.11.2024,15,87,124,37,1860
862,6,6,27.11.2024,1,311,352,41,352
128,18,24,13.11.2024,6,57,80,23,480
694,9,5,15.11.2024,12,105,145,40,1740
915,22,18,07.11.2024,15,354,506,152,7590
831,17,21,22.11.2024,4,208,247,39,988
54,20,1,02.11.2024,13,388,570,182,7410
384,30,8,07.11.2024,3,28,29,1,87
15,11,27,07.11.2024,3,126,182,56,546
817,27,27,22.11.2024,6,368,393,25,2358
525,4,27,11.11.2024,11,290,329,39,3619
213,30,18,13.11.2024,14,78,89,11,1246
366,11,6,01.11.2024,13,334,352,18,4576
218,15,8,03.11.2024,9,332,404,72,3636
69,29,7,14.11.2024,10,388,495,107,4950
105,23,18,26.11.2024,19,102,152,50,2888
615,11,21,23.11.2024,13,345,514,169,6682
711,5,11,06.11.2024,11,489,661,172,7271
70,11,1,20.11.2024,19,235,301,66,5719
760,8,17,19.11.2024,1,132,175,43,175
919,4,10,08.11.2024,14,383,510,127,7140
62,5,12,16.11.2024,10,117,143,26,1430
658,2,8,30.11.2024,20,495,618,123,12360
899,11,5,09.11.2024,11,329,458,129,5038
534,26,14,21.11.2024,10,380,438,58,4380
751,11,11,08.11.2024,7,279,407,128,2849
681,8,26,22.11.2024,8,312,381,69,3048
330,6,15,21.11.2024,1,51,65,14,65
977,7,2,21.11.2024,5,470,520,50,2600
178,19,18,27.11.2024,7,133,145,12,1015
743,15,10,06.11.2024,7,138,155,17,1085
255,10,10,19.11.2024,15,485,553,68,8295
884,26,16,03.11.2024,12,211,238,27,2856
452,14,17,20.11.2024,14,385,546,161,7644
813,16,1,25.11.2024,13,225,245,20,3185
929,30,10,20.11.2024,18,93,129,36,2322
264,13,15,10.11.2024,15,156,203,47,3045
493,3,11,05.11.2024,16,114,167,53,2672
5,1,28,17.11.2024,12,256,375,119,4500
963,13,24,12.11.2024,13,255,341,86,4433
603,3,14,29.11.2024,2,496,549,53,1098
955,19,6,07.11.2024,14,479,670,191,9380
770,24,12,17.11.2024,16,325,395,70,6320
60,21,13,30.11.2024,14,373,432,59,6048
36,30,27,12.11.2024,1,355,476,121,476
268,20,15,22.11.2024,5,142,188,46,940
975,22,27,06.11.2024,1,76,83,7,83
729,30,13,13.11.2024,19,488,530,42,10070
932,7,29,14.11.2024,6,418,487,69,2922
310,17,18,22.11.2024,13,301,416,115,5408
771,29,30,24.11.2024,3,72,95,23,285
817,12,27,05.11.2024,9,379,557,178,5013
408,23,10,01.11.2024,6,412,433,21,2598
72,25,23,14.11.2024,17,220,260,40,4420
442,6,6,12.11.2024,6,358,408,50,2448
187,17,4,15.11.2024,19,411,466,55,8854
61,24,6,26.11.2024,7,144,210,66,1470
419,15,21,30.11.2024,20,72,97,25,1940
82,10,3,13.11.2024,4,153,184,31,736
600,8,16,16.11.2024,4,25,29,4,116
979,1,22,19.11.2024,2,66,85,19,170
8,13,20,17.11.2024,9,467,590,123,5310
346,20,14,11.11.2024,12,347,418,71,5016
323,27,8,12.11.2024,13,202,217,15,2821
365,28,11,26.11.2024,4,21,31,10,124
412,24,27,29.11.2024,5,32,36,4,180
544,9,23,25.11.2024,8,197,261,64,2088
675,28,16,17.11.2024,14,337,354,17,4956
654,27,11,01.11.2024,12,439,653,214,7836
754,11,22,15.11.2024,8,311,383,72,3064
628,26,3,12.11.2024,14,471,694,223,9716
488,22,28,23.11.2024,4,372,440,68,1760
200,23,5,28.11.2024,17,441,618,177,10506
734,17,2,05.11.2024,16,402,477,75,7632
690,18,28,15.11.2024,6,450,666,216,3996
494,22,18,08.11.2024,8,122,169,47,1352
676,23,3,04.11.2024,14,497,528,31,7392
952,30,11,29.11.2024,13,388,446,58,5798
264,22,16,29.11.2024,4,339,497,158,1988
649,24,16,03.11.2024,11,439,644,205,7084
785,30,20,03.11.2024,11,201,276,75,3036
754,24,13,21.11.2024,18,484,603,119,10854
239,8,9,04.11.2024,10,62,68,6,680
759,19,30,07.11.2024,4,295,327,32,1308
321,13,19,24.11.2024,1,169,223,54,223
195,28,13,14.11.2024,11,390,550,160,6050
957,26,5,17.11.2024,20,304,333,29,6660
10,18,28,15.11.2024,11,89,132,43,1452
858,8,16,22.11.2024,15,91,107,16,1605
765,22,28,26.11.2024,2,307,366,59,732
706,4,9,28.11.2024,19,250,355,105,6745
507,10,23,13.11.2024,2,491,589,98,1178
848,23,7,28.11.2024,8,356,382,26,3056
887,25,6,28.11.2024,16,369,437,68,6992
835,22,30,28.11.2024,6,496,643,147,3858
346,14,22,16.11.2024,12,384,470,86,5640
541,24,10,10.11.2024,7,357,462,105,3234
100,5,11,25.11.2024,19,436,468,32,8892
958,23,10,15.11.2024,6,297,371,74,2226
495,10,29,05.11.2024,7,125,173,48,1211
753,21,1,12.11.2024,19,69,97,28,1843
880,5,13,14.11.2024,6,464,508,44,3048
998,16,6,02.11.2024,4,491,659,168,2636
608,14,5,21.11.2024,13,138,152,14,1976
407,16,10,23.11.2024,20,478,643,165,12860
385,25,23,26.11.2024,3,393,566,173,1698
666,13,9,21.11.2024,15,196,217,21,3255
85,4,16,21.11.2024,17,128,168,40,2856
587,16,9,23.11.2024,4,401,454,53,1816
496,21,23,14.11.2024,10,294,322,28,3220
66,23,30,28.11.2024,18,109,154,45,2772
21,13,18,27.11.2024,18,396,510,114,9180
66,17,27,19.11.2024,18,363,510,147,9180
128,25,25,07.11.2024,4,107,141,34,564
185,1,18,15.11.2024,11,79,88,9,968
212,21,6,03.11.2024,18,143,199,56,3582
87,4,17,10.11.2024,12,484,545,61,6540
968,22,1,08.11.2024,10,42,62,20,620
927,26,10,22.11.2024,18,234,306,72,5508
712,11,17,30.11.2024,12,311,398,87,4776
705,4,22,27.11.2024,2,134,152,18,304
307,28,27,07.11.2024,5,309,355,46,1775
368,9,5,24.11.2024,20,223,289,66,5780
267,13,21,29.11.2024,6,212,231,19,1386
261,22,14,23.11.2024,5,277,300,23,1500
751,9,21,23.11.2024,7,363,473,110,3311
664,27,17,20.11.2024,6,221,248,27,1488
807,14,13,01.11.2024,20,139,163,24,3260
545,4,22,18.11.2024,14,52,69,17,966
372,30,11,25.11.2024,9,90,127,37,1143
281,1,4,13.11.2024,8,202,221,19,1768
948,4,6,17.11.2024,10,303,428,125,4280
98,17,12,23.11.2024,19,435,565,130,10735
623,4,29,02.11.2024,6,173,240,67,1440
186,12,26,24.11.2024,18,285,412,127,7416
413,16,19,05.11.2024,9,25,31,6,279
160,22,5,05.11.2024,13,292,342,50,4446
941,24,21,12.11.2024,8,346,428,82,3424
469,6,15,12.11.2024,15,261,307,46,4605
439,17,23,29.11.2024,8,166,239,73,1912
971,10,14,25.11.2024,11,426,569,143,6259
79,24,8,03.11.2024,6,296,322,26,1932
293,18,30,16.11.2024,1,482,598,116,598
521,30,24,05.11.2024,16,259,352,93,5632
694,29,18,23.11.2024,4,215,285,70,1140
933,27,24,01.11.2024,14,357,496,139,6944
251,24,22,30.11.2024,17,348,372,24,6324
460,6,22,30.11.2024,17,454,512,58,8704
376,27,5,17.11.2024,12,477,592,115,7104
389,6,12,04.11.2024,11,459,533,74,5863
553,28,25,28.11.2024,4,159,202,43,808
272,7,1,24.11.2024,19,209,306,97,5814
952,30,21,17.11.2024,2,469,681,212,1362
869,16,2,12.11.2024,1,315,378,63,378
363,4,1,12.11.2024,6,213,224,11,1344
442,16,7,03.11.2024,17,267,299,32,5083
127,30,16,01.11.2024,5,389,453,64,2265
482,13,12,10.11.2024,12,226,255,29,3060
832,9,4,15.11.2024,15,98,118,20,1770
445,1,12,29.11.2024,7,73,86,13,602
137,13,14,24.11.2024,11,452,508,56,5588
204,16,22,09.11.2024,4,222,288,66,1152
820,22,23,05.11.2024,11,381,533,152,5863
410,17,24,30.11.2024,13,83,123,40,1599
812,1,5,05.11.2024,12,260,363,103,4356
243,2,22,27.11.2024,11,226,298,72,3278
9,14,16,10.11.2024,10,253,353,100,3530
254,20,5,24.11.2024,17,110,129,19,2193
118,28,9,23.11.2024,8,340,422,82,3376
486,23,26,26.11.2024,4,357,455,98,1820
186,7,28,19.11.2024,5,130,144,14,720
40,9,7,30.11.2024,5,225,298,73,1490
94,28,2,13.11.2024,14,272,371,99,5194
237,8,11,14.11.2024,16,49,61,12,976
53,10,4,09.11.2024,12,155,187,32,2244
429,8,11,29.11.2024,2,107,113,6,226
677,24,11,07.11.2024,10,247,360,113,3600
104,14,6,09.11.2024,16,195,231,36,3696
100,22,1,22.11.2024,18,390,432,42,7776
370,24,26,12.11.2024,19,274,333,59,6327
666,9,7,19.11.2024,13,62,68,6,884
645,24,20,04.11.2024,2,302,440,138,880
671,27,7,07.11.2024,15,464,503,39,7545
560,20,11,10.11.2024,16,495,565,70,9040
739,5,2,05.11.2024,7,221,302,81,2114
913,29,25,28.11.2024,18,488,709,221,12762
460,21,23,04.11.2024,14,53,65,12,910
954,17,26,01.11.2024,6,308,419,111,2514
133,10,2,19.11.2024,2,401,547,146,1094
759,27,13,16.11.2024,18,438,651,213,11718
170,15,25,17.11.2024,13,290,355,65,4615
622,9,7,06.11.2024,1,97,111,14,111
714,1,29,30.11.2024,17,239,327,88,5559
538,9,10,28.11.2024,8,162,190,28,1520
122,6,8,02.11.2024,18,134,143,9,2574
152,29,9,30.11.2024,5,150,211,61,1055
658,8,27,07.11.2024,18,76,102,26,1836
648,20,12,11.11.2024,3,474,687,213,2061
271,24,5,14.11.2024,20,162,241,79,4820
641,27,1,27.11.2024,12,125,186,61,2232
181,9,1,18.11.2024,19,71,99,28,1881
392,21,9,28.11.2024,20,284,403,119,8060
226,11,9,07.11.2024,19,322,463,141,8797
405,5,15,08.11.2024,14,197,287,90,4018
96,16,6,15.11.2024,6,411,465,54,2790
584,16,24,06.11.2024,10,30,34,4,340
182,27,13,22.11.2024,20,110,123,13,2460
437,8,15,30.11.2024,13,68,88,20,1144
745,25,26,01.11.2024,20,68,83,15,1660
113,27,1,25.11.2024,2,83,117,34,234
275,5,21,20.11.2024,1,400,422,22,422
811,4,18,24.11.2024,11,429,467,38,5137
143,16,25,19.11.2024,15,411,489,78,7335
491,5,8,02.11.2024,18,352,469,117,8442
127,1,27,02.11.2024,4,281,308,27,1232
908,27,14,05.11.2024,1,458,486,28,486
438,13,5,12.11.2024,10,128,186,58,1860
394,22,29,23.11.2024,4,256,383,127,1532
230,4,10,12.11.2024,3,316,348,32,1044
946,30,30,03.11.2024,2,310,351,41,702
544,11,20,06.11.2024,14,92,124,32,1736
309,20,27,10.11.2024,12,440,516,76,6192
512,22,12,30.11.2024,9,409,561,152,5049
79,26,1,28.11.2024,5,393,439,46,2195
152,13,15,24.11.2024,16,411,453,42,7248
438,24,9,05.11.2024,3,175,194,19,582
786,13,12,11.11.2024,16,223,304,81,4864
424,20,26,21.11.2024,11,86,127,41,1397
944,8,13,14.11.2024,18,259,334,75,6012
546,18,27,08.11.2024,13,60,82,22,1066
540,19,25,23.11.2024,8,357,413,56,3304
3,7,28,01.11.2024,12,288,427,139,5124
944,4,2,30.11.2024,12,193,277,84,3324
798,27,5,10.11.2024,15,89,128,39,1920
996,30,30,14.11.2024,8,121,139,18,1112
765,5,4,23.11.2024,5,201,214,13,1070
989,14,12,02.11.2024,4,338,366,28,1464
858,20,28,06.11.2024,1,91,101,10,101
251,3,1,19.11.2024,14,92,104,12,1456
762,5,24,17.11.2024,10,246,338,92,3380
455,26,21,23.11.2024,1,158,177,19,177
903,21,2,20.11.2024,6,262,276,14,1656
853,14,22,29.11.2024,15,286,407,121,6105
942,19,17,10.11.2024,8,223,250,27,2000
997,3,17,13.11.2024,5,377,463,86,2315
58,8,13,06.11.2024,18,310,337,27,6066
710,15,16,11.11.2024,13,417,469,52,6097
823,12,21,14.11.2024,7,150,164,14,1148
372,20,25,28.11.2024,11,33,39,6,429
555,4,3,07.11.2024,20,25,37,12,740
193,18,7,21.11.2024,2,135,147,12,294
584,19,2,19.11.2024,16,42,50,8,800
967,10,1,12.11.2024,10,480,612,132,6120
323,25,13,24.11.2024,12,487,666,179,7992
100,11,14,29.11.2024,17,68,97,29,1649
154,1,19,26.11.2024,13,249,359,110,4667
39,10,6,05.11.2024,15,58,77,19,1155
976,23,8,29.11.2024,7,408,548,140,3836
788,23,6,17.11.2024,17,496,657,161,11169
536,30,25,11.11.2024,15,397,477,80,7155
369,20,28,14.11.2024,2,448,626,178,1252
397,8,7,20.11.2024,20,56,63,7,1260
643,16,4,26.11.2024,1,88,128,40,128
561,28,26,26.11.2024,3,259,326,67,978
174,30,10,06.11.2024,3,154,187,33,561
92,3,6,23.11.2024,15,144,182,38,2730
263,25,29,15.11.2024,5,471,701,230,3505
500,2,12,28.11.2024,10,212,305,93,3050
940,22,5,15.11.2024,12,266,354,88,4248
322,12,3,22.11.2024,14,263,307,44,4298
897,22,2,20.11.2024,2,376,436,60,872
841,18,1,05.11.2024,4,160,179,19,716
409,28,3,08.11.2024,13,440,594,154,7722
358,15,15,21.11.2024,18,452,569,117,10242
88,6,24,04.11.2024,13,389,443,54,5759
337,3,11,11.11.2024,20,253,346,93,6920
488,4,9,15.11.2024,2,282,416,134,832
150,21,7,11.11.2024,19,35,46,11,874
390,2,30,26.11.2024,12,399,595,196,7140
219,2,7,28.11.2024,1,477,648,171,648
277,9,21,06.11.2024,3,88,103,15,309
84,10,28,23.11.2024,15,438,564,126,8460
686,29,9,06.11.2024,2,64,94,30,188
351,25,10,06.11.2024,7,188,232,44,1624
487,18,23,26.11.2024,6,483,603,120,3618
935,23,19,13.11.2024,1,289,420,131,420
204,3,24,22.11.2024,19,316,378,62,7182
844,24,24,27.11.2024,11,27,39,12,429
957,5,16,28.11.2024,11,75,111,36,1221
417,9,17,24.11.2024,1,494,729,235,729
878,5,21,15.11.2024,19,67,77,10,1463
193,14,23,18.11.2024,6,308,354,46,2124
215,7,22,19.11.2024,1,198,240,42,240
310,29,10,17.11.2024,4,356,477,121,1908
467,14,14,12.11.2024,12,418,518,100,6216
998,25,11,04.11.2024,6,240,293,53,1758
567,20,6,18.11.2024,14,203,291,88,4074
706,22,14,21.11.2024,10,357,526,169,5260
928,28,4,03.11.2024,4,63,67,4,268
955,14,4,16.11.2024,20,465,509,44,10180
455,17,19,26.11.2024,2,341,488,147,976
217,8,25,15.11.2024,18,203,231,28,4158
481,4,12,26.11.2024,15,218,310,92,4650
721,26,24,13.11.2024,1,471,660,189,660
520,10,9,29.11.2024,9,168,244,76,2196
932,14,22,08.11.2024,1,452,559,107,559
16,1,5,26.11.2024,12,424,544,120,6528
760,20,11,11.11.2024,6,480,719,239,4314
248,18,13,07.11.2024,20,329,469,140,9380
821,30,19,14.11.2024,5,471,577,106,2885
746,6,13,29.11.2024,11,268,335,67,3685
102,23,26,05.11.2024,17,77,101,24,1717
402,27,25,21.11.2024,9,422,473,51,4257
331,7,3,03.11.2024,1,230,307,77,307
608,5,1,20.11.2024,18,462,501,39,9018
392,1,24,24.11.2024,5,492,657,165,3285
797,12,6,08.11.2024,8,163,210,47,1680
252,24,25,26.11.2024,13,390,525,135,6825
282,3,30,05.11.2024,1,326,428,102,428
106,4,15,30.11.2024,20,79,88,9,1760
269,29,6,03.11.2024,3,257,312,55,936
859,7,13,04.11.2024,16,402,497,95,7952
499,21,3,07.11.2024,14,200,238,38,3332
931,15,26,06.11.2024,6,163,238,75,1428
676,19,21,20.11.2024,2,76,92,16,184
356,16,20,20.11.2024,18,22,29,7,522
261,30,4,07.11.2024,20,34,36,2,720
525,25,5,07.11.2024,12,75,86,11,1032
336,5,8,03.11.2024,5,148,188,40,940
977,3,12,23.11.2024,18,333,420,87,7560
829,16,14,17.11.2024,13,463,538,75,6994
203,22,28,29.11.2024,9,482,528,46,4752
813,25,19,10.11.2024,6,401,593,192,3558
500,14,29,15.11.2024,14,306,359,53,5026
327,20,4,20.11.2024,13,226,295,69,3835
383,29,21,27.11.2024,3,236,342,106,1026
982,17,9,19.11.2024,14,161,229,68,3206
661,17,12,13.11.2024,1,75,106,31,106
440,26,6,12.11.2024,8,55,74,19,592
381,5,25,11.11.2024,4,25,33,8,132
735,11,7,15.11.2024,19,402,584,182,11096
576,3,13,10.11.2024,20,122,140,18,2800
575,9,23,20.11.2024,3,296,396,100,1188
699,25,14,11.11.2024,11,115,123,8,1353
506,16,2,09.11.2024,14,77,97,20,1358
616,11,19,13.11.2024,8,297,350,53,2800
660,26,28,19.11.2024,1,458,539,81,539
862,13,2,29.11.2024,18,461,492,31,8856
661,1,3,16.11.2024,4,418,517,99,2068
309,9,11,25.11.2024,12,212,276,64,3312
321,16,20,02.11.2024,13,163,244,81,3172
506,28,21,30.11.2024,4,425,625,200,2500
106,1,8,02.11.2024,1,87,130,43,130
883,23,24,14.11.2024,8,102,116,14,928
924,26,12,27.11.2024,18,495,728,233,13104
889,2,9,29.11.2024,2,73,108,35,216
77,9,11,23.11.2024,20,400,488,88,9760
716,6,30,05.11.2024,19,241,267,26,5073
883,5,25,19.11.2024,14,326,440,114,6160
535,17,8,19.11.2024,16,337,503,166,8048
330,25,24,16.11.2024,8,64,89,25,712
729,3,12,18.11.2024,8,337,465,128,3720
211,23,3,03.11.2024,16,49,52,3,832
222,15,27,13.11.2024,7,254,306,52,2142
834,19,25,17.11.2024,17,432,602,170,10234
320,23,15,21.11.2024,5,427,469,42,2345
134,8,30,12.11.2024,13,488,703,215,9139
526,7,25,13.11.2024,7,53,66,13,462
703,10,28,19.11.2024,4,91,131,40,524
763,4,8,01.11.2024,15,110,117,7,1755
678,17,15,12.11.2024,9,77,100,23,900
363,14,7,05.11.2024,13,261,334,73,4342
55,15,9,12.11.2024,4,44,53,9,212
951,14,7,10.11.2024,7,213,281,68,1967
543,20,16,17.11.2024,14,72,78,6,1092
255,4,8,04.11.2024,2,450,589,139,1178
245,3,18,04.11.2024,9,129,171,42,1539
734,13,13,13.11.2024,4,126,178,52,712
709,9,16,07.11.2024,6,397,479,82,2874
295,23,20,10.11.2024,1,65,83,18,83
718,20,16,24.11.2024,10,429,584,155,5840
175,11,22,03.11.2024,6,110,160,50,960
146,1,22,16.11.2024,14,180,204,24,2856
271,29,3,06.11.2024,1,305,454,149,454
598,1,16,28.11.2024,8,247,264,17,2112
18,19,22,10.11.2024,8,272,306,34,2448
151,25,4,04.11.2024,10,406,487,81,4870
503,24,12,18.11.2024,9,338,394,56,3546
470,1,27,12.11.2024,10,361,524,163,5240
794,22,28,28.11.2024,20,252,296,44,5920
532,24,21,01.11.2024,5,490,703,213,3515
676,5,12,16.11.2024,1,137,190,53,190
997,14,12,07.11.2024,3,113,167,54,501
655,4,9,29.11.2024,18,452,566,114,10188
982,29,17,06.11.2024,9,457,552,95,4968
340,13,19,14.11.2024,9,168,180,12,1620
533,23,11,27.11.2024,20,79,111,32,2220
581,26,26,12.11.2024,10,73,77,4,770
950,22,5,15.11.2024,5,271,320,49,1600
572,22,6,10.11.2024,16,158,223,65,3568
16,15,2,07.11.2024,10,416,460,44,4600
501,10,1,14.11.2024,12,337,354,17,4248
258,5,12,29.11.2024,10,397,506,109,5060
982,25,18,05.11.2024,3,362,404,42,1212
751,7,14,19.11.2024,3,160,170,10,510
956,12,8,26.11.2024,13,223,331,108,4303
101,29,9,30.11.2024,10,307,346,39,3460
447,22,29,11.11.2024,19,87,121,34,2299
257,5,14,18.11.2024,7,165,179,14,1253
581,30,21,15.11.2024,18,108,151,43,2718
854,14,4,05.11.2024,17,232,276,44,4692
958,22,23,12.11.2024,15,190,239,49,3585
985,14,15,01.11.2024,18,33,46,13,828
91,25,5,20.11.2024,10,398,521,123,5210
383,5,20,18.11.2024,19,441,474,33,9006
866,13,5,13.11.2024,1,242,337,95,337
531,15,27,02.11.2024,3,46,66,20,198
666,4,11,20.11.2024,4,415,541,126,2164
708,11,28,02.11.2024,4,375,508,133,2032
758,23,2,23.11.2024,7,268,349,81,2443
991,16,5,08.11.2024,5,164,196,32,980
960,1,26,16.11.2024,20,350,386,36,7720
1,5,20,29.11.2024,4,270,313,43,1252
107,16,1,27.11.2024,17,233,251,18,4267
125,10,13,16.11.2024,6,414,591,177,3546
560,9,27,20.11.2024,15,432,574,142,8610
443,5,21,01.11.2024,6,88,122,34,732
247,6,17,24.11.2024,18,116,147,31,2646
297,22,4,19.11.2024,16,196,230,34,3680
396,23,26,04.11.2024,15,220,273,53,4095
29,10,15,04.11.2024,19,207,271,64,5149
35,21,21,29.11.2024,20,233,340,107,6800
364,5,15,29.11.2024,15,153,228,75,3420
367,17,28,28.11.2024,17,121,176,55,2992
538,13,17,03.11.2024,6,335,405,70,2430
737,19,11,15.11.2024,5,154,214,60,1070
311,30,13,03.11.2024,16,201,253,52,4048
675,6,19,23.11.2024,17,392,505,113,8585
133,23,11,19.11.2024,19,187,248,61,4712
414,3,2,01.11.2024,6,131,177,46,1062
512,30,22,16.11.2024,11,385,574,189,6314
828,30,24,26.11.2024,8,71,102,31,816
746,29,13,25.11.2024,14,463,499,36,6986
257,4,2,28.11.2024,3,232,283,51,849
647,27,1,30.11.2024,6,174,238,64,1428
387,5,21,19.11.2024,18,116,135,19,2430
449,22,10,08.11.2024,7,376,469,93,3283
542,26,26,07.11.2024,3,299,399,100,1197
685,4,7,02.11.2024,5,449,544,95,2720
418,19,18,28.11.2024,3,184,249,65,747
981,30,24,21.11.2024,17,258,368,110,6256
585,27,16,17.11.2024,12,191,278,87,3336
874,5,26,03.11.2024,15,225,275,50,4125
73,19,3,05.11.2024,17,163,180,17,3060
237,2,20,18.11.2024,11,31,44,13,484
297,30,27,09.11.2024,13,358,386,28,5018
893,6,10,03.11.2024,18,296,425,129,7650
955,20,17,10.11.2024,13,317,411,94,5343
914,4,19,16.11.2024,9,334,355,21,3195
432,9,7,11.11.2024,2,87,113,26,226
752,11,30,25.11.2024,2,133,144,11,288
971,19,29,20.11.2024,2,186,201,15,402
427,20,24,20.11.2024,3,446,564,118,1692
133,9,24,02.11.2024,4,37,47,10,188
666,12,14,16.11.2024,10,395,571,176,5710
234,1,30,02.11.2024,1,391,554,163,554
548,20,28,13.11.2024,1,285,306,21,306
785,13,23,05.11.2024,14,357,463,106,6482
119,15,4,29.11.2024,20,492,598,106,11960
199,11,14,30.11.2024,2,134,147,13,294
11,8,14,24.11.2024,18,293,438,145,7884
16,28,24,08.11.2024,2,57,63,6,126
185,10,2,11.11.2024,12,309,449,140,5388
300,5,20,13.11.2024,16,336,452,116,7232
79,9,18,07.11.2024,16,359,508,149,8128
920,30,28,08.11.2024,15,362,534,172,8010
799,18,10,28.11.2024,8,273,319,46,2552
715,18,17,04.11.2024,2,186,230,44,460
974,20,16,09.11.2024,3,118,131,13,393
1000,17,8,10.11.2024,18,121,148,27,2664
836,26,5,02.11.2024,8,355,477,122,3816
465,4,1,16.11.2024,2,150,197,47,394
308,27,3,02.11.2024,9,430,526,96,4734
20,28,13,13.11.2024,15,41,47,6,705
189,22,14,18.11.2024,2,337,359,22,718
782,12,30,01.11.2024,20,382,459,77,9180
849,30,9,26.11.2024,19,124,132,8,2508
744,27,20,14.11.2024,14,396,581,185,8134
771,2,26,04.11.2024,18,206,284,78,5112
695,10,28,18.11.2024,15,223,307,84,4605
788,17,9,06.11.2024,13,244,366,122,4758
244,5,30,01.11.2024,9,404,597,193,5373
88,8,25,18.11.2024,10,182,223,41,2230
631,9,12,09.11.2024,9,396,560,164,5040
623,1,4,10.11.2024,19,337,481,144,9139
868,6,15,15.11.2024,1,231,291,60,291
990,12,16,21.11.2024,18,125,134,9,2412
962,3,9,29.11.2024,20,285,421,136,8420
452,6,9,25.11.2024,9,145,184,39,1656
233,21,6,05.11.2024,20,335,387,52,7740
671,2,6,22.11.2024,17,433,568,135,9656
43,18,23,08.11.2024,2,477,714,237,1428
999,9,1,22.11.2024,12,279,299,20,3588
241,12,4,03.11.2024,17,233,298,65,5066
243,7,11,19.11.2024,12,418,567,149,6804
74,21,14,29.11.2024,10,89,106,17,1060
808,12,11,14.11.2024,12,246,366,120,4392
637,1,6,12.11.2024,2,160,178,18,356
606,1,4,20.11.2024,7,408,522,114,3654
800,24,17,26.11.2024,19,362,533,171,10127
388,27,19,02.11.2024,5,203,304,101,1520
81,3,30,08.11.2024,19,262,342,80,6498
562,24,14,18.11.2024,4,427,550,123,2200
53,20,16,22.11.2024,17,270,322,52,5474
200,27,19,10.11.2024,8,178,251,73,2008
371,8,15,11.11.2024,4,353,441,88,1764
981,29,14,12.11.2024,3,189,241,52,723
937,12,21,16.11.2024,20,131,183,52,3660
236,19,27,27.11.2024,5,464,539,75,2695
932,14,22,19.11.2024,5,311,437,126,2185
350,11,4,03.11.2024,14,222,331,109,4634
590,16,21,29.11.2024,7,452,653,201,4571
16,6,4,14.11.2024,9,387,531,144,4779
482,24,4,05.11.2024,2,420,446,26,892
171,3,5,17.11.2024,17,461,672,211,11424
363,5,13,23.11.2024,18,136,161,25,2898
345,29,27,29.11.2024,11,304,403,99,4433
740,2,3,24.11.2024,12,476,695,219,8340
646,15,24,27.11.2024,14,159,201,42,2814
138,24,6,24.11.2024,19,460,677,217,12863
86,5,29,01.11.2024,19,305,412,107,7828
465,13,11,15.11.2024,6,264,347,83,2082
968,25,4,08.11.2024,10,257,275,18,2750
531,29,17,19.11.2024,17,425,528,103,8976
331,13,11,25.11.2024,6,478,511,33,3066
968,24,29,24.11.2024,7,227,266,39,1862
901,20,11,04.11.2024,12,157,173,16,2076
281,16,15,08.11.2024,6,158,232,74,1392
621,25,4,30.11.2024,8,340,378,38,3024
212,18,27,17.11.2024,6,33,48,15,288
983,29,18,18.11.2024,7,23,33,10,231
27,12,7,10.11.2024,19,225,281,56,5339
130,27,15,10.11.2024,4,364,532,168,2128
123,15,29,14.11.2024,16,146,210,64,3360
286,24,22,04.11.2024,12,406,562,156,6744
228,24,3,11.11.2024,6,263,309,46,1854
646,24,17,22.11.2024,3,359,428,69,1284
947,2,14,04.11.2024,17,172,246,74,4182
677,27,29,21.11.2024,2,476,634,158,1268
252,5,19,13.11.2024,8,343,401,58,3208
156,16,27,06.11.2024,16,156,177,21,2832
897,3,17,28.11.2024,7,22,23,1,161
572,20,7,23.11.2024,6,39,53,14,318
629,13,21,19.11.2024,8,326,413,87,3304
673,6,29,10.11.2024,8,440,594,154,4752
502,26,21,13.11.2024,20,191,242,51,4840
99,8,4,29.11.2024,10,221,277,56,2770
254,22,14,04.11.2024,6,243,290,47,1740
117,12,23,13.11.2024,5,391,496,105,2480
825,28,16,20.11.2024,14,350,372,22,5208
275,17,7,29.11.2024,14,49,69,20,966
268,22,11,14.11.2024,13,408,507,99,6591
267,30,2,09.11.2024,16,370,445,75,7120
839,2,10,15.11.2024,14,126,182,56,2548
549,7,25,21.11.2024,4,475,630,155,2520
338,5,20,18.11.2024,1,476,504,28,504
389,3,25,23.11.2024,11,458,639,181,7029
567,3,21,02.11.2024,17,121,156,35,2652
161,27,18,13.11.2024,8,159,179,20,1432
383,11,14,07.11.2024,18,372,548,176,9864
37,28,1,25.11.2024,17,69,85,16,1445
497,2,6,10.11.2024,10,32,42,10,420
705,8,2,09.11.2024,4,410,501,91,2004
411,5,27,24.11.2024,9,434,470,36,4230
517,24,23,25.11.2024,14,30,41,11,574
555,20,30,05.11.2024,4,373,525,152,2100
199,27,20,28.11.2024,10,397,492,95,4920
762,1,10,09.11.2024,15,117,137,20,2055
672,19,16,13.11.2024,10,226,260,34,2600
417,18,9,16.11.2024,10,456,588,132,5880
251,13,1,16.11.2024,13,477,664,187,8632
732,4,15,08.11.2024,19,488,600,112,11400
238,15,12,16.11.2024,19,72,86,14,1634
148,26,21,03.11.2024,4,289,331,42,1324
965,16,19,08.11.2024,3,88,117,29,351
485,17,24,27.11.2024,19,385,415,30,7885
506,9,14,10.11.2024,11,420,448,28,4928
706,19,20,14.11.2024,1,149,170,21,170
576,26,16,18.11.2024,16,170,229,59,3664
330,15,23,16.11.2024,17,286,396,110,6732
751,3,30,04.11.2024,14,356,434,78,6076
776,1,6,17.11.2024,4,100,124,24,496
996,4,2,29.11.2024,14,258,343,85,4802
538,16,5,24.11.2024,18,221,233,12,4194
121,14,10,24.11.2024,9,271,359,88,3231
381,19,21,06.11.2024,5,159,216,57,1080
823,20,23,12.11.2024,17,310,392,82,6664
216,30,11,30.11.2024,5,99,136,37,680
486,1,11,14.11.2024,6,92,100,8,600
6,10,23,07.11.2024,7,353,456,103,3192
339,4,2,20.11.2024,15,305,330,25,4950
652,18,29,08.11.2024,12,322,472,150,5664
282,10,27,30.11.2024,14,301,357,56,4998
640,25,13,30.11.2024,9,289,387,98,3483
208,3,19,05.11.2024,4,371,436,65,1744
270,19,4,05.11.2024,17,302,421,119,7157
339,19,25,28.11.2024,19,310,461,151,8759
755,28,20,22.11.2024,16,120,127,7,2032
238,7,3,30.11.2024,20,90,102,12,2040
896,1,11,03.11.2024,2,86,121,35,242
436,22,16,11.11.2024,10,260,287,27,2870
574,13,13,25.11.2024,13,359,434,75,5642
859,17,11,17.11.2024,3,444,634,190,1902
979,6,21,27.11.2024,9,361,516,155,4644
574,15,16,23.11.2024,9,349,454,105,4086
446,21,12,06.11.2024,1,436,625,189,625
790,22,12,24.11.2024,14,123,160,37,2240
943,7,13,12.11.2024,6,468,701,233,4206
201,15,12,17.11.2024,7,23,27,4,189
97,30,12,30.11.2024,9,261,276,15,2484
280,2,21,09.11.2024,16,211,316,105,5056
722,9,9,21.11.2024,2,486,691,205,1382
884,23,30,16.11.2024,20,323,411,88,8220
485,24,28,21.11.2024,18,408,435,27,7830
30,20,29,23.11.2024,5,359,405,46,2025
872,5,3,14.11.2024,4,47,63,16,252
64,11,4,28.11.2024,18,153,220,67,3960
671,20,24,01.11.2024,11,422,604,182,6644
325,29,23,06.11.2024,19,367,445,78,8455
15,22,13,14.11.2024,2,51,73,22,146
514,5,24,09.11.2024,3,103,110,7,330
624,7,23,17.11.2024,14,103,143,40,2002
858,1,10,09.11.2024,18,188,227,39,4086
582,27,23,03.11.2024,19,467,508,41,9652
941,3,6,24.11.2024,3,109,144,35,432
989,1,25,06.11.2024,1,124,152,28,152
84,29,24,08.11.2024,10,422,565,143,5650
924,28,7,24.11.2024,5,169,206,37,1030
294,6,9,05.11.2024,19,171,197,26,3743
193,9,29,07.11.2024,6,490,572,82,3432
451,9,3,16.11.2024,12,298,359,61,4308
658,17,15,27.11.2024,6,38,54,16,324
395,5,18,19.11.2024,7,497,619,122,4333
662,26,22,26.11.2024,10,120,163,43,1630
516,18,27,24.11.2024,9,64,89,25,801
265,7,15,09.11.2024,2,463,593,130,1186
647,6,16,05.11.2024,15,302,367,65,5505
387,22,19,29.11.2024,2,175,192,17,384
368,28,29,01.11.2024,6,222,267,45,1602
664,29,4,06.11.2024,12,167,210,43,2520
191,25,1,15.11.2024,20,239,313,74,6260
446,24,13,16.11.2024,8,141,172,31,1376
346,16,22,13.11.2024,10,39,58,19,580
240,25,30,29.11.2024,17,72,89,17,1513
276,19,13,19.11.2024,1,99,111,12,111
308,29,20,23.11.2024,17,115,171,56,2907
770,5,5,22.11.2024,11,399,428,29,4708
93,10,26,25.11.2024,5,405,509,104,2545
170,15,1,22.11.2024,5,116,131,15,655
315,3,6,08.11.2024,7,230,316,86,2212
158,22,18,28.11.2024,12,22,25,3,300
103,16,18,22.11.2024,13,355,519,164,6747
685,13,27,15.11.2024,8,386,422,36,3376
132,11,25,30.11.2024,5,212,254,42,1270
290,27,22,24.11.2024,14,307,396,89,5544
356,16,22,24.11.2024,19,33,48,15,912
183,25,8,12.11.2024,12,183,260,77,3120
626,20,25,13.11.2024,3,330,367,37,1101
193,2,7,10.11.2024,14,65,79,14,1106
185,14,5,10.11.2024,10,206,292,86,2920
36,9,14,06.11.2024,6,211,271,60,1626
109,15,26,03.11.2024,12,349,383,34,4596
884,13,26,26.11.2024,1,97,108,11,108
520,13,22,15.11.2024,1,253,375,122,375
412,14,25,02.11.2024,10,224,310,86,3100
119,20,26,26.11.2024,15,261,366,105,5490
730,11,28,18.11.2024,12,74,83,9,996
435,18,25,13.11.2024,3,92,111,19,333
957,23,19,09.11.2024,7,267,354,87,2478
894,15,14,02.11.2024,15,155,171,16,2565
502,15,12,02.11.2024,20,349,407,58,8140
346,22,10,25.11.2024,1,281,317,36,317
366,14,1,15.11.2024,11,163,174,11,1914
115,12,24,02.11.2024,18,375,435,60,7830
87,18,4,05.11.2024,5,324,403,79,2015
282,12,15,23.11.2024,20,137,195,58,3900
855,30,24,27.11.2024,17,293,313,20,5321
335,12,2,05.11.2024,20,489,654,165,13080
904,4,13,17.11.2024,3,182,243,61,729
310,14,13,01.11.2024,6,476,555,79,3330
669,24,29,03.11.2024,14,483,680,197,9520
585,9,10,20.11.2024,17,279,392,113,6664
711,26,2,12.11.2024,19,247,344,97,6536
448,9,24,23.11.2024,6,153,207,54,1242
620,13,30,06.11.2024,10,151,186,35,1860
20,26,14,22.11.2024,5,152,191,39,955
810,21,11,04.11.2024,8,128,175,47,1400
227,3,20,10.11.2024,20,417,548,131,10960
651,20,11,18.11.2024,13,248,323,75,4199
352,11,11,12.11.2024,15,93,133,40,1995
511,7,18,23.11.2024,6,343,400,57,2400
34,22,28,19.11.2024,3,323,421,98,1263
354,3,7,24.11.2024,17,197,233,36,3961
323,15,22,15.11.2024,1,95,125,30,125
640,12,19,14.11.2024,14,498,528,30,7392
997,10,18,24.11.2024,16,495,603,108,9648
551,5,13,20.11.2024,4,67,76,9,304
114,19,10,06.11.2024,6,388,579,191,3474
411,18,14,12.11.2024,7,221,291,70,2037
328,25,12,21.11.2024,4,339,461,122,1844
649,25,21,11.11.2024,17,277,340,63,5780
880,13,16,25.11.2024,15,157,231,74,3465
161,30,28,06.11.2024,13,158,204,46,2652
343,25,15,21.11.2024,6,348,381,33,2286
595,21,14,14.11.2024,14,111,118,7,1652
230,5,20,20.11.2024,17,499,659,160,11203
750,14,1,11.11.2024,20,140,183,43,3660
484,22,3,12.11.2024,1,377,545,168,545
670,13,18,17.11.2024,7,428,481,53,3367
378,24,28,08.11.2024,6,247,338,91,2028
205,11,5,10.11.2024,3,449,514,65,1542
473,15,8,22.11.2024,20,233,270,37,5400
182,15,17,21.11.2024,4,406,579,173,2316
894,30,30,06.11.2024,8,242,359,117,2872
8,24,2,22.11.2024,14,436,653,217,9142
883,13,3,26.11.2024,14,480,694,214,9716
551,4,23,25.11.2024,20,331,427,96,8540
25,15,16,27.11.2024,2,161,197,36,394
843,24,25,02.11.2024,12,212,311,99,3732
645,21,15,14.11.2024,4,70,100,30,400
777,27,19,25.11.2024,4,367,445,78,1780
673,11,5,30.11.2024,8,402,460,58,3680
100,11,21,23.11.2024,3,240,329,89,987
771,8,25,09.11.2024,11,162,202,40,2222
807,15,23,09.11.2024,19,152,162,10,3078
144,5,17,10.11.2024,1,126,153,27,153
372,23,10,10.11.2024,6,292,347,55,2082
731,15,22,10.11.2024,5,377,514,137,2570
151,20,10,28.11.2024,13,144,165,21,2145
872,7,19,10.11.2024,5,300,351,51,1755
739,17,24,28.11.2024,17,215,285,70,4845
175,12,21,05.11.2024,19,429,511,82,9709
384,13,28,30.11.2024,16,331,478,147,7648
494,6,16,29.11.2024,13,27,40,13,520
351,8,10,07.11.2024,8,92,122,30,976
747,26,4,21.11.2024,7,191,240,49,1680
935,21,30,01.11.2024,17,451,624,173,10608
373,22,2,13.11.2024,4,477,610,133,2440
278,18,18,28.11.2024,18,439,652,213,11736
58,15,19,17.11.2024,8,137,194,57,1552
188,23,30,21.11.2024,8,130,178,48,1424
182,2,20,09.11.2024,18,153,212,59,3816
751,27,30,03.11.2024,5,271,292,21,1460
234,8,19,25.11.2024,19,249,273,24,5187
903,26,2,11.11.2024,3,114,126,12,378
86,16,7,04.11.2024,18,303,400,97,7200
308,19,1,19.11.2024,14,433,477,44,6678
908,15,25,21.11.2024,7,303,404,101,2828
774,15,1,09.11.2024,14,309,393,84,5502
181,11,17,16.11.2024,17,156,209,53,3553
271,28,18,08.11.2024,11,152,198,46,2178
317,21,15,04.11.2024,6,254,303,49,1818
998,17,16,16.11.2024,6,106,147,41,882
690,10,4,30.11.2024,15,184,251,67,3765
843,6,7,25.11.2024,4,386,443,57,1772
514,10,11,25.11.2024,17,247,335,88,5695
950,20,7,19.11.2024,5,175,199,24,995
406,26,6,28.11.2024,6,313,351,38,2106
980,17,16,21.11.2024,20,399,558,159,11160
276,8,30,09.11.2024,16,468,668,200,10688
380,5,10,11.11.2024,12,418,498,80,5976
316,14,19,13.11.2024,14,23,33,10,462
57,14,12,21.11.2024,5,488,681,193,3405
20,27,23,07.11.2024,7,338,394,56,2758
853,12,1,11.11.2024,14,400,478,78,6692
574,24,7,26.11.2024,7,316,395,79,2765
281,4,3,08.11.2024,6,176,223,47,1338
739,19,16,02.11.2024,13,350,511,161,6643
499,8,9,20.11.2024,19,200,219,19,4161
655,11,9,18.11.2024,12,230,271,41,3252
484,5,29,24.11.2024,3,176,246,70,738
424,27,5,28.11.2024,5,303,397,94,1985
576,3,15,08.11.2024,11,295,411,116,4521
267,18,17,27.11.2024,10,351,391,40,3910
789,3,28,26.11.2024,11,479,581,102,6391
792,15,24,29.11.2024,7,108,137,29,959
472,12,11,07.11.2024,9,143,198,55,1782
24,5,4,21.11.2024,14,225,318,93,4452
818,2,27,17.11.2024,2,458,587,129,1174
17,19,14,02.11.2024,17,439,526,87,8942
552,16,10,19.11.2024,11,325,448,123,4928
579,3,18,25.11.2024,4,275,388,113,1552
867,28,3,19.11.2024,15,313,468,155,7020
770,3,25,22.11.2024,14,413,520,107,7280
911,29,24,05.11.2024,11,55,74,19,814
348,15,17,25.11.2024,14,447,550,103,7700
301,1,20,27.11.2024,13,29,33,4,429
438,5,9,28.11.2024,8,301,419,118,3352
546,15,21,22.11.2024,7,390,510,120,3570
364,29,29,23.11.2024,19,93,130,37,2470
212,10,6,04.11.2024,1,276,407,131,407
41,25,5,18.11.2024,12,478,573,95,6876
323,30,8,22.11.2024,7,117,131,14,917
278,8,30,30.11.2024,7,391,415,24,2905
899,29,15,04.11.2024,13,32,46,14,598
875,24,7,13.11.2024,2,234,288,54,576
211,25,13,19.11.2024,4,65,73,8,292
936,19,24,17.11.2024,4,98,112,14,448
964,16,24,20.11.2024,12,380,453,73,5436
196,7,3,26.11.2024,17,193,225,32,3825
115,15,1,01.11.2024,13,406,499,93,6487
879,4,12,12.11.2024,10,422,525,103,5250
869,21,10,08.11.2024,3,332,470,138,1410
897,16,1,09.11.2024,11,42,60,18,660
182,19,1,05.11.2024,17,95,129,34,2193
781,2,2,20.11.2024,7,436,587,151,4109
381,20,14,27.11.2024,6,221,250,29,1500
532,5,24,26.11.2024,6,195,286,91,1716
806,6,1,16.11.2024,7,167,222,55,1554
931,27,9,20.11.2024,11,34,36,2,396
30,29,16,02.11.2024,5,459,491,32,2455
387,25,20,24.11.2024,17,101,111,10,1887
358,29,8,03.11.2024,14,494,544,50,7616
488,15,14,28.11.2024,18,231,332,101,5976
829,21,1,10.11.2024,16,245,357,112,5712
132,11,22,18.11.2024,12,479,647,168,7764
99,16,16,24.11.2024,19,114,131,17,2489
133,26,5,08.11.2024,3,377,517,140,1551
290,29,20,04.11.2024,8,129,146,17,1168
676,10,11,23.11.2024,15,341,438,97,6570
592,29,9,25.11.2024,5,177,216,39,1080
149,19,24,30.11.2024,2,379,534,155,1068
648,2,26,07.11.2024,6,27,36,9,216
856,26,8,06.11.2024,13,175,229,54,2977
496,28,12,07.11.2024,19,215,321,106,6099
465,20,9,18.11.2024,15,77,90,13,1350
787,17,30,11.11.2024,11,498,565,67,6215
350,26,28,16.11.2024,18,239,261,22,4698
877,11,25,17.11.2024,9,50,61,11,549
658,1,18,05.11.2024,4,129,162,33,648
114,4,18,23.11.2024,10,81,97,16,970
464,14,18,03.11.2024,17,108,153,45,2601
907,17,7,05.11.2024,8,392,447,55,3576
763,12,17,20.11.2024,5,290,374,84,1870
49,26,18,12.11.2024,18,131,193,62,3474
544,6,12,06.11.2024,4,347,463,116,1852
880,20,8,27.11.2024,5,280,414,134,2070
435,28,7,09.11.2024,2,480,709,229,1418
304,13,29,17.11.2024,14,449,566,117,7924
140,24,10,01.11.2024,3,141,183,42,549
320,7,30,24.11.2024,20,305,330,25,6600
774,14,5,05.11.2024,16,415,578,163,9248
827,8,13,26.11.2024,6,330,405,75,2430
199,8,27,12.11.2024,3,129,190,61,570
144,29,13,04.11.2024,19,473,529,56,10051
455,5,22,09.11.2024,11,25,28,3,308
319,17,4,25.11.2024,20,246,332,86,6640
306,27,4,18.11.2024,20,238,258,20,5160
773,30,24,11.11.2024,9,476,508,32,4572
859,29,9,04.11.2024,15,224,253,29,3795
727,23,28,26.11.2024,16,384,442,58,7072
106,3,24,20.11.2024,20,435,504,69,10080
871,22,16,27.11.2024,14,222,297,75,4158
886,25,9,27.11.2024,9,454,608,154,5472
337,14,22,27.11.2024,9,492,535,43,4815
104,23,26,16.11.2024,8,301,346,45,2768
445,22,9,04.11.2024,16,289,413,124,6608
385,20,17,28.11.2024,13,40,44,4,572
859,26,21,04.11.2024,19,66,97,31,1843
245,12,19,22.11.2024,20,222,273,51,5460
763,2,12,21.11.2024,15,429,561,132,8415
536,2,13,27.11.2024,14,341,362,21,5068
581,6,1,21.11.2024,11,67,99,32,1089
822,1,24,15.11.2024,9,192,261,69,2349
361,8,9,15.11.2024,2,176,240,64,480
651,9,25,26.11.2024,6,121,168,47,1008
561,21,11,24.11.2024,13,382,535,153,6955
177,28,16,28.11.2024,3,180,239,59,717
758,26,27,08.11.2024,11,418,458,40,5038
740,3,21,13.11.2024,11,318,426,108,4686
775,13,7,09.11.2024,16,188,266,78,4256
918,12,25,06.11.2024,6,175,192,17,1152
596,10,30,17.11.2024,18,162,211,49,3798
183,13,20,23.11.2024,3,115,126,11,378
613,30,29,22.11.2024,13,429,479,50,6227
349,18,12,13.11.2024,5,462,507,45,2535
980,24,27,29.11.2024,10,314,468,154,4680
332,8,15,27.11.2024,2,138,155,17,310
281,1,16,08.11.2024,8,138,159,21,1272
664,26,7,05.11.2024,1,162,241,79,241
879,20,16,27.11.2024,15,219,284,65,4260
582,7,14,06.11.2024,17,299,398,99,6766
910,29,13,24.11.2024,9,359,536,177,4824
823,26,9,14.11.2024,12,195,286,91,3432
241,11,18,12.11.2024,3,480,533,53,1599
881,27,23,08.11.2024,18,298,326,28,5868
940,26,17,23.11.2024,16,277,304,27,4864
847,20,8,24.11.2024,12,364,488,124,5856
568,27,8,15.11.2024,9,296,318,22,2862
634,15,16,19.11.2024,14,51,76,25,1064
23,18,15,18.11.2024,2,450,569,119,1138
724,5,3,22.11.2024,12,51,71,20,852
584,9,29,24.11.2024,1,363,461,98,461
722,25,5,13.11.2024,7,338,402,64,2814
714,22,10,11.11.2024,8,294,424,130,3392
969,14,5,25.11.2024,18,490,645,155,11610
884,1,20,02.11.2024,12,302,422,120,5064
73,20,3,17.11.2024,14,371,511,140,7154
255,20,25,25.11.2024,6,421,448,27,2688
952,16,24,04.11.2024,11,63,93,30,1023
588,23,22,13.11.2024,14,203,257,54,3598
868,11,6,04.11.2024,10,190,261,71,2610
901,9,16,03.11.2024,6,145,165,20,990
360,21,21,03.11.2024,11,237,259,22,2849
264,1,29,20.11.2024,2,491,529,38,1058
383,4,6,01.11.2024,17,26,31,5,527
314,1,26,29.11.2024,19,290,417,127,7923
979,6,7,21.11.2024,20,259,335,76,6700
1000,12,4,28.11.2024,5,308,403,95,2015
913,15,23,28.11.2024,6,264,373,109,2238
456,1,20,02.11.2024,18,446,628,182,11304
124,26,30,10.11.2024,10,72,97,25,970
605,17,6,29.11.2024,4,259,342,83,1368
628,30,11,15.11.2024,18,419,588,169,10584
967,4,22,18.11.2024,3,182,222,40,666
246,27,16,07.11.2024,13,40,43,3,559
944,16,26,27.11.2024,19,67,87,20,1653
680,21,11,30.11.2024,17,290,396,106,6732
535,13,25,18.11.2024,7,156,173,17,1211
782,7,10,21.11.2024,14,214,261,47,3654
503,1,16,04.11.2024,11,289,383,94,4213
314,16,26,25.11.2024,10,390,532,142,5320
541,27,2,07.11.2024,3,167,220,53,660
922,19,18,06.11.2024,11,375,484,109,5324
49,10,13,07.11.2024,12,483,518,35,6216
846,22,28,14.11.2024,17,272,307,35,5219
380,22,23,02.11.2024,7,67,100,33,700
914,8,23,11.11.2024,3,363,462,99,1386
585,21,20,01.11.2024,2,463,529,66,1058
706,4,30,10.11.2024,1,454,612,158,612
938,27,11,06.11.2024,13,417,507,90,6591
858,13,2,05.11.2024,5,307,409,102,2045
265,29,30,14.11.2024,19,361,525,164,9975
318,7,29,21.11.2024,9,216,228,12,2052
844,14,13,09.11.2024,7,412,523,111,3661
615,1,21,23.11.2024,13,40,56,16,728
132,22,23,08.11.2024,3,326,359,33,1077
924,26,16,03.11.2024,6,278,313,35,1878
758,9,22,23.11.2024,13,157,185,28,2405
877,19,9,04.11.2024,4,210,304,94,1216
207,3,18,28.11.2024,16,116,149,33,2384
37,16,16,04.11.2024,4,130,185,55,740
189,3,25,23.11.2024,3,136,181,45,543
449,24,5,15.11.2024,20,389,525,136,10500
516,25,7,25.11.2024,7,368,394,26,2758
15,5,11,28.11.2024,9,462,558,96,5022
206,29,21,02.11.2024,13,202,299,97,3887
518,3,8,06.11.2024,7,181,249,68,1743
26,28,15,03.11.2024,8,309,364,55,2912
165,5,18,11.11.2024,2,73,79,6,158
531,18,1,20.11.2024,6,368,439,71,2634
40,5,29,04.11.2024,8,23,24,1,192
60,27,13,25.11.2024,19,77,89,12,1691
644,2,19,18.11.2024,3,30,42,12,126
488,30,19,21.11.2024,13,156,206,50,2678
461,30,24,08.11.2024,16,314,379,65,6064
652,15,16,30.11.2024,5,238,344,106,1720
230,5,10,21.11.2024,6,482,591,109,3546
264,29,6,12.11.2024,1,227,269,42,269
44,15,14,23.11.2024,18,429,641,212,11538
129,27,21,12.11.2024,7,472,585,113,4095
428,15,24,15.11.2024,15,477,601,124,9015
346,11,22,13.11.2024,5,367,420,53,2100
223,23,7,19.11.2024,7,475,655,180,4585
803,20,12,29.11.2024,15,283,395,112,5925
419,12,21,10.11.2024,7,209,263,54,1841
556,21,15,10.11.2024,20,218,248,30,4960
346,18,29,06.11.2024,13,470,585,115,7605
966,15,1,23.11.2024,7,205,277,72,1939
280,24,22,19.11.2024,5,328,429,101,2145
821,7,5,14.11.2024,11,245,353,108,3883
134,25,30,16.11.2024,11,313,436,123,4796
544,24,21,29.11.2024,2,345,484,139,968
88,1,1,30.11.2024,2,179,195,16,390
954,29,12,07.11.2024,5,480,570,90,2850
68,12,20,30.11.2024,11,300,427,127,4697
487,11,23,06.11.2024,10,166,234,68,2340
164,29,29,05.11.2024,6,219,283,64,1698
634,14,6,18.11.2024,18,322,439,117,7902
288,23,28,29.11.2024,8,489,659,170,5272
151,30,15,04.11.2024,2,85,104,19,208
389,16,6,25.11.2024,1,301,450,149,450
372,30,15,19.11.2024,19,107,156,49,2964
994,16,22,19.11.2024,12,445,665,220,7980
908,12,3,06.11.2024,5,320,433,113,2165
939,5,4,30.11.2024,7,482,575,93,4025
729,26,26,03.11.2024,12,309,436,127,5232
17,20,29,19.11.2024,14,496,602,106,8428
259,7,17,09.11.2024,17,454,482,28,8194
327,29,6,02.11.2024,8,356,416,60,3328
444,11,2,09.11.2024,15,337,404,67,6060
33,5,28,30.11.2024,20,25,33,8,660
310,13,7,29.11.2024,16,202,216,14,3456
689,9,23,13.11.2024,11,196,251,55,2761
803,14,14,23.11.2024,11,84,101,17,1111
268,18,7,16.11.2024,10,148,216,68,2160
941,22,3,26.11.2024,11,434,630,196,6930
24,26,5,26.11.2024,4,137,154,17,616
67,5,19,26.11.2024,8,394,567,173,4536
10,24,1,24.11.2024,11,438,581,143,6391
160,19,21,28.11.2024,15,323,387,64,5805
681,4,20,04.11.2024,2,358,408,50,816
764,30,3,06.11.2024,3,365,398,33,1194
444,26,22,08.11.2024,7,44,48,4,336
329,21,17,07.11.2024,16,412,564,152,9024
508,20,23,06.11.2024,16,158,214,56,3424
886,28,2,15.11.2024,6,264,286,22,1716
998,7,9,05.11.2024,18,296,336,40,6048
127,23,25,03.11.2024,7,110,131,21,917
234,6,13,21.11.2024,19,162,201,39,3819
656,10,7,14.11.2024,9,416,574,158,5166
544,1,21,29.11.2024,9,155,174,19,1566
64,3,16,12.11.2024,2,318,450,132,900
82,22,25,29.11.2024,15,26,36,10,540
91,11,19,25.11.2024,12,355,470,115,5640
983,3,19,09.11.2024,11,236,327,91,3597
492,12,16,10.11.2024,16,170,256,86,4096
195,8,19,06.11.2024,2,352,434,82,868
902,15,11,30.11.2024,13,243,353,110,4589
464,5,5,24.11.2024,13,221,235,14,3055
143,26,11,13.11.2024,5,212,224,12,1120
811,27,22,29.11.2024,6,93,137,44,822
223,4,1,13.11.2024,16,92,111,19,1776
23,16,13,06.11.2024,10,418,600,182,6000
285,8,7,16.11.2024,20,367,457,90,9140
971,28,6,16.11.2024,2,190,208,18,416
976,11,23,16.11.2024,20,159,184,25,3680
966,16,26,07.11.2024,14,255,378,123,5292
647,6,11,21.11.2024,10,348,433,85,4330
125,20,5,17.11.2024,10,184,224,40,2240
706,28,5,12.11.2024,19,486,524,38,9956
458,12,14,08.11.2024,7,473,644,171,4508
932,28,29,11.11.2024,16,398,517,119,8272
592,26,11,23.11.2024,7,453,672,219,4704
801,21,19,30.11.2024,8,360,477,117,3816
833,27,8,16.11.2024,19,245,260,15,4940
524,29,4,13.11.2024,5,319,347,28,1735
503,15,20,29.11.2024,9,52,64,12,576
198,26,25,09.11.2024,5,195,272,77,1360
486,8,8,21.11.2024,1,177,252,75,252
495,18,5,26.11.2024,9,479,608,129,5472
322,20,29,18.11.2024,7,416,557,141,3899
981,30,20,20.11.2024,4,162,174,12,696
907,7,17,26.11.2024,17,156,219,63,3723
434,23,27,28.11.2024,1,163,186,23,186
304,1,1,21.11.2024,14,58,73,15,1022
932,5,15,21.11.2024,13,287,377,90,4901
777,11,4,30.11.2024,9,239,272,33,2448
622,15,10,06.11.2024,19,82,121,39,2299
127,2,28,11.11.2024,18,249,277,28,4986
852,24,13,18.11.2024,1,322,432,110,432
406,6,11,20.11.2024,2,329,393,64,786
775,19,2,29.11.2024,17,47,64,17,1088
136,16,3,30.11.2024,3,87,96,9,288
168,23,8,03.11.2024,12,487,585,98,7020
423,11,25,03.11.2024,16,212,229,17,3664
427,21,26,13.11.2024,5,283,309,26,1545
213,15,6,04.11.2024,9,129,139,10,1251
700,18,1,02.11.2024,8,250,267,17,2136
777,8,5,28.11.2024,5,260,311,51,1555
775,21,22,13.11.2024,1,265,313,48,313
25,22,23,23.11.2024,14,284,303,19,4242
604,2,7,08.11.2024,19,256,309,53,5871
83,19,29,12.11.2024,17,451,507,56,8619
218,5,18,01.11.2024,20,155,202,47,4040
524,13,6,27.11.2024,7,382,445,63,3115
201,11,29,09.11.2024,13,77,91,14,1183
30,15,20,21.11.2024,17,390,445,55,7565
116,2,13,26.11.2024,4,377,544,167,2176
205,25,19,24.11.2024,10,420,568,148,5680
908,19,27,10.11.2024,12,243,325,82,3900
236,19,29,29.11.2024,9,124,132,8,1188
13,7,27,06.11.2024,11,119,176,57,1936
398,24,11,15.11.2024,13,309,347,38,4511
504,16,18,20.11.2024,10,402,542,140,5420
961,8,3,20.11.2024,4,445,637,192,2548
635,2,28,01.11.2024,9,466,554,88,4986
391,24,19,06.11.2024,4,46,52,6,208
196,14,24,29.11.2024,12,57,70,13,840
23,10,25,02.11.2024,4,165,193,28,772
953,30,29,26.11.2024,7,78,104,26,728
976,22,26,01.11.2024,16,104,114,10,1824
743,8,15,28.11.2024,19,354,415,61,7885
24,23,19,16.11.2024,3,371,415,44,1245
67,13,22,13.11.2024,1,38,47,9,47
477,14,6,01.11.2024,19,451,606,155,11514
983,25,29,09.11.2024,10,365,417,52,4170
274,1,22,09.11.2024,7,133,166,33,1162
2,21,2,28.11.2024,19,421,525,104,9975
975,23,16,26.11.2024,8,363,503,140,4024
294,12,3,20.11.2024,12,239,302,63,3624
168,12,22,29.11.2024,12,369,477,108,5724
329,24,21,12.11.2024,14,104,127,23,1778
479,12,25,10.11.2024,5,411,570,159,2850
507,22,18,14.11.2024,12,481,524,43,6288
260,29,5,11.11.2024,12,330,413,83,4956
553,28,22,06.11.2024,2,185,270,85,540
641,5,20,11.11.2024,18,324,448,124,8064
872,26,19,05.11.2024,7,416,511,95,3577
844,14,29,04.11.2024,17,281,361,80,6137
590,1,9,30.11.2024,18,339,381,42,6858
233,22,23,26.11.2024,11,255,305,50,3355
857,26,12,18.11.2024,13,271,385,114,5005
225,19,12,24.11.2024,14,350,523,173,7322
232,21,21,15.11.2024,5,420,611,191,3055
193,23,1,29.11.2024,17,404,514,110,8738
938,3,23,10.11.2024,8,383,454,71,3632
215,18,21,04.11.2024,7,31,33,2,231
124,7,6,27.11.2024,3,52,65,13,195
122,14,12,22.11.2024,13,25,33,8,429
352,13,12,07.11.2024,10,226,297,71,2970
490,21,20,19.11.2024,2,346,515,169,1030
512,11,12,01.11.2024,9,356,512,156,4608
393,25,18,25.11.2024,4,223,293,70,1172
902,12,22,16.11.2024,1,202,300,98,300
778,29,3,16.11.2024,9,281,306,25,2754
742,27,23,21.11.2024,4,238,330,92,1320
248,20,16,02.11.2024,11,169,236,67,2596
876,15,7,20.11.2024,14,66,89,23,1246
608,28,22,25.11.2024,1,469,586,117,586
515,6,15,09.11.2024,19,206,303,97,5757
670,24,2,09.11.2024,19,76,98,22,1862
179,29,15,10.11.2024,6,39,52,13,312
437,4,22,05.11.2024,3,116,147,31,441
6,13,25,24.11.2024,6,391,418,27,2508
188,8,11,28.11.2024,19,426,491,65,9329
456,26,23,30.11.2024,4,69,76,7,304
759,20,19,01.11.2024,15,258,363,105,5445
441,1,23,17.11.2024,12,325,356,31,4272
486,2,9,14.11.2024,18,357,386,29,6948
90,9,29,22.11.2024,12,248,317,69,3804
250,30,30,29.11.2024,5,78,88,10,440
585,6,22,07.11.2024,15,337,436,99,6540
571,9,16,03.11.2024,6,299,330,31,1980
41,8,7,05.11.2024,10,84,115,31,1150
12,12,2,17.11.2024,1,74,100,26,100
600,17,1,10.11.2024,5,173,201,28,1005
492,26,7,07.11.2024,16,250,286,36,4576
177,13,18,21.11.2024,18,432,468,36,8424
684,5,28,17.11.2024,5,433,468,35,2340
526,3,19,06.11.2024,8,321,397,76,3176
641,12,8,27.11.2024,9,215,299,84,2691
44,28,11,25.11.2024,13,33,45,12,585
954,12,13,15.11.2024,20,421,485,64,9700
930,5,16,20.11.2024,17,447,599,152,10183
774,21,6,08.11.2024,20,270,344,74,6880
77,14,20,01.11.2024,14,52,56,4,784
914,25,5,25.11.2024,2,197,242,45,484
476,21,26,30.11.2024,11,166,214,48,2354
335,30,10,28.11.2024,16,265,325,60,5200
893,27,23,19.11.2024,18,463,613,150,11034
677,26,19,05.11.2024,16,182,247,65,3952
999,11,18,17.11.2024,20,323,376,53,7520
275,30,9,28.11.2024,10,305,352,47,3520
950,29,11,30.11.2024,8,292,352,60,2816
314,7,27,11.11.2024,17,345,405,60,6885
613,14,22,22.11.2024,7,389,564,175,3948
143,26,25,23.11.2024,10,111,151,40,1510
730,18,18,11.11.2024,7,403,529,126,3703
178,4,24,24.11.2024,10,327,373,46,3730
809,21,27,11.11.2024,6,446,631,185,3786
384,8,13,16.11.2024,9,468,588,120,5292
350,5,9,20.11.2024,3,141,210,69,630
833,18,13,01.11.2024,3,111,163,52,489
951,16,15,30.11.2024,18,300,353,53,6354
582,14,7,09.11.2024,2,491,655,164,1310
502,20,4,16.11.2024,14,206,227,21,3178
186,4,12,25.11.2024,2,40,43,3,86
111,18,18,09.11.2024,5,396,581,185,2905
704,14,7,02.11.2024,19,49,54,5,1026
640,24,9,10.11.2024,14,136,156,20,2184
619,19,25,09.11.2024,18,190,219,29,3942
24,18,19,11.11.2024,8,102,152,50,1216
393,7,18,20.11.2024,1,478,522,44,522
759,20,9,26.11.2024,16,80,93,13,1488
417,8,8,15.11.2024,20,100,112,12,2240
226,9,4,01.11.2024,8,342,426,84,3408
882,20,28,13.11.2024,15,122,134,12,2010
84,14,23,15.11.2024,15,92,134,42,2010
872,20,25,13.11.2024,1,280,328,48,328
903,22,16,14.11.2024,17,184,195,11,3315
520,20,13,27.11.2024,15,311,379,68,5685
721,3,20,27.11.2024,13,101,124,23,1612
224,11,12,13.11.2024,9,139,165,26,1485
237,13,20,29.11.2024,16,481,654,173,10464
577,8,21,23.11.2024,3,237,334,97,1002
399,19,12,12.11.2024,13,30,37,7,481
457,30,14,03.11.2024,14,142,164,22,2296
376,30,9,16.11.2024,6,101,145,44,870
661,17,20,17.11.2024,7,426,635,209,4445
374,2,25,08.11.2024,3,359,403,44,1209
631,23,18,02.11.2024,9,58,85,27,765
464,5,10,05.11.2024,14,154,225,71,3150
235,14,10,06.11.2024,17,52,75,23,1275
636,2,19,21.11.2024,6,158,200,42,1200
434,29,6,08.11.2024,1,408,464,56,464
730,3,3,25.11.2024,4,149,209,60,836
547,4,25,15.11.2024,18,385,530,145,9540
157,18,30,06.11.2024,8,398,476,78,3808
176,25,9,17.11.2024,1,260,378,118,378
404,5,6,02.11.2024,16,95,105,10,1680
883,20,27,12.11.2024,19,396,498,102,9462
466,6,23,04.11.2024,8,98,129,31,1032
44,3,13,05.11.2024,1,158,203,45,203
502,22,25,13.11.2024,18,280,345,65,6210
538,15,21,17.11.2024,12,397,521,124,6252
858,24,13,25.11.2024,9,271,335,64,3015
516,28,16,05.11.2024,2,119,157,38,314
377,27,10,04.11.2024,20,454,555,101,11100
307,12,1,11.11.2024,16,115,122,7,1952
446,25,21,25.11.2024,5,236,310,74,1550
777,24,5,21.11.2024,10,210,234,24,2340
923,8,29,15.11.2024,9,254,320,66,2880
477,12,29,07.11.2024,15,83,122,39,1830
252,5,29,21.11.2024,4,162,174,12,696
477,30,13,29.11.2024,14,58,68,10,952
841,17,18,16.11.2024,2,468,675,207,1350
491,3,12,11.11.2024,7,169,216,47,1512
12,4,5,24.11.2024,18,149,159,10,2862
224,21,17,12.11.2024,1,235,282,47,282
628,15,12,20.11.2024,11,157,168,11,1848
530,19,4,29.11.2024,15,384,478,94,7170
527,2,22,25.11.2024,18,370,482,112,8676
69,5,30,27.11.2024,13,178,245,67,3185
750,24,21,09.11.2024,5,88,129,41,645
96,20,13,09.11.2024,13,126,134,8,1742
13,5,7,14.11.2024,19,113,159,46,3021
905,5,14,18.11.2024,19,142,208,66,3952
1,3,6,28.11.2024,2,147,187,40,374
68,8,15,30.11.2024,6,464,590,126,3540
82,22,15,26.11.2024,11,316,471,155,5181
872,16,9,19.11.2024,18,283,412,129,7416
760,11,21,22.11.2024,11,273,368,95,4048
856,23,19,17.11.2024,9,407,570,163,5130
252,8,27,01.11.2024,14,252,302,50,4228
522,10,16,24.11.2024,13,45,59,14,767
821,28,9,04.11.2024,5,286,410,124,2050
225,29,8,15.11.2024,5,465,634,169,3170
518,12,14,24.11.2024,13,221,265,44,3445
84,8,6,20.11.2024,16,475,641,166,10256
794,11,30,29.11.2024,2,229,325,96,650
158,14,16,01.11.2024,11,470,519,49,5709
242,16,29,16.11.2024,13,302,373,71,4849
870,8,10,08.11.2024,20,406,488,82,9760
613,11,19,13.11.2024,3,68,74,6,222
756,1,5,18.11.2024,14,256,280,24,3920
994,26,26,23.11.2024,5,496,521,25,2605
182,2,5,10.11.2024,12,346,506,160,6072
717,12,22,19.11.2024,3,39,57,18,171
339,4,2,19.11.2024,3,494,656,162,1968
842,30,7,26.11.2024,6,451,640,189,3840
503,4,9,19.11.2024,10,315,406,91,4060
852,20,10,05.11.2024,3,242,347,105,1041
162,21,25,23.11.2024,17,66,88,22,1496
706,10,2,13.11.2024,11,339,462,123,5082
830,15,12,17.11.2024,10,161,220,59,2200
411,14,26,30.11.2024,8,401,574,173,4592
683,11,7,08.11.2024,15,91,102,11,1530
82,2,19,29.11.2024,4,91,136,45,544
130,5,24,03.11.2024,10,390,530,140,5300
594,8,23,16.11.2024,14,217,318,101,4452
685,22,18,24.11.2024,19,165,226,61,4294
918,16,21,02.11.2024,12,95,108,13,1296
68,2,2,27.11.2024,9,207,293,86,2637
475,22,13,26.11.2024,11,236,334,98,3674
764,23,14,22.11.2024,11,480,666,186,7326
889,23,6,01.11.2024,6,478,591,113,3546
499,29,11,05.11.2024,2,444,515,71,1030
619,16,9,30.11.2024,7,366,453,87,3171
790,1,21,12.11.2024,11,404,492,88,5412
3,4,16,25.11.2024,17,117,130,13,2210
697,22,28,24.11.2024,17,151,185,34,3145
542,19,20,30.11.2024,20,114,160,46,3200
749,26,2,15.11.2024,19,283,365,82,6935
774,15,2,10.11.2024,11,29,38,9,418
989,26,3,16.11.2024,14,466,681,215,9534
624,19,8,30.11.2024,11,421,484,63,5324
272,10,29,21.11.2024,2,412,557,145,1114
594,9,13,09.11.2024,1,275,294,19,294
975,27,15,08.11.2024,13,21,23,2,299
78,26,26,09.11.2024,18,411,533,122,9594
427,1,17,28.11.2024,10,389,525,136,5250
509,19,7,18.11.2024,18,158,174,16,3132
241,30,13,18.11.2024,11,105,141,36,1551
15,22,14,03.11.2024,11,330,488,158,5368
22,4,5,30.11.2024,9,101,119,18,1071
264,14,6,29.11.2024,14,118,133,15,1862
100,25,30,10.11.2024,10,499,679,180,6790
655,3,3,05.11.2024,4,429,452,23,1808
246,3,25,25.11.2024,9,483,532,49,4788
463,11,4,17.11.2024,18,243,269,26,4842
685,20,9,26.11.2024,3,191,208,17,624
181,13,26,07.11.2024,18,474,652,178,11736
933,30,20,26.11.2024,3,496,557,61,1671
351,6,17,27.11.2024,18,113,169,56,3042
776,21,12,01.11.2024,11,430,604,174,6644
443,4,26,17.11.2024,13,122,138,16,1794
653,16,25,19.11.2024,3,489,677,188,2031
855,22,30,30.11.2024,16,288,361,73,5776
330,21,12,07.11.2024,2,37,43,6,86
585,12,1,22.11.2024,12,331,410,79,4920
858,1,11,28.11.2024,15,61,87,26,1305
609,17,18,25.11.2024,4,305,385,80,1540
567,18,24,25.11.2024,11,77,110,33,1210
806,27,21,11.11.2024,8,170,241,71,1928
301,2,28,04.11.2024,2,471,635,164,1270
141,23,9,27.11.2024,13,500,588,88,7644
871,14,3,17.11.2024,12,56,67,11,804
308,14,1,01.11.2024,10,177,243,66,2430
891,5,30,17.11.2024,20,308,337,29,6740
117,4,9,25.11.2024,11,173,191,18,2101
591,7,19,26.11.2024,3,131,154,23,462
862,25,18,25.11.2024,18,458,498,40,8964
730,18,30,19.11.2024,18,163,211,48,3798
305,4,29,13.11.2024,2,170,245,75,490
96,22,11,09.11.2024,2,86,94,8,188
968,19,1,04.11.2024,16,40,57,17,912
416,18,4,09.11.2024,6,304,395,91,2370
814,8,3,11.11.2024,6,109,159,50,954
718,28,4,21.11.2024,1,246,339,93,339
130,6,24,27.11.2024,17,135,166,31,2822
698,17,29,09.11.2024,19,401,562,161,10678
193,16,18,08.11.2024,2,226,300,74,600
398,7,27,17.11.2024,10,185,228,43,2280
605,14,30,19.11.2024,10,149,198,49,1980
911,4,23,14.11.2024,9,331,422,91,3798
118,13,19,07.11.2024,9,352,461,109,4149
834,21,19,04.11.2024,8,84,89,5,712
256,24,2,24.11.2024,3,348,387,39,1161
224,9,4,19.11.2024,1,333,457,124,457
850,23,1,14.11.2024,4,184,230,46,920
151,24,21,26.11.2024,4,437,523,86,2092
421,13,22,17.11.2024,9,233,266,33,2394
651,5,7,13.11.2024,12,110,149,39,1788
970,22,8,16.11.2024,16,476,593,117,9488
259,1,14,15.11.2024,6,49,72,23,432
62,24,15,17.11.2024,10,118,130,12,1300
295,5,10,09.11.2024,6,225,237,12,1422
805,25,17,03.11.2024,19,238,283,45,5377
230,15,7,23.11.2024,9,423,627,204,5643
277,6,16,08.11.2024,15,454,481,27,7215
241,21,16,13.11.2024,8,494,641,147,5128
658,30,5,04.11.2024,9,366,471,105,4239
707,4,9,28.11.2024,17,404,560,156,9520
21,3,19,29.11.2024,4,136,160,24,640
830,8,25,22.11.2024,18,431,564,133,10152
947,17,30,06.11.2024,16,489,514,25,8224
982,1,11,25.11.2024,18,221,267,46,4806
493,7,6,04.11.2024,10,366,454,88,4540
713,26,9,19.11.2024,7,322,435,113,3045
984,20,19,19.11.2024,12,66,83,17,996
201,29,8,11.11.2024,2,432,523,91,1046
778,8,18,11.11.2024,16,129,191,62,3056
17,23,3,04.11.2024,19,450,519,69,9861
888,2,7,15.11.2024,14,277,383,106,5362
106,22,18,15.11.2024,5,126,144,18,720
380,4,2,09.11.2024,1,461,569,108,569
288,21,19,29.11.2024,15,449,490,41,7350
946,8,20,04.11.2024,3,407,572,165,1716
550,24,21,25.11.2024,8,41,56,15,448
555,6,22,25.11.2024,1,465,590,125,590
222,26,14,29.11.2024,11,68,87,19,957
235,30,19,09.11.2024,1,225,272,47,272
366,25,15,18.11.2024,6,33,36,3,216
643,19,1,22.11.2024,9,112,160,48,1440
240,24,2,24.11.2024,6,114,130,16,780
136,10,15,02.11.2024,15,128,142,14,2130
121,24,30,24.11.2024,7,196,273,77,1911
780,10,27,22.11.2024,14,94,101,7,1414
923,6,16,13.11.2024,1,102,109,7,109
180,22,27,29.11.2024,14,72,100,28,1400
217,3,5,14.11.2024,4,229,312,83,1248
171,9,23,17.11.2024,18,444,573,129,10314
923,30,19,29.11.2024,19,493,714,221,13566
162,27,20,18.11.2024,19,123,155,32,2945
177,20,27,26.11.2024,15,154,180,26,2700
220,30,24,26.11.2024,1,114,135,21,135
792,18,15,30.11.2024,3,440,485,45,1455
712,5,29,02.11.2024,8,374,482,108,3856
878,4,18,16.11.2024,13,456,599,143,7787
756,27,5,02.11.2024,17,106,154,48,2618
819,5,8,30.11.2024,2,264,349,85,698
906,3,8,18.11.2024,18,60,77,17,1386
96,9,9,11.11.2024,18,85,96,11,1728
438,16,28,27.11.2024,7,87,122,35,854
716,21,3,17.11.2024,5,320,346,26,1730
739,21,18,03.11.2024,11,241,327,86,3597
868,11,1,02.11.2024,1,394,552,158,552
708,1,28,26.11.2024,1,60,68,8,68
761,26,21,19.11.2024,3,60,68,8,204
976,26,4,15.11.2024,18,331,356,25,6408
646,24,20,01.11.2024,5,494,589,95,2945
689,4,26,30.11.2024,17,330,458,128,7786
268,6,3,18.11.2024,5,308,404,96,2020
489,10,16,17.11.2024,3,92,131,39,393
296,17,20,26.11.2024,2,171,215,44,430
520,14,15,01.11.2024,2,308,323,15,646
268,29,8,13.11.2024,12,326,355,29,4260
742,17,9,17.11.2024,5,214,280,66,1400
242,14,5,26.11.2024,9,266,397,131,3573
379,22,2,12.11.2024,10,414,581,167,5810
385,24,2,18.11.2024,2,320,344,24,688
213,8,14,20.11.2024,20,288,382,94,7640
806,1,25,20.11.2024,17,109,117,8,1989
275,26,2,30.11.2024,4,435,507,72,2028
542,4,29,18.11.2024,17,374,437,63,7429
751,9,28,21.11.2024,6,283,357,74,2142
902,30,8,17.11.2024,7,201,281,80,1967
542,21,3,13.11.2024,9,136,184,48,1656
145,23,13,20.11.2024,10,368,473,105,4730
661,22,22,24.11.2024,10,216,242,26,2420
249,29,14,25.11.2024,5,197,271,74,1355
542,14,7,04.11.2024,10,481,560,79,5600
474,28,2,27.11.2024,13,160,239,79,3107
400,6,12,25.11.2024,12,384,552,168,6624
44,6,13,26.11.2024,8,366,445,79,3560
557,22,6,10.11.2024,7,480,701,221,4907
24,22,3,16.11.2024,13,168,236,68,3068
884,10,17,19.11.2024,17,263,384,121,6528
791,8,24,04.11.2024,12,136,185,49,2220
532,6,27,09.11.2024,11,368,409,41,4499
625,27,23,02.11.2024,11,38,52,14,572
59,28,10,08.11.2024,7,460,526,66,3682
784,27,12,07.11.2024,17,144,171,27,2907
726,4,13,24.11.2024,8,407,575,168,4600
93,4,23,20.11.2024,15,273,375,102,5625
807,4,18,02.11.2024,20,488,566,78,11320
94,21,22,07.11.2024,16,124,153,29,2448
331,8,2,29.11.2024,14,430,592,162,8288
980,3,30,25.11.2024,20,385,491,106,9820
985,11,13,04.11.2024,15,481,691,210,10365
798,18,24,28.11.2024,17,448,473,25,8041
190,7,27,01.11.2024,1,301,362,61,362
425,4,18,05.11.2024,20,271,287,16,5740
705,13,11,16.11.2024,16,147,173,26,2768
611,4,24,30.11.2024,14,460,666,206,9324
697,7,13,12.11.2024,20,400,444,44,8880
60,3,10,20.11.2024,3,408,588,180,1764
655,25,19,10.11.2024,4,279,321,42,1284
407,17,16,11.11.2024,1,302,419,117,419
418,7,6,27.11.2024,6,472,624,152,3744
518,5,3,08.11.2024,15,152,183,31,2745
79,3,9,30.11.2024,2,354,508,154,1016
302,5,17,18.11.2024,14,472,504,32,7056
376,21,1,25.11.2024,11,134,197,63,2167
439,14,26,24.11.2024,2,269,294,25,588
765,5,14,25.11.2024,1,471,694,223,694
896,2,17,29.11.2024,7,193,238,45,1666
623,3,27,28.11.2024,1,205,279,74,279
75,11,24,07.11.2024,4,477,666,189,2664
261,29,11,12.11.2024,2,412,527,115,1054
188,14,19,04.11.2024,16,321,407,86,6512
782,18,21,29.11.2024,5,318,475,157,2375
852,9,10,24.11.2024,2,76,90,14,180
568,1,26,17.11.2024,15,395,475,80,7125
244,16,28,22.11.2024,18,374,481,107,8658
418,2,7,08.11.2024,12,315,348,33,4176
105,22,12,15.11.2024,1,311,333,22,333
378,19,19,23.11.2024,3,406,478,72,1434
187,30,1,23.11.2024,15,496,651,155,9765
170,13,25,20.11.2024,19,319,425,106,8075
786,20,19,26.11.2024,13,437,589,152,7657
851,18,21,20.11.2024,20,378,512,134,10240
780,28,15,03.11.2024,17,162,209,47,3553
375,19,13,21.11.2024,19,139,167,28,3173
106,10,1,25.11.2024,17,446,582,136,9894
812,28,7,06.11.2024,7,72,103,31,721
827,27,8,10.11.2024,5,393,488,95,2440
578,18,2,14.11.2024,20,356,532,176,10640
485,5,13,21.11.2024,4,239,296,57,1184
914,1,21,15.11.2024,6,380,452,72,2712
966,24,8,17.11.2024,20,126,170,44,3400
617,30,12,21.11.2024,8,451,580,129,4640
674,29,18,25.11.2024,1,421,628,207,628
848,1,29,12.11.2024,14,446,492,46,6888
146,29,23,19.11.2024,20,228,243,15,4860
824,28,26,05.11.2024,13,303,368,65,4784
693,5,14,22.11.2024,9,65,84,19,756
587,13,12,14.11.2024,3,463,532,69,1596
576,16,26,14.11.2024,4,343,465,122,1860
150,25,7,26.11.2024,17,171,205,34,3485
946,25,4,09.11.2024,7,393,483,90,3381
153,8,19,26.11.2024,10,428,502,74,5020
921,2,28,01.11.2024,6,250,287,37,1722
7,22,28,17.11.2024,14,308,449,141,6286
399,3,2,04.11.2024,13,262,284,22,3692
685,7,27,20.11.2024,11,415,590,175,6490
27,2,3,13.11.2024,17,47,63,16,1071
83,10,21,20.11.2024,3,432,516,84,1548
465,14,25,06.11.2024,17,114,150,36,2550
454,21,14,21.11.2024,5,44,54,10,270
653,9,9,01.11.2024,16,232,305,73,4880
401,6,2,23.11.2024,15,445,613,168,9195
782,28,14,22.11.2024,5,306,369,63,1845
569,26,3,24.11.2024,16,368,523,155,8368
945,13,30,02.11.2024,6,291,428,137,2568
69,25,25,09.11.2024,1,211,271,60,271
547,9,3,07.11.2024,7,117,135,18,945
960,5,30,11.11.2024,12,363,409,46,4908
354,30,13,04.11.2024,15,281,306,25,4590
11,7,28,29.11.2024,6,345,375,30,2250
168,1,13,04.11.2024,8,380,440,60,3520
526,22,11,05.11.2024,15,258,337,79,5055
354,13,4,07.11.2024,7,235,341,106,2387
559,10,10,09.11.2024,19,44,65,21,1235
886,19,11,02.11.2024,5,435,514,79,2570
45,27,4,14.11.2024,9,157,168,11,1512
463,7,22,09.11.2024,4,211,273,62,1092
950,5,29,15.11.2024,16,340,383,43,6128
192,3,1,27.11.2024,6,327,472,145,2832
916,27,19,18.11.2024,6,69,79,10,474
532,30,14,06.11.2024,19,282,390,108,7410
504,26,24,22.11.2024,20,230,320,90,6400
888,27,8,28.11.2024,18,137,151,14,2718
528,6,18,22.11.2024,11,216,260,44,2860
587,25,15,24.11.2024,1,257,351,94,351
558,24,21,14.11.2024,13,347,519,172,6747
465,16,23,02.11.2024,13,433,552,119,7176
922,13,17,25.11.2024,5,433,458,25,2290
783,1,13,18.11.2024,5,60,86,26,430
185,8,21,12.11.2024,11,343,374,31,4114
403,22,28,22.11.2024,12,27,33,6,396
459,30,4,22.11.2024,9,214,240,26,2160
75,17,21,25.11.2024,6,55,72,17,432
336,19,13,15.11.2024,20,478,622,144,12440
548,25,22,09.11.2024,8,226,300,74,2400
296,26,18,28.11.2024,1,477,529,52,529
941,2,28,11.11.2024,2,477,649,172,1298
236,22,27,18.11.2024,14,488,644,156,9016
709,9,17,10.11.2024,5,163,216,53,1080
867,24,20,17.11.2024,18,322,432,110,7776
291,12,15,21.11.2024,18,264,391,127,7038
770,30,2,23.11.2024,15,64,94,30,1410
241,29,18,13.11.2024,15,207,236,29,3540
788,22,6,01.11.2024,20,237,289,52,5780
80,20,3,24.11.2024,15,258,332,74,4980
394,18,5,28.11.2024,20,296,369,73,7380
510,23,28,05.11.2024,5,174,227,53,1135
506,24,2,26.11.2024,18,173,222,49,3996
409,21,6,22.11.2024,8,197,268,71,2144
905,1,22,29.11.2024,12,383,469,86,5628
746,20,11,22.11.2024,15,293,312,19,4680
128,6,9,29.11.2024,18,104,145,41,2610
873,12,9,09.11.2024,6,468,575,107,3450
608,13,7,05.11.2024,12,417,552,135,6624
191,21,8,21.11.2024,5,348,481,133,2405
868,9,26,13.11.2024,8,436,496,60,3968
984,29,30,19.11.2024,4,183,206,23,824
82,22,22,30.11.2024,11,110,153,43,1683
740,30,16,06.11.2024,11,207,307,100,3377
176,13,19,08.11.2024,8,185,245,60,1960
703,12,4,08.11.2024,17,71,97,26,1649
379,12,1,21.11.2024,16,269,398,129,6368
973,28,18,11.11.2024,1,313,435,122,435
792,22,10,27.11.2024,9,128,145,17,1305
644,20,4,29.11.2024,17,416,450,34,7650
853,4,30,16.11.2024,20,252,270,18,5400
535,27,23,11.11.2024,19,133,188,55,3572
89,27,12,07.11.2024,13,168,201,33,2613
465,4,11,27.11.2024,11,117,134,17,1474
178,12,20,29.11.2024,7,412,521,109,3647
867,17,4,08.11.2024,14,235,280,45,3920
17,20,9,28.11.2024,5,355,475,120,2375
112,10,25,26.11.2024,3,37,45,8,135
468,13,20,17.11.2024,4,354,455,101,1820
575,2,20,24.11.2024,5,384,404,20,2020
370,5,8,28.11.2024,17,273,392,119,6664
357,13,6,29.11.2024,5,469,610,141,3050
935,26,25,14.11.2024,14,48,57,9,798
792,19,17,14.11.2024,15,279,328,49,4920
884,6,5,16.11.2024,11,265,395,130,4345
915,22,9,18.11.2024,11,372,461,89,5071
373,26,28,11.11.2024,20,158,202,44,4040
312,20,30,04.11.2024,3,410,509,99,1527
341,1,5,30.11.2024,1,444,474,30,474
821,10,12,21.11.2024,8,301,436,135,3488
75,8,5,21.11.2024,4,404,582,178,2328
71,7,1,11.11.2024,11,251,322,71,3542
649,21,14,18.11.2024,6,347,409,62,2454
292,28,17,17.11.2024,20,204,268,64,5360
734,16,5,16.11.2024,8,223,324,101,2592
808,15,24,10.11.2024,14,92,97,5,1358
376,28,17,24.11.2024,6,461,544,83,3264
973,3,17,07.11.2024,6,360,508,148,3048
109,24,5,07.11.2024,3,81,107,26,321
900,27,21,01.11.2024,10,320,344,24,3440
757,1,29,03.11.2024,17,137,161,24,2737
164,7,23,18.11.2024,15,186,239,53,3585
786,16,13,17.11.2024,3,339,383,44,1149
186,29,12,16.11.2024,15,174,241,67,3615
372,18,21,09.11.2024,16,85,95,10,1520
585,2,11,05.11.2024,20,63,90,27,1800
876,22,24,15.11.2024,13,452,587,135,7631
748,4,13,02.11.2024,18,437,600,163,10800
984,4,21,16.11.2024,6,50,69,19,414
204,15,26,23.11.2024,7,464,625,161,4375
990,6,27,30.11.2024,1,176,199,23,199
591,19,30,20.11.2024,7,376,544,168,3808
979,4,24,14.11.2024,11,335,441,106,4851
656,10,8,18.11.2024,18,89,129,40,2322
333,21,12,23.11.2024,8,399,572,173,4576
554,7,11,18.11.2024,10,148,164,16,1640
743,21,15,24.11.2024,16,125,177,52,2832
297,8,1,19.11.2024,11,145,169,24,1859
831,25,16,20.11.2024,4,107,133,26,532
845,28,28,19.11.2024,15,21,28,7,420
451,3,6,02.11.2024,11,138,201,63,2211
480,25,17,30.11.2024,16,365,418,53,6688
725,29,27,11.11.2024,5,298,388,90,1940
937,17,8,05.11.2024,5,33,45,12,225
996,4,5,26.11.2024,12,211,296,85,3552
884,2,18,07.11.2024,6,38,41,3,246
780,18,16,20.11.2024,15,269,344,75,5160
583,15,12,22.11.2024,7,353,485,132,3395
900,12,22,17.11.2024,12,109,145,36,1740
404,30,2,26.11.2024,2,117,137,20,274
310,8,30,13.11.2024,3,411,590,179,1770
588,11,4,15.11.2024,3,187,269,82,807
977,7,28,24.11.2024,19,451,650,199,12350
24,25,5,21.11.2024,19,100,147,47,2793
965,19,24,12.11.2024,1,64,73,9,73
284,21,28,24.11.2024,17,113,149,36,2533
202,30,1,19.11.2024,14,496,540,44,7560
704,19,16,03.11.2024,20,484,540,56,10800
50,21,5,24.11.2024,5,75,85,10,425
888,22,30,23.11.2024,15,217,301,84,4515
143,2,4,20.11.2024,3,76,92,16,276
108,5,30,06.11.2024,2,78,107,29,214
458,5,24,11.11.2024,17,385,565,180,9605
203,30,20,24.11.2024,7,38,49,11,343
442,13,11,07.11.2024,18,26,30,4,540
667,29,22,26.11.2024,10,393,431,38,4310
783,26,10,06.11.2024,4,63,67,4,268
572,22,13,21.11.2024,17,87,105,18,1785
9,19,22,11.11.2024,5,92,109,17,545
132,1,27,27.11.2024,19,113,162,49,3078
991,12,24,13.11.2024,3,409,565,156,1695
2,26,30,07.11.2024,19,306,339,33,6441
712,19,16,27.11.2024,1,393,453,60,453
465,4,5,09.11.2024,7,223,271,48,1897
335,18,12,13.11.2024,10,386,428,42,4280
867,1,9,03.11.2024,5,32,48,16,240
953,2,14,04.11.2024,12,315,398,83,4776
571,16,9,02.11.2024,6,308,331,23,1986
737,24,3,14.11.2024,14,434,460,26,6440
234,5,5,28.11.2024,10,275,406,131,4060
110,11,11,09.11.2024,6,417,567,150,3402
658,1,8,23.11.2024,10,36,38,2,380
18,20,12,30.11.2024,13,479,625,146,8125
787,21,15,12.11.2024,14,449,533,84,7462
67,12,15,19.11.2024,12,199,246,47,2952
177,8,9,16.11.2024,4,86,121,35,484
473,14,1,04.11.2024,2,286,400,114,800
817,26,17,04.11.2024,2,119,169,50,338
755,26,14,18.11.2024,8,68,84,16,672
782,3,16,06.11.2024,14,268,347,79,4858
530,4,26,24.11.2024,12,235,262,27,3144
32,28,24,04.11.2024,11,358,451,93,4961
201,17,2,14.11.2024,15,69,74,5,1110
730,8,11,03.11.2024,2,410,484,74,968
994,17,9,16.11.2024,10,116,142,26,1420
117,23,7,01.11.2024,1,291,330,39,330
545,28,17,22.11.2024,12,234,320,86,3840
611,9,16,01.11.2024,7,78,82,4,574
204,22,26,28.11.2024,7,311,349,38,2443
830,30,15,30.11.2024,9,422,613,191,5517
448,27,5,03.11.2024,12,301,387,86,4644
851,5,23,28.11.2024,16,29,31,2,496
273,13,14,14.11.2024,4,169,203,34,812
604,1,25,03.11.2024,4,44,58,14,232
683,15,4,30.11.2024,9,38,53,15,477
269,19,8,18.11.2024,18,53,72,19,1296
776,23,28,23.11.2024,9,296,352,56,3168
684,23,3,11.11.2024,6,40,53,13,318
514,2,26,19.11.2024,10,330,436,106,4360
509,30,30,13.11.2024,20,274,348,74,6960
230,21,3,07.11.2024,15,303,412,109,6180
834,14,13,20.11.2024,18,380,416,36,7488
930,13,4,05.11.2024,7,253,374,121,2618
497,16,19,09.11.2024,8,132,149,17,1192
331,14,6,07.11.2024,17,341,450,109,7650
597,19,30,04.11.2024,20,234,247,13,4940
729,27,30,09.11.2024,6,444,636,192,3816
979,22,5,01.11.2024,7,244,313,69,2191
840,29,18,28.11.2024,6,71,87,16,522
862,6,22,22.11.2024,1,323,435,112,435
266,4,28,30.11.2024,18,473,667,194,12006
241,12,22,23.11.2024,20,294,388,94,7760
907,25,19,15.11.2024,5,451,490,39,2450
456,1,24,27.11.2024,18,262,344,82,6192
297,30,22,17.11.2024,1,411,590,179,590
994,18,30,13.11.2024,9,166,185,19,1665
777,4,15,29.11.2024,12,271,374,103,4488
239,19,15,17.11.2024,12,230,243,13,2916
177,2,26,01.11.2024,9,279,346,67,3114
328,16,22,03.11.2024,6,424,518,94,3108
88,10,20,13.11.2024,3,387,523,136,1569
957,6,17,29.11.2024,16,344,452,108,7232
811,6,20,22.11.2024,14,289,369,80,5166
475,24,25,13.11.2024,19,473,639,166,12141
869,16,22,21.11.2024,2,148,195,47,390
235,23,4,09.11.2024,3,399,495,96,1485
364,14,2,16.11.2024,18,328,371,43,6678
291,22,29,26.11.2024,18,288,346,58,6228
387,12,4,25.11.2024,15,299,429,130,6435
675,22,21,13.11.2024,6,161,172,11,1032
620,30,14,23.11.2024,10,421,513,92,5130
560,8,24,09.11.2024,20,226,264,38,5280
524,10,5,03.11.2024,15,26,33,7,495
105,13,5,06.11.2024,12,298,346,48,4152
646,14,9,18.11.2024,18,80,102,22,1836
588,26,25,08.11.2024,9,277,357,80,3213
514,8,20,02.11.2024,14,86,100,14,1400
492,5,25,17.11.2024,15,309,334,25,5010
23,20,27,03.11.2024,3,164,188,24,564
850,4,19,29.11.2024,8,192,266,74,2128
615,21,27,06.11.2024,7,363,399,36,2793
219,16,24,14.11.2024,1,184,274,90,274
45,30,9,11.11.2024,18,265,326,61,5868
799,27,23,01.11.2024,6,193,286,93,1716
769,10,16,05.11.2024,9,80,87,7,783
326,21,2,28.11.2024,7,355,416,61,2912
807,19,14,13.11.2024,3,246,340,94,1020
919,30,30,24.11.2024,3,391,433,42,1299
265,20,18,19.11.2024,18,323,418,95,7524
980,30,24,01.11.2024,13,242,314,72,4082
100,9,3,15.11.2024,9,219,313,94,2817
108,26,8,27.11.2024,11,319,467,148,5137
642,13,9,18.11.2024,14,316,408,92,5712
825,30,8,23.11.2024,19,210,279,69,5301
451,10,30,17.11.2024,13,292,397,105,5161
888,3,11,11.11.2024,19,145,173,28,3287
676,2,4,04.11.2024,20,85,112,27,2240
185,2,28,22.11.2024,16,497,577,80,9232
952,13,29,23.11.2024,2,189,204,15,408
81,14,22,24.11.2024,2,129,170,41,340
771,25,18,26.11.2024,13,119,142,23,1846
421,23,21,05.11.2024,4,267,312,45,1248
382,20,2,13.11.2024,16,24,25,1,400
672,21,19,10.11.2024,5,163,243,80,1215
257,6,2,10.11.2024,13,499,678,179,8814
281,26,29,24.11.2024,18,314,391,77,7038
421,2,11,26.11.2024,14,146,154,8,2156
810,30,10,11.11.2024,14,435,553,118,7742
454,11,18,29.11.2024,1,294,412,118,412
316,25,11,08.11.2024,7,395,558,163,3906
30,14,5,08.11.2024,12,144,177,33,2124
391,26,5,28.11.2024,6,390,468,78,2808
297,2,4,13.11.2024,11,310,374,64,4114
948,2,1,23.11.2024,14,97,110,13,1540
180,5,10,06.11.2024,15,226,326,100,4890
711,22,16,10.11.2024,13,84,101,17,1313
69,13,1,04.11.2024,3,105,144,39,432
103,3,12,30.11.2024,17,411,478,67,8126
817,17,21,13.11.2024,2,23,33,10,66
550,1,4,16.11.2024,19,268,329,61,6251
729,16,18,05.11.2024,7,440,496,56,3472
610,29,12,15.11.2024,1,467,548,81,548
139,23,14,26.11.2024,9,429,574,145,5166
436,3,5,24.11.2024,4,461,496,35,1984
542,9,8,24.11.2024,16,184,229,45,3664
714,19,24,13.11.2024,18,43,56,13,1008
998,27,21,06.11.2024,12,492,727,235,8724
180,10,5,04.11.2024,18,353,408,55,7344
333,29,9,12.11.2024,9,43,58,15,522
440,9,10,21.11.2024,12,157,198,41,2376
758,5,28,07.11.2024,3,73,108,35,324
158,30,23,15.11.2024,10,389,517,128,5170
755,24,16,22.11.2024,20,372,555,183,11100
462,15,29,25.11.2024,13,387,448,61,5824
301,21,21,22.11.2024,6,255,271,16,1626
889,27,18,18.11.2024,13,349,495,146,6435
920,16,12,23.11.2024,1,334,360,26,360
868,3,20,26.11.2024,13,482,685,203,8905
262,11,23,21.11.2024,7,36,48,12,336
812,8,11,24.11.2024,18,261,292,31,5256
640,29,8,11.11.2024,8,443,467,24,3736
879,30,28,23.11.2024,4,267,366,99,1464
406,15,16,17.11.2024,10,267,288,21,2880
436,12,6,09.11.2024,9,142,192,50,1728
369,9,9,14.11.2024,2,416,477,61,954
548,29,12,23.11.2024,3,248,330,82,990
462,23,26,18.11.2024,4,27,37,10,148
774,30,26,24.11.2024,11,136,179,43,1969
151,18,15,17.11.2024,17,337,487,150,8279
753,13,26,20.11.2024,19,298,445,147,8455
541,17,25,05.11.2024,20,49,74,25,1480
323,16,19,23.11.2024,5,422,463,41,2315
860,15,22,05.11.2024,9,201,214,13,1926
92,28,24,20.11.2024,18,379,463,84,8334
259,6,9,05.11.2024,7,419,563,144,3941
607,15,6,17.11.2024,8,134,189,55,1512
155,4,21,22.11.2024,18,260,319,59,5742
837,6,29,19.11.2024,7,492,631,139,4417
528,30,2,23.11.2024,19,287,329,42,6251
150,4,2,27.11.2024,4,27,31,4,124
911,1,1,03.11.2024,17,205,256,51,4352
118,2,30,01.11.2024,17,424,559,135,9503
889,18,30,26.11.2024,16,363,401,38,6416
561,3,27,10.11.2024,7,199,280,81,1960
296,2,30,24.11.2024,8,451,532,81,4256
327,21,8,21.11.2024,3,303,421,118,1263
806,16,9,14.11.2024,18,328,373,45,6714
317,14,28,19.11.2024,11,419,589,170,6479
36,1,7,24.11.2024,1,239,332,93,332
938,6,1,12.11.2024,9,473,699,226,6291
603,13,15,27.11.2024,3,179,261,82,783
48,14,14,29.11.2024,13,223,243,20,3159
14,29,21,13.11.2024,12,164,178,14,2136
93,23,27,29.11.2024,8,494,519,25,4152
458,18,11,04.11.2024,13,315,461,146,5993
606,9,25,20.11.2024,16,40,53,13,848
377,25,18,25.11.2024,7,226,294,68,2058
302,18,5,13.11.2024,18,368,480,112,8640
415,6,13,20.11.2024,15,397,511,114,7665
553,14,18,18.11.2024,17,451,588,137,9996
484,17,22,22.11.2024,16,395,428,33,6848
32,12,26,19.11.2024,14,107,134,27,1876
80,19,15,29.11.2024,13,31,41,10,533
130,1,3,05.11.2024,14,443,617,174,8638
368,15,28,21.11.2024,17,297,423,126,7191
192,13,1,10.11.2024,3,286,301,15,903
967,29,19,12.11.2024,5,472,662,190,3310
370,11,17,11.11.2024,4,241,303,62,1212
724,3,22,24.11.2024,5,254,311,57,1555
190,26,3,04.11.2024,18,343,489,146,8802
565,5,9,03.11.2024,20,362,446,84,8920
142,14,9,06.11.2024,6,88,129,41,774
343,17,19,03.11.2024,15,46,62,16,930
936,29,9,24.11.2024,12,148,164,16,1968
844,18,12,22.11.2024,10,199,284,85,2840
47,11,14,25.11.2024,17,81,115,34,1955
145,5,28,28.11.2024,12,259,271,12,3252
589,1,24,02.11.2024,3,323,372,49,1116
722,29,11,14.11.2024,9,476,599,123,5391
217,27,5,09.11.2024,16,496,633,137,10128
942,18,20,11.11.2024,9,22,24,2,216
533,21,30,27.11.2024,17,108,147,39,2499
735,15,8,03.11.2024,5,497,538,41,2690
965,30,18,30.11.2024,12,23,25,2,300
806,12,18,21.11.2024,2,64,84,20,168
999,1,20,06.11.2024,15,445,489,44,7335
836,22,3,11.11.2024,6,225,312,87,1872
45,24,12,08.11.2024,15,46,60,14,900
205,2,2,15.11.2024,3,409,538,129,1614
697,1,1,16.11.2024,9,455,648,193,5832
670,3,29,17.11.2024,19,397,517,120,9823
336,23,10,08.11.2024,5,403,518,115,2590
424,19,18,19.11.2024,7,435,538,103,3766
135,20,9,09.11.2024,16,388,479,91,7664
751,3,20,26.11.2024,17,464,692,228,11764
208,26,10,26.11.2024,18,60,87,27,1566
743,25,3,02.11.2024,9,180,201,21,1809
794,18,22,20.11.2024,13,126,143,17,1859
480,29,10,07.11.2024,12,230,296,66,3552
903,27,8,11.11.2024,5,222,239,17,1195
883,9,18,14.11.2024,2,378,473,95,946
603,18,8,23.11.2024,9,448,658,210,5922
516,7,18,10.11.2024,6,173,199,26,1194
944,26,30,21.11.2024,10,215,239,24,2390
49,11,11,02.11.2024,15,412,604,192,9060
722,2,13,12.11.2024,15,318,384,66,5760
373,13,6,07.11.2024,19,108,153,45,2907
609,2,18,30.11.2024,11,453,542,89,5962
44,16,21,23.11.2024,10,371,500,129,5000
615,4,29,08.11.2024,4,477,714,237,2856
474,25,17,13.11.2024,4,308,419,111,1676
146,11,26,10.11.2024,15,347,373,26,5595
720,6,6,21.11.2024,1,215,286,71,286
942,8,11,27.11.2024,9,355,386,31,3474
182,1,29,03.11.2024,5,107,156,49,780
804,26,29,19.11.2024,12,439,472,33,5664
162,28,14,25.11.2024,2,58,64,6,128
220,28,24,30.11.2024,6,455,549,94,3294
818,21,22,22.11.2024,19,145,193,48,3667
633,11,2,15.11.2024,10,41,59,18,590
103,25,15,23.11.2024,7,425,535,110,3745
564,2,30,12.11.2024,19,344,460,116,8740
936,8,22,25.11.2024,3,43,64,21,192
295,22,20,07.11.2024,10,391,413,22,4130
707,29,19,04.11.2024,1,153,170,17,170
33,29,7,14.11.2024,2,263,359,96,718
779,10,3,03.11.2024,18,164,217,53,3906
97,8,21,11.11.2024,20,316,357,41,7140
559,12,12,25.11.2024,8,456,620,164,4960
349,5,2,12.11.2024,13,54,58,4,754
987,16,19,19.11.2024,1,329,405,76,405
439,30,30,27.11.2024,18,48,62,14,1116
735,15,16,09.11.2024,2,394,572,178,1144
491,17,9,23.11.2024,5,364,539,175,2695
679,7,19,28.11.2024,10,167,228,61,2280
384,28,8,01.11.2024,1,208,262,54,262
777,28,28,06.11.2024,11,177,204,27,2244
649,12,27,01.11.2024,3,257,383,126,1149
321,9,5,29.11.2024,13,108,119,11,1547
551,9,6,19.11.2024,2,321,433,112,866
587,23,25,05.11.2024,8,399,474,75,3792
877,4,3,01.11.2024,2,294,394,100,788
914,14,27,22.11.2024,2,191,201,10,402
783,18,18,30.11.2024,14,265,307,42,4298
156,29,29,04.11.2024,3,204,255,51,765
814,5,20,30.11.2024,1,155,210,55,210
981,30,30,15.11.2024,11,382,572,190,6292
570,26,18,15.11.2024,11,431,620,189,6820
90,6,19,24.11.2024,19,390,464,74,8816
405,2,8,27.11.2024,8,221,312,91,2496
184,26,1,29.11.2024,5,240,290,50,1450
192,3,9,15.11.2024,15,447,609,162,9135
130,1,30,15.11.2024,4,64,77,13,308
166,8,23,25.11.2024,18,23,26,3,468
718,6,4,21.11.2024,20,368,415,47,8300
362,30,30,17.11.2024,4,271,395,124,1580
741,1,22,12.11.2024,19,65,72,7,1368
115,17,14,07.11.2024,18,198,257,59,4626
84,24,19,29.11.2024,11,293,369,76,4059
997,16,6,23.11.2024,4,203,261,58,1044
726,2,25,25.11.2024,11,460,582,122,6402
784,26,23,20.11.2024,7,52,78,26,546
624,5,17,30.11.2024,19,250,282,32,5358
522,9,11,29.11.2024,10,436,586,150,5860
527,5,6,24.11.2024,16,98,105,7,1680
565,7,20,10.11.2024,18,81,119,38,2142
235,5,22,05.11.2024,2,141,166,25,332
499,9,21,07.11.2024,5,464,667,203,3335
766,4,3,14.11.2024,12,297,407,110,4884
718,1,22,05.11.2024,1,81,108,27,108
52,9,30,23.11.2024,5,125,139,14,695
735,15,16,12.11.2024,5,354,388,34,1940
382,23,7,02.11.2024,5,262,324,62,1620
908,2,14,09.11.2024,13,115,155,40,2015
845,2,12,23.11.2024,20,131,186,55,3720
468,15,12,13.11.2024,19,66,85,19,1615
136,25,3,22.11.2024,1,333,498,165,498
92,14,22,29.11.2024,3,245,299,54,897
623,2,28,06.11.2024,19,380,489,109,9291
123,26,1,09.11.2024,8,424,587,163,4696
841,9,3,20.11.2024,13,208,233,25,3029
84,26,28,07.11.2024,4,222,234,12,936
58,12,13,18.11.2024,12,485,600,115,7200
993,30,13,15.11.2024,2,204,278,74,556
953,5,3,19.11.2024,17,406,492,86,8364
62,10,19,10.11.2024,9,164,175,11,1575
989,14,13,07.11.2024,10,310,352,42,3520
231,19,14,12.11.2024,1,165,218,53,218
172,15,7,05.11.2024,6,205,255,50,1530
855,4,3,10.11.2024,5,143,200,57,1000
682,5,30,27.11.2024,11,472,613,141,6743
329,9,22,05.11.2024,4,346,496,150,1984
652,29,2,18.11.2024,16,476,627,151,10032
704,20,4,24.11.2024,20,467,521,54,10420
246,24,10,30.11.2024,3,336,439,103,1317
390,9,8,07.11.2024,18,183,211,28,3798
138,24,10,15.11.2024,6,447,603,156,3618
374,18,8,08.11.2024,8,145,166,21,1328
835,2,26,23.11.2024,8,57,78,21,624
375,28,22,17.11.2024,16,215,262,47,4192
737,9,12,28.11.2024,15,394,482,88,7230
707,19,22,09.11.2024,16,179,224,45,3584
601,23,29,24.11.2024,9,366,540,174,4860
939,21,11,07.11.2024,12,484,604,120,7248
578,16,28,09.11.2024,13,206,283,77,3679
796,17,13,26.11.2024,3,227,331,104,993
130,3,6,11.11.2024,10,198,255,57,2550
931,1,19,11.11.2024,20,460,547,87,10940
90,27,11,06.11.2024,13,306,366,60,4758
963,12,19,13.11.2024,13,165,206,41,2678
116,28,30,08.11.2024,1,238,354,116,354
140,8,12,25.11.2024,19,494,578,84,10982
395,4,30,27.11.2024,10,45,61,16,610
272,21,18,19.11.2024,7,139,202,63,1414
964,14,27,04.11.2024,10,393,569,176,5690
219,23,26,02.11.2024,15,292,335,43,5025
789,15,8,04.11.2024,1,34,46,12,46
749,4,16,17.11.2024,12,461,514,53,6168
124,3,12,24.11.2024,18,234,343,109,6174
571,9,11,06.11.2024,7,194,289,95,2023
287,24,29,06.11.2024,14,447,571,124,7994
472,9,9,28.11.2024,16,43,55,12,880
659,6,28,21.11.2024,1,352,435,83,435
350,29,24,27.11.2024,5,127,159,32,795
464,5,19,14.11.2024,13,347,428,81,5564
200,15,1,04.11.2024,9,457,613,156,5517
48,30,25,21.11.2024,12,411,583,172,6996
955,18,3,01.11.2024,12,176,226,50,2712
47,2,1,30.11.2024,5,252,342,90,1710
747,5,3,10.11.2024,6,174,234,60,1404
969,7,4,14.11.2024,1,310,357,47,357
588,23,26,04.11.2024,7,386,498,112,3486
643,23,3,16.11.2024,6,456,520,64,3120
203,13,20,12.11.2024,12,360,462,102,5544
401,6,30,24.11.2024,1,308,350,42,350
744,21,28,16.11.2024,8,185,254,69,2032
990,20,12,27.11.2024,7,457,510,53,3570
155,21,23,25.11.2024,15,129,171,42,2565
916,17,20,20.11.2024,6,21,25,4,150
486,23,23,27.11.2024,8,395,455,60,3640
233,14,14,03.11.2024,17,188,200,12,3400
407,3,30,02.11.2024,18,489,523,34,9414
192,13,20,16.11.2024,4,387,547,160,2188
850,28,7,13.11.2024,2,67,86,19,172
160,13,4,12.11.2024,18,127,188,61,3384
695,18,21,06.11.2024,3,483,614,131,1842
813,27,21,14.11.2024,9,276,322,46,2898
413,16,7,11.11.2024,15,382,423,41,6345
215,7,23,05.11.2024,5,477,698,221,3490
521,1,21,04.11.2024,20,160,240,80,4800
355,18,22,28.11.2024,19,94,133,39,2527
702,21,28,06.11.2024,6,372,450,78,2700
59,13,6,27.11.2024,20,497,597,100,11940
381,21,2,29.11.2024,13,136,198,62,2574
810,24,16,28.11.2024,8,52,70,18,560
545,2,9,13.11.2024,16,152,217,65,3472
7,16,22,11.11.2024,8,431,637,206,5096
791,4,21,18.11.2024,11,91,132,41,1452
74,8,25,13.11.2024,6,213,229,16,1374
804,10,22,13.11.2024,8,294,404,110,3232
673,12,13,03.11.2024,11,371,521,150,5731
47,12,11,09.11.2024,19,55,62,7,1178
642,22,3,12.11.2024,3,226,310,84,930
74,3,19,25.11.2024,11,178,209,31,2299
584,30,22,03.11.2024,19,366,482,116,9158
217,19,11,15.11.2024,18,258,365,107,6570
62,16,26,01.11.2024,5,29,32,3,160
1000,6,22,01.11.2024,3,319,428,109,1284
99,5,24,22.11.2024,3,92,99,7,297
207,19,8,25.11.2024,14,455,605,150,8470
474,18,19,21.11.2024,15,215,280,65,4200
536,16,7,03.11.2024,6,225,326,101,1956
237,3,26,20.11.2024,6,83,112,29,672
692,25,1,15.11.2024,11,354,525,171,5775
548,20,16,21.11.2024,18,222,257,35,4626
653,30,7,21.11.2024,19,452,617,165,11723
317,7,4,20.11.2024,3,322,394,72,1182
317,7,1,17.11.2024,19,326,369,43,7011
128,5,2,06.11.2024,4,301,364,63,1456
25,25,12,16.11.2024,13,151,177,26,2301
656,15,26,30.11.2024,10,250,343,93,3430
2,5,14,18.11.2024,15,210,250,40,3750
682,25,14,16.11.2024,13,163,204,41,2652
461,30,10,29.11.2024,3,222,253,31,759
912,12,14,23.11.2024,2,143,172,29,344
24,14,8,12.11.2024,11,356,449,93,4939
39,19,24,13.11.2024,9,291,387,96,3483
986,15,15,03.11.2024,4,444,579,135,2316
367,5,19,23.11.2024,13,127,145,18,1885
712,12,19,15.11.2024,1,106,128,22,128
166,17,6,15.11.2024,14,344,427,83,5978
241,3,28,11.11.2024,20,159,205,46,4100
871,18,27,19.11.2024,11,314,379,65,4169
289,14,22,14.11.2024,8,163,196,33,1568
269,28,29,30.11.2024,10,378,449,71,4490
264,26,3,26.11.2024,10,314,385,71,3850
951,20,19,08.11.2024,20,136,187,51,3740
879,9,9,19.11.2024,15,157,205,48,3075
277,29,14,09.11.2024,1,272,369,97,369
674,23,18,06.11.2024,5,128,168,40,840
513,14,5,20.11.2024,16,367,422,55,6752
590,22,27,18.11.2024,17,300,441,141,7497
103,8,6,04.11.2024,1,499,695,196,695
457,5,2,23.11.2024,6,75,95,20,570
45,16,11,10.11.2024,17,187,220,33,3740
727,26,14,12.11.2024,11,247,324,77,3564
880,25,5,02.11.2024,8,25,30,5,240
581,14,28,10.11.2024,13,466,520,54,6760
626,8,19,02.11.2024,1,88,121,33,121
365,4,5,25.11.2024,4,118,170,52,680
342,28,13,28.11.2024,12,274,361,87,4332
195,11,19,11.11.2024,16,483,627,144,10032
441,26,3,30.11.2024,19,313,461,148,8759
268,23,12,18.11.2024,10,111,151,40,1510
407,13,8,03.11.2024,3,127,164,37,492
380,2,29,07.11.2024,10,447,508,61,5080
418,6,30,22.11.2024,5,36,42,6,210
318,15,10,06.11.2024,9,215,289,74,2601
20,10,8,22.11.2024,15,363,449,86,6735
760,23,22,26.11.2024,13,395,511,116,6643
29,2,18,26.11.2024,11,361,525,164,5775
583,28,9,13.11.2024,19,480,538,58,10222
825,21,3,21.11.2024,16,230,271,41,4336
477,9,7,02.11.2024,10,120,143,23,1430
159,8,18,26.11.2024,12,475,533,58,6396
835,18,20,09.11.2024,14,208,235,27,3290
770,11,24,28.11.2024,6,116,128,12,768
157,20,26,08.11.2024,1,85,95,10,95
411,19,4,07.11.2024,7,441,509,68,3563
225,7,9,14.11.2024,15,232,320,88,4800
126,22,29,14.11.2024,15,195,277,82,4155
449,28,14,05.11.2024,16,313,377,64,6032
834,11,8,29.11.2024,2,103,138,35,276
216,2,3,29.11.2024,6,457,631,174,3786
570,25,9,27.11.2024,16,102,108,6,1728
278,23,30,26.11.2024,5,42,55,13,275
470,3,26,19.11.2024,1,64,87,23,87
981,6,22,26.11.2024,5,160,232,72,1160
60,15,27,29.11.2024,14,460,536,76,7504
905,18,15,24.11.2024,4,419,530,111,2120
652,23,16,11.11.2024,9,219,291,72,2619
853,20,30,28.11.2024,6,464,498,34,2988
369,21,18,08.11.2024,18,439,548,109,9864
808,22,16,21.11.2024,5,183,264,81,1320
66,6,5,11.11.2024,20,39,58,19,1160
801,23,11,13.11.2024,13,384,452,68,5876
261,30,17,24.11.2024,5,475,602,127,3010
643,7,15,19.11.2024,3,401,439,38,1317
87,3,2,04.11.2024,17,240,307,67,5219
242,23,12,23.11.2024,18,220,321,101,5778
629,2,22,30.11.2024,3,238,255,17,765
845,16,10,23.11.2024,2,403,592,189,1184
613,5,12,04.11.2024,19,486,646,160,12274
712,12,6,20.11.2024,11,373,542,169,5962
113,16,4,06.11.2024,6,88,112,24,672
398,24,9,08.11.2024,8,288,326,38,2608
22,12,28,10.11.2024,5,89,109,20,545
386,22,11,22.11.2024,9,304,407,103,3663
871,7,30,07.11.2024,1,352,499,147,499
208,10,10,10.11.2024,15,441,629,188,9435
313,17,27,17.11.2024,16,264,346,82,5536
339,1,9,15.11.2024,1,406,428,22,428
384,20,22,13.11.2024,17,348,377,29,6409
785,28,11,07.11.2024,15,258,344,86,5160
926,6,13,14.11.2024,7,97,140,43,980
759,11,14,08.11.2024,9,109,159,50,1431
486,11,26,06.11.2024,6,458,598,140,3588
18,14,3,29.11.2024,13,188,204,16,2652
829,20,5,01.11.2024,12,295,433,138,5196
155,19,10,04.11.2024,3,175,252,77,756
952,25,14,07.11.2024,2,93,111,18,222
776,22,23,19.11.2024,13,132,153,21,1989
685,24,26,05.11.2024,14,103,137,34,1918
304,22,25,06.11.2024,2,227,246,19,492
680,9,20,17.11.2024,1,330,429,99,429
100,7,7,24.11.2024,4,127,164,37,656
872,2,2,09.11.2024,19,277,396,119,7524
722,28,6,03.11.2024,3,105,117,12,351
973,27,6,26.11.2024,3,199,235,36,705
679,30,29,04.11.2024,12,278,401,123,4812
557,14,18,16.11.2024,13,163,172,9,2236
782,19,4,17.11.2024,11,146,188,42,2068
399,10,10,25.11.2024,5,422,571,149,2855
44,26,13,06.11.2024,19,465,681,216,12939
510,15,21,17.11.2024,16,137,164,27,2624
336,25,24,13.11.2024,13,155,224,69,2912
767,10,25,24.11.2024,4,306,421,115,1684
223,10,22,06.11.2024,4,313,429,116,1716
447,26,5,06.11.2024,3,113,119,6,357
707,3,2,10.11.2024,6,314,404,90,2424
815,4,10,24.11.2024,16,470,688,218,11008
582,25,28,23.11.2024,4,63,91,28,364
458,5,27,25.11.2024,14,302,398,96,5572
628,9,19,23.11.2024,17,66,74,8,1258
716,7,4,24.11.2024,18,30,34,4,612
443,14,14,01.11.2024,6,359,387,28,2322
357,30,7,24.11.2024,6,279,317,38,1902
406,7,28,04.11.2024,1,174,187,13,187
830,6,9,08.11.2024,17,452,586,134,9962
2,30,12,18.11.2024,6,464,663,199,3978
631,6,22,25.11.2024,19,388,419,31,7961
462,13,18,23.11.2024,14,99,124,25,1736
447,30,8,28.11.2024,8,105,137,32,1096
911,7,29,28.11.2024,17,313,382,69,6494
809,29,7,07.11.2024,16,216,299,83,4784
518,11,21,04.11.2024,18,458,636,178,11448
787,13,6,13.11.2024,15,70,88,18,1320
313,25,4,01.11.2024,3,111,150,39,450
811,6,7,29.11.2024,8,364,407,43,3256
690,18,28,17.11.2024,8,188,213,25,1704
755,20,24,28.11.2024,3,274,327,53,981
961,25,24,23.11.2024,1,215,312,97,312
505,13,4,21.11.2024,2,223,297,74,594
380,27,19,06.11.2024,1,325,477,152,477
536,4,28,21.11.2024,9,139,150,11,1350
131,15,20,15.11.2024,14,76,111,35,1554
712,4,12,19.11.2024,14,298,385,87,5390
253,18,23,10.11.2024,12,337,381,44,4572
692,1,23,27.11.2024,5,357,435,78,2175
713,27,13,18.11.2024,13,387,512,125,6656
363,19,27,04.11.2024,5,175,200,25,1000
632,17,19,19.11.2024,6,185,213,28,1278
280,22,14,21.11.2024,1,387,535,148,535
908,5,19,28.11.2024,20,31,36,5,720
487,5,25,20.11.2024,14,223,333,110,4662
312,3,25,15.11.2024,19,317,402,85,7638
576,1,18,26.11.2024,20,240,325,85,6500
510,9,18,12.11.2024,20,428,504,76,10080
283,3,17,07.11.2024,20,405,580,175,11600
116,14,15,08.11.2024,10,423,543,120,5430
646,11,7,13.11.2024,19,277,358,81,6802
390,10,25,19.11.2024,18,33,39,6,702
11,26,20,06.11.2024,17,407,588,181,9996
335,6,4,27.11.2024,2,99,110,11,220
470,2,13,13.11.2024,10,285,415,130,4150
19,27,18,06.11.2024,9,277,322,45,2898
533,4,25,08.11.2024,1,287,371,84,371
569,7,28,22.11.2024,2,178,212,34,424
835,18,18,08.11.2024,20,306,386,80,7720
854,28,24,04.11.2024,18,187,279,92,5022
243,1,5,30.11.2024,15,398,582,184,8730
49,1,7,02.11.2024,12,366,509,143,6108
413,4,19,29.11.2024,20,191,218,27,4360
934,12,13,10.11.2024,4,288,402,114,1608
197,27,15,18.11.2024,10,227,297,70,2970
515,25,16,30.11.2024,1,334,430,96,430
166,14,29,21.11.2024,2,35,47,12,94
209,14,12,29.11.2024,4,43,50,7,200
303,10,9,05.11.2024,20,306,327,21,6540
496,9,22,11.11.2024,14,288,423,135,5922
839,30,12,06.11.2024,10,471,575,104,5750
807,25,5,04.11.2024,11,457,605,148,6655
447,28,16,05.11.2024,11,468,653,185,7183
189,28,6,04.11.2024,20,24,28,4,560
955,21,21,22.11.2024,10,231,246,15,2460
511,10,16,29.11.2024,13,166,196,30,2548
805,11,12,20.11.2024,8,308,369,61,2952
99,28,27,27.11.2024,8,277,329,52,2632
501,27,3,05.11.2024,10,180,217,37,2170
105,6,23,27.11.2024,20,47,65,18,1300
404,5,22,06.11.2024,3,467,504,37,1512
735,25,16,08.11.2024,5,324,408,84,2040
161,14,25,09.11.2024,18,328,453,125,8154
633,12,18,11.11.2024,11,286,322,36,3542
599,22,10,06.11.2024,12,87,125,38,1500
104,13,4,17.11.2024,11,255,338,83,3718
460,3,2,11.11.2024,2,274,366,92,732
372,10,20,03.11.2024,9,235,279,44,2511
483,8,25,12.11.2024,7,191,213,22,1491
449,28,17,24.11.2024,10,74,104,30,1040
473,4,12,19.11.2024,10,357,532,175,5320
471,7,9,10.11.2024,20,118,141,23,2820
501,17,18,01.11.2024,8,114,147,33,1176
432,3,28,26.11.2024,3,350,406,56,1218
660,17,30,20.11.2024,6,225,240,15,1440
486,17,18,29.11.2024,6,410,533,123,3198
362,26,6,16.11.2024,18,248,262,14,4716
848,18,14,06.11.2024,11,348,415,67,4565
126,15,23,10.11.2024,14,177,238,61,3332
949,11,24,08.11.2024,16,410,575,165,9200
52,4,17,19.11.2024,4,191,259,68,1036
193,10,9,28.11.2024,13,258,357,99,4641
454,24,13,30.11.2024,6,304,374,70,2244
955,3,10,08.11.2024,7,411,456,45,3192
620,19,9,29.11.2024,13,322,400,78,5200
995,29,11,02.11.2024,20,302,397,95,7940
30,23,2,04.11.2024,2,275,358,83,716
492,8,19,01.11.2024,18,455,648,193,11664
701,23,11,06.11.2024,4,358,463,105,1852
420,22,17,10.11.2024,10,102,120,18,1200
284,24,17,25.11.2024,17,163,226,63,3842
923,27,22,20.11.2024,15,300,374,74,5610
575,30,29,12.11.2024,16,178,243,65,3888
357,25,17,05.11.2024,17,376,538,162,9146
53,6,5,03.11.2024,15,378,475,97,7125
552,20,22,29.11.2024,3,414,490,76,1470
554,7,21,20.11.2024,15,451,568,117,8520
949,11,25,19.11.2024,17,164,243,79,4131
948,11,26,04.11.2024,9,402,459,57,4131
509,25,28,06.11.2024,17,498,742,244,12614
108,3,6,24.11.2024,7,326,373,47,2611
515,11,25,14.11.2024,18,75,81,6,1458
252,20,16,27.11.2024,18,58,86,28,1548
345,19,1,29.11.2024,1,374,497,123,497
939,28,27,24.11.2024,19,323,363,40,6897
108,15,15,19.11.2024,2,198,221,23,442
883,14,30,14.11.2024,19,120,170,50,3230
383,3,21,27.11.2024,11,377,488,111,5368
22,25,24,15.11.2024,1,389,526,137,526
200,5,22,13.11.2024,1,378,418,40,418
590,8,26,19.11.2024,3,25,37,12,111
546,5,28,19.11.2024,16,168,225,57,3600
323,12,4,08.11.2024,14,40,43,3,602
544,11,27,18.11.2024,4,431,591,160,2364
44,10,11,02.11.2024,5,164,225,61,1125
212,13,3,29.11.2024,11,468,658,190,7238
544,16,7,13.11.2024,13,87,109,22,1417
223,23,12,17.11.2024,20,212,247,35,4940
362,8,26,20.11.2024,2,358,477,119,954
558,11,28,25.11.2024,14,63,85,22,1190
299,15,22,08.11.2024,3,332,478,146,1434
841,13,8,19.11.2024,16,293,354,61,5664
809,29,4,04.11.2024,13,159,195,36,2535
696,20,2,22.11.2024,5,422,617,195,3085
483,16,6,15.11.2024,1,431,558,127,558
432,25,21,13.11.2024,14,22,33,11,462
303,6,17,03.11.2024,13,407,475,68,6175
837,23,22,14.11.2024,3,37,40,3,120
714,15,11,21.11.2024,7,181,261,80,1827
651,30,10,14.11.2024,9,41,49,8,441
128,2,7,22.11.2024,18,282,314,32,5652
220,1,9,05.11.2024,16,221,275,54,4400
957,28,17,28.11.2024,4,146,171,25,684
278,15,4,17.11.2024,19,130,155,25,2945
217,30,1,19.11.2024,14,296,317,21,4438
508,13,9,23.11.2024,20,321,437,116,8740
4,19,6,06.11.2024,17,278,399,121,6783
962,20,17,15.11.2024,9,438,609,171,5481
360,4,28,23.11.2024,8,419,585,166,4680
551,24,29,15.11.2024,5,426,471,45,2355
273,29,7,01.11.2024,14,407,603,196,8442
123,26,4,25.11.2024,13,423,600,177,7800
795,24,25,27.11.2024,2,117,173,56,346
605,17,25,17.11.2024,3,263,301,38,903
482,15,21,24.11.2024,12,482,554,72,6648
240,7,13,10.11.2024,16,236,336,100,5376
97,8,23,01.11.2024,20,26,38,12,760
965,12,7,17.11.2024,14,485,550,65,7700
131,13,5,12.11.2024,9,398,592,194,5328
947,9,3,21.11.2024,6,434,501,67,3006
88,20,2,24.11.2024,12,236,262,26,3144
275,25,9,03.11.2024,1,47,64,17,64
707,19,27,23.11.2024,9,68,78,10,702
278,12,25,08.11.2024,18,329,354,25,6372
495,23,20,10.11.2024,4,478,701,223,2804
148,25,9,18.11.2024,15,34,46,12,690
572,16,5,24.11.2024,13,492,708,216,9204
589,14,7,06.11.2024,6,199,298,99,1788
863,10,26,05.11.2024,6,159,186,27,1116
912,23,21,22.11.2024,7,103,113,10,791
547,27,20,02.11.2024,2,112,137,25,274
442,4,23,13.11.2024,7,44,47,3,329
560,13,15,23.11.2024,6,47,69,22,414
798,2,2,20.11.2024,11,394,456,62,5016
915,26,14,24.11.2024,5,54,65,11,325
420,18,19,01.11.2024,1,183,231,48,231
321,1,2,04.11.2024,16,137,164,27,2624
818,19,1,01.11.2024,15,124,156,32,2340
195,25,25,02.11.2024,15,102,112,10,1680
210,18,27,13.11.2024,19,40,51,11,969
906,3,21,13.11.2024,16,88,98,10,1568
824,27,9,11.11.2024,9,377,530,153,4770
508,4,19,06.11.2024,18,408,605,197,10890
486,27,1,15.11.2024,9,167,206,39,1854
149,27,8,25.11.2024,10,161,226,65,2260
925,5,6,12.11.2024,5,65,79,14,395
148,11,6,07.11.2024,19,150,163,13,3097
978,24,30,30.11.2024,1,300,356,56,356
844,15,26,27.11.2024,16,444,541,97,8656
24,7,22,06.11.2024,14,328,396,68,5544
97,8,30,05.11.2024,16,216,291,75,4656
618,27,10,24.11.2024,18,32,47,15,846
138,9,12,27.11.2024,12,300,363,63,4356
392,2,5,04.11.2024,4,296,326,30,1304
979,30,18,19.11.2024,3,102,127,25,381
902,13,25,23.11.2024,10,372,524,152,5240
907,14,9,16.11.2024,18,225,326,101,5868
527,22,14,05.11.2024,7,243,364,121,2548
930,1,17,17.11.2024,9,170,198,28,1782
524,24,8,15.11.2024,18,489,728,239,13104
113,19,2,16.11.2024,10,317,414,97,4140
88,14,10,02.11.2024,2,214,295,81,590
783,17,30,27.11.2024,7,209,309,100,2163
641,5,27,07.11.2024,11,490,576,86,6336
276,17,14,09.11.2024,15,473,505,32,7575
162,4,8,19.11.2024,17,217,255,38,4335
192,5,23,28.11.2024,1,101,151,50,151
205,24,24,16.11.2024,5,436,528,92,2640
337,1,29,07.11.2024,7,21,22,1,154
562,17,13,08.11.2024,10,377,565,188,5650
465,8,19,04.11.2024,20,22,29,7,580
586,25,25,19.11.2024,3,78,86,8,258
818,1,1,19.11.2024,3,205,284,79,852
643,5,27,08.11.2024,5,349,398,49,1990
468,24,27,19.11.2024,18,474,620,146,11160
471,24,23,20.11.2024,2,206,267,61,534
751,11,10,18.11.2024,3,473,680,207,2040
561,14,16,09.11.2024,13,138,148,10,1924
944,20,27,27.11.2024,19,267,363,96,6897
256,14,4,29.11.2024,4,367,426,59,1704
457,3,30,04.11.2024,17,444,529,85,8993
679,20,18,21.11.2024,12,353,423,70,5076
145,25,19,26.11.2024,10,92,97,5,970
652,9,26,28.11.2024,1,53,60,7,60
781,8,9,14.11.2024,14,34,41,7,574
967,19,20,20.11.2024,9,156,226,70,2034
280,28,13,14.11.2024,15,91,98,7,1470
60,18,5,09.11.2024,1,409,559,150,559
553,30,3,23.11.2024,17,93,103,10,1751
228,17,15,20.11.2024,10,485,542,57,5420
913,13,5,02.11.2024,17,186,270,84,4590
509,9,23,11.11.2024,5,244,344,100,1720
368,21,7,14.11.2024,10,97,142,45,1420
353,15,1,01.11.2024,10,62,82,20,820
791,18,5,18.11.2024,11,71,79,8,869
429,3,21,06.11.2024,11,186,197,11,2167
682,28,29,13.11.2024,4,444,478,34,1912
617,6,8,02.11.2024,9,225,238,13,2142
88,5,18,08.11.2024,17,89,97,8,1649
92,24,29,24.11.2024,6,116,169,53,1014
582,24,30,21.11.2024,14,53,58,5,812
31,21,29,09.11.2024,18,363,383,20,6894
754,14,14,25.11.2024,11,128,181,53,1991
913,24,30,25.11.2024,9,170,234,64,2106
994,29,10,21.11.2024,6,449,669,220,4014
430,8,28,21.11.2024,10,204,303,99,3030
110,20,3,11.11.2024,8,23,30,7,240
762,26,21,07.11.2024,10,256,286,30,2860
241,12,18,14.11.2024,3,256,316,60,948
174,6,11,25.11.2024,4,380,420,40,1680
470,22,6,13.11.2024,15,494,632,138,9480
868,14,23,26.11.2024,13,469,689,220,8957
802,13,5,28.11.2024,5,153,165,12,825
949,20,29,15.11.2024,14,429,536,107,7504
877,28,9,26.11.2024,20,161,203,42,4060
83,22,6,19.11.2024,2,327,396,69,792
38,14,30,04.11.2024,17,166,216,50,3672
309,5,5,08.11.2024,11,435,615,180,6765
315,2,10,24.11.2024,14,442,614,172,8596
561,5,4,05.11.2024,3,181,243,62,729
864,9,20,24.11.2024,12,99,115,16,1380
805,6,1,13.11.2024,9,404,542,138,4878
91,25,4,04.11.2024,20,257,292,35,5840
564,3,17,05.11.2024,15,140,200,60,3000
440,8,10,08.11.2024,11,345,485,140,5335
513,28,28,17.11.2024,6,368,473,105,2838
284,19,26,14.11.2024,18,31,38,7,684
266,28,25,01.11.2024,12,426,604,178,7248
45,6,3,06.11.2024,12,169,228,59,2736
286,3,26,24.11.2024,6,139,147,8,882
726,13,2,10.11.2024,20,377,486,109,9720
5,27,8,16.11.2024,5,68,94,26,470
894,17,13,02.11.2024,2,117,126,9,252
716,7,4,20.11.2024,15,284,374,90,5610
619,30,2,03.11.2024,3,408,434,26,1302
14,7,10,30.11.2024,16,410,475,65,7600
769,23,16,24.11.2024,4,303,382,79,1528
668,18,14,02.11.2024,4,445,618,173,2472
906,30,5,25.11.2024,12,348,462,114,5544
770,2,24,17.11.2024,9,67,90,23,810
866,21,15,27.11.2024,17,178,216,38,3672
10,21,4,03.11.2024,7,480,578,98,4046
346,17,6,23.11.2024,4,31,45,14,180
572,17,22,28.11.2024,15,271,285,14,4275
141,25,15,20.11.2024,2,363,458,95,916
969,14,4,14.11.2024,1,285,365,80,365
798,20,16,27.11.2024,5,82,94,12,470
611,29,25,19.11.2024,13,141,179,38,2327
124,18,7,16.11.2024,11,422,451,29,4961
900,14,18,28.11.2024,4,452,476,24,1904
818,10,18,01.11.2024,18,196,237,41,4266
888,17,2,01.11.2024,6,333,449,116,2694
301,7,26,25.11.2024,5,122,150,28,750
191,6,27,04.11.2024,13,301,423,122,5499
394,20,22,25.11.2024,13,285,407,122,5291
266,13,22,16.11.2024,1,207,258,51,258
700,12,3,14.11.2024,20,351,408,57,8160
871,30,30,12.11.2024,5,63,68,5,340
119,27,14,29.11.2024,10,415,509,94,5090
5,16,30,01.11.2024,7,115,123,8,861
964,27,21,17.11.2024,9,449,503,54,4527
869,7,23,24.11.2024,4,318,457,139,1828
592,5,10,18.11.2024,10,262,301,39,3010
11,10,30,04.11.2024,14,308,436,128,6104
834,1,11,28.11.2024,8,42,47,5,376
934,3,13,16.11.2024,12,387,530,143,6360
398,23,10,13.11.2024,8,131,189,58,1512
630,28,11,08.11.2024,10,284,310,26,3100
334,1,27,04.11.2024,9,458,567,109,5103
788,5,16,17.11.2024,19,398,571,173,10849
126,11,16,08.11.2024,18,182,252,70,4536
937,28,4,05.11.2024,18,390,568,178,10224
930,16,11,26.11.2024,4,84,111,27,444
784,19,16,17.11.2024,4,184,215,31,860
386,28,21,02.11.2024,20,242,278,36,5560
393,1,5,10.11.2024,10,229,316,87,3160
379,25,9,14.11.2024,15,245,261,16,3915
67,15,4,01.11.2024,15,118,167,49,2505
475,4,12,13.11.2024,9,382,484,102,4356
657,25,8,16.11.2024,2,124,157,33,314
315,8,17,01.11.2024,6,447,528,81,3168
75,27,10,17.11.2024,11,359,485,126,5335
393,2,6,19.11.2024,6,180,251,71,1506
404,22,17,13.11.2024,5,449,509,60,2545
529,27,10,02.11.2024,15,220,256,36,3840
11,15,21,29.11.2024,13,348,388,40,5044
969,3,28,27.11.2024,7,473,541,68,3787
562,30,13,16.11.2024,14,352,426,74,5964
129,7,29,17.11.2024,14,367,523,156,7322
622,2,14,29.11.2024,1,403,517,114,517
959,17,13,19.11.2024,8,105,143,38,1144
799,12,25,08.11.2024,9,23,32,9,288
704,17,27,20.11.2024,5,248,324,76,1620
761,3,29,11.11.2024,20,430,534,104,10680
264,25,1,11.11.2024,7,347,480,133,3360
422,15,2,24.11.2024,16,260,376,116,6016
512,23,11,12.11.2024,9,96,138,42,1242
601,23,28,01.11.2024,8,419,539,120,4312
151,28,6,16.11.2024,7,433,601,168,4207
134,15,24,07.11.2024,6,49,55,6,330
967,21,5,16.11.2024,4,71,77,6,308
476,27,12,21.11.2024,16,224,248,24,3968
504,4,14,06.11.2024,2,394,442,48,884
905,18,12,04.11.2024,10,149,193,44,1930
591,18,8,02.11.2024,12,104,114,10,1368
436,19,1,07.11.2024,19,431,487,56,9253
31,29,6,24.11.2024,14,498,743,245,10402
814,18,1,04.11.2024,9,109,133,24,1197
508,27,3,02.11.2024,14,282,407,125,5698
462,15,29,29.11.2024,1,462,653,191,653
83,13,30,07.11.2024,15,446,476,30,7140
351,22,1,02.11.2024,10,300,343,43,3430
424,27,15,06.11.2024,9,460,561,101,5049
230,28,4,28.11.2024,15,97,114,17,1710
455,14,8,30.11.2024,18,23,26,3,468
577,2,24,13.11.2024,11,145,162,17,1782
359,20,24,20.11.2024,18,176,240,64,4320
225,24,20,08.11.2024,5,242,271,29,1355
777,16,6,18.11.2024,3,97,127,30,381
842,13,8,12.11.2024,2,163,228,65,456
837,14,2,05.11.2024,14,365,457,92,6398
662,11,27,06.11.2024,15,434,564,130,8460
312,12,7,19.11.2024,16,147,204,57,3264
601,12,1,15.11.2024,1,263,340,77,340
309,27,1,14.11.2024,16,497,690,193,11040
867,28,1,06.11.2024,2,282,380,98,760
945,4,19,27.11.2024,6,306,344,38,2064
791,3,29,12.11.2024,10,443,513,70,5130
34,9,9,18.11.2024,19,459,602,143,11438
178,29,6,12.11.2024,7,139,156,17,1092
981,6,8,12.11.2024,3,40,56,16,168
928,21,26,11.11.2024,12,430,463,33,5556
634,29,24,08.11.2024,11,156,220,64,2420
700,29,2,08.11.2024,13,299,423,124,5499
828,18,10,23.11.2024,7,319,444,125,3108
252,7,29,06.11.2024,10,428,525,97,5250
168,19,14,05.11.2024,1,410,435,25,435
578,24,24,18.11.2024,8,79,112,33,896
808,9,25,09.11.2024,3,98,128,30,384
455,25,11,25.11.2024,20,209,304,95,6080
627,20,20,05.11.2024,2,77,89,12,178
509,13,7,03.11.2024,16,241,316,75,5056
285,6,3,30.11.2024,1,204,269,65,269
888,9,21,03.11.2024,19,118,147,29,2793
638,26,4,19.11.2024,5,107,134,27,670
720,8,4,16.11.2024,12,131,162,31,1944
967,14,28,09.11.2024,16,173,233,60,3728
521,21,30,13.11.2024,9,204,296,92,2664
146,23,1,29.11.2024,20,224,281,57,5620
785,8,1,01.11.2024,19,305,410,105,7790
901,18,29,09.11.2024,11,440,515,75,5665
196,6,23,04.11.2024,3,190,219,29,657
340,12,1,11.11.2024,4,150,206,56,824
143,4,19,21.11.2024,4,164,221,57,884
51,17,28,15.11.2024,16,460,579,119,9264
144,9,15,20.11.2024,5,200,276,76,1380
881,5,5,03.11.2024,17,282,386,104,6562
261,21,26,22.11.2024,11,356,461,105,5071
113,19,6,24.11.2024,1,165,214,49,214
505,2,14,16.11.2024,13,418,476,58,6188
214,29,8,25.11.2024,6,303,452,149,2712
441,12,4,12.11.2024,20,473,531,58,10620
479,23,18,22.11.2024,10,481,564,83,5640
905,17,11,21.11.2024,17,397,481,84,8177
540,17,7,27.11.2024,18,102,143,41,2574
717,14,23,26.11.2024,16,85,119,34,1904
19,24,17,09.11.2024,13,251,339,88,4407
798,6,12,10.11.2024,7,434,580,146,4060
327,24,12,03.11.2024,19,208,270,62,5130
177,6,28,12.11.2024,1,382,493,111,493
362,24,26,22.11.2024,13,101,146,45,1898
308,15,6,18.11.2024,14,111,154,43,2156
902,6,21,01.11.2024,3,429,483,54,1449
167,8,30,09.11.2024,3,158,207,49,621
609,1,26,01.11.2024,20,357,442,85,8840
175,27,23,15.11.2024,2,85,104,19,208
269,30,27,29.11.2024,11,417,448,31,4928
595,12,14,07.11.2024,6,52,74,22,444
663,2,1,23.11.2024,8,315,338,23,2704
779,3,19,08.11.2024,8,198,226,28,1808
635,6,5,06.11.2024,10,421,460,39,4600
973,19,8,13.11.2024,1,354,438,84,438
22,30,17,05.11.2024,15,253,270,17,4050
410,9,13,04.11.2024,14,419,450,31,6300
1000,14,28,05.11.2024,13,155,212,57,2756
731,12,1,01.11.2024,19,176,222,46,4218
205,9,14,03.11.2024,15,417,561,144,8415
878,8,22,04.11.2024,7,492,713,221,4991
806,14,4,01.11.2024,20,144,198,54,3960
989,14,10,05.11.2024,7,363,445,82,3115
283,29,27,10.11.2024,4,459,523,64,2092
183,15,16,22.11.2024,13,271,343,72,4459
431,29,30,25.11.2024,2,223,303,80,606
810,9,20,10.11.2024,6,319,342,23,2052
285,29,14,26.11.2024,3,247,355,108,1065
103,17,18,15.11.2024,1,499,712,213,712
507,20,20,19.11.2024,7,103,140,37,980
43,29,6,10.11.2024,18,125,149,24,2682
791,9,3,25.11.2024,16,101,118,17,1888
439,25,11,26.11.2024,7,260,319,59,2233
262,15,19,25.11.2024,1,99,144,45,144
792,18,12,24.11.2024,8,202,281,79,2248
429,18,19,02.11.2024,9,350,395,45,3555
529,14,24,23.11.2024,9,50,53,3,477
981,1,20,11.11.2024,8,260,313,53,2504
907,11,16,24.11.2024,9,104,127,23,1143
286,8,11,25.11.2024,19,310,441,131,8379
34,19,25,08.11.2024,16,276,322,46,5152
438,2,10,16.11.2024,14,374,442,68,6188
467,17,30,17.11.2024,9,152,191,39,1719
406,24,13,03.11.2024,18,381,545,164,9810
987,28,12,29.11.2024,14,143,177,34,2478
479,5,22,29.11.2024,13,382,471,89,6123
947,26,29,26.11.2024,3,197,233,36,699
711,3,17,12.11.2024,17,378,495,117,8415
961,2,5,15.11.2024,16,464,522,58,8352
864,4,1,25.11.2024,17,168,179,11,3043
466,21,27,27.11.2024,18,205,242,37,4356
242,12,14,25.11.2024,14,36,52,16,728
234,23,8,15.11.2024,9,459,604,145,5436
252,7,1,13.11.2024,16,329,445,116,7120
23,27,13,16.11.2024,4,283,314,31,1256
753,6,14,14.11.2024,16,457,612,155,9792
795,3,20,01.11.2024,17,237,318,81,5406
442,11,7,17.11.2024,11,345,487,142,5357
48,13,16,25.11.2024,7,295,337,42,2359
697,27,6,23.11.2024,17,353,509,156,8653
516,25,16,13.11.2024,1,376,448,72,448
653,11,28,01.11.2024,10,294,327,33,3270
121,23,15,02.11.2024,9,331,431,100,3879
784,23,25,03.11.2024,18,435,590,155,10620
454,1,14,13.11.2024,7,110,118,8,826
72,13,25,06.11.2024,19,467,632,165,12008
901,1,16,07.11.2024,19,299,417,118,7923
522,27,20,03.11.2024,19,412,605,193,11495
503,4,18,05.11.2024,14,357,530,173,7420
788,7,25,26.11.2024,8,243,305,62,2440
937,30,1,18.11.2024,14,415,493,78,6902
269,6,13,19.11.2024,10,96,109,13,1090
713,19,18,22.11.2024,8,487,530,43,4240
790,8,11,10.11.2024,20,352,388,36,7760
368,25,19,20.11.2024,14,236,353,117,4942
614,6,3,20.11.2024,11,413,516,103,5676
3,12,9,20.11.2024,17,98,147,49,2499
238,18,30,17.11.2024,9,336,390,54,3510
56,23,5,26.11.2024,3,244,315,71,945
425,16,17,28.11.2024,1,205,251,46,251
657,9,22,08.11.2024,4,185,248,63,992
594,28,25,25.11.2024,2,69,93,24,186
259,29,25,19.11.2024,5,453,608,155,3040
96,11,1,07.11.2024,15,392,432,40,6480
56,30,20,05.11.2024,14,323,345,22,4830
901,2,7,01.11.2024,17,322,343,21,5831
656,29,28,28.11.2024,3,238,293,55,879
542,6,20,14.11.2024,18,103,149,46,2682
304,27,10,27.11.2024,17,177,261,84,4437
677,28,1,15.11.2024,5,268,361,93,1805
990,11,19,06.11.2024,15,323,352,29,5280
430,18,1,14.11.2024,19,349,479,130,9101
906,29,13,28.11.2024,4,102,129,27,516
402,5,1,18.11.2024,2,275,392,117,784
246,20,4,15.11.2024,2,325,459,134,918
945,14,7,22.11.2024,9,155,178,23,1602
823,20,13,21.11.2024,6,328,394,66,2364
535,22,27,29.11.2024,16,452,491,39,7856
12,24,24,10.11.2024,5,163,220,57,1100
383,7,14,20.11.2024,1,301,443,142,443
160,8,15,12.11.2024,8,24,32,8,256
273,19,15,13.11.2024,2,140,171,31,342
780,15,1,05.11.2024,10,136,163,27,1630
865,25,29,23.11.2024,10,40,49,9,490
716,25,14,09.11.2024,17,382,521,139,8857
835,15,26,12.11.2024,9,346,515,169,4635
895,13,27,23.11.2024,9,423,616,193,5544
560,5,4,12.11.2024,19,237,302,65,5738
531,12,9,23.11.2024,13,217,326,109,4238
984,5,8,14.11.2024,2,203,287,84,574
619,25,20,17.11.2024,14,156,169,13,2366
382,19,10,19.11.2024,16,485,695,210,11120
683,29,6,05.11.2024,2,477,540,63,1080
538,13,6,06.11.2024,14,291,322,31,4508
394,14,13,03.11.2024,15,475,621,146,9315
418,6,7,29.11.2024,12,201,300,99,3600
931,29,20,22.11.2024,5,302,418,116,2090
811,24,18,08.11.2024,7,174,226,52,1582
489,28,13,18.11.2024,17,243,309,66,5253
626,6,12,30.11.2024,14,26,29,3,406
261,17,6,02.11.2024,17,475,671,196,11407
917,20,27,08.11.2024,4,177,234,57,936
764,7,25,20.11.2024,3,94,104,10,312
11,1,1,29.11.2024,3,159,171,12,513
675,23,15,30.11.2024,13,90,120,30,1560
765,3,26,10.11.2024,8,429,619,190,4952
749,30,19,03.11.2024,7,164,174,10,1218
529,26,19,16.11.2024,11,93,124,31,1364
557,16,5,02.11.2024,19,314,391,77,7429
336,27,22,13.11.2024,10,97,136,39,1360
963,23,5,10.11.2024,1,178,265,87,265
665,5,2,17.11.2024,6,132,188,56,1128
32,19,30,16.11.2024,14,225,332,107,4648
105,20,9,18.11.2024,20,212,310,98,6200
583,27,25,18.11.2024,2,332,476,144,952
412,18,5,29.11.2024,1,61,82,21,82
252,21,30,01.11.2024,15,316,389,73,5835
959,17,14,19.11.2024,11,490,548,58,6028
783,21,30,24.11.2024,10,428,450,22,4500
254,26,10,16.11.2024,9,78,87,9,783
231,3,22,07.11.2024,16,337,402,65,6432
415,4,1,02.11.2024,16,255,291,36,4656
174,3,16,12.11.2024,2,128,140,12,280
590,25,22,06.11.2024,2,90,108,18,216
637,24,27,19.11.2024,20,367,482,115,9640
529,16,7,07.11.2024,15,39,47,8,705
189,26,10,28.11.2024,10,152,190,38,1900
564,20,1,25.11.2024,9,257,273,16,2457
768,18,14,28.11.2024,5,392,467,75,2335
68,30,29,01.11.2024,16,219,237,18,3792
776,20,3,26.11.2024,16,322,480,158,7680
705,18,28,25.11.2024,12,63,86,23,1032
985,22,6,28.11.2024,18,305,331,26,5958
361,13,7,09.11.2024,2,310,336,26,672
814,12,17,01.11.2024,12,186,258,72,3096
747,24,26,04.11.2024,11,450,564,114,6204
278,23,26,20.11.2024,13,341,396,55,5148
683,4,30,13.11.2024,2,330,469,139,938
3,2,10,01.11.2024,19,138,196,58,3724
13,23,10,11.11.2024,10,76,90,14,900
19,25,8,20.11.2024,18,92,100,8,1800
553,1,22,07.11.2024,19,204,284,80,5396
786,24,24,02.11.2024,8,267,390,123,3120
558,18,13,22.11.2024,9,322,438,116,3942
22,22,15,18.11.2024,18,26,32,6,576
162,20,23,11.11.2024,3,486,594,108,1782
709,14,23,20.11.2024,7,436,600,164,4200
351,24,14,05.11.2024,7,47,53,6,371
480,10,9,28.11.2024,1,262,334,72,334
55,25,25,27.11.2024,14,254,324,70,4536
989,20,18,16.11.2024,2,306,327,21,654
696,23,4,20.11.2024,20,64,92,28,1840
843,23,21,29.11.2024,10,436,473,37,4730
205,22,28,30.11.2024,5,409,499,90,2495
99,11,18,09.11.2024,18,182,195,13,3510
167,26,13,08.11.2024,6,336,370,34,2220
672,13,2,10.11.2024,15,403,546,143,8190
163,5,1,11.11.2024,8,308,389,81,3112
8,16,16,09.11.2024,12,361,428,67,5136
744,23,26,02.11.2024,18,346,469,123,8442
141,30,21,29.11.2024,7,58,81,23,567
297,13,24,03.11.2024,20,295,406,111,8120
591,9,14,29.11.2024,16,406,608,202,9728
136,28,14,06.11.2024,8,177,246,69,1968
385,30,1,12.11.2024,8,489,543,54,4344
394,3,24,18.11.2024,10,28,34,6,340
833,18,30,15.11.2024,1,124,152,28,152
411,2,11,30.11.2024,2,209,223,14,446
406,8,14,27.11.2024,1,198,219,21,219
544,29,21,03.11.2024,14,148,156,8,2184
559,19,4,01.11.2024,7,302,397,95,2779
169,2,26,24.11.2024,8,327,364,37,2912
139,1,20,09.11.2024,11,96,109,13,1199
966,15,25,12.11.2024,19,244,322,78,6118
237,28,4,19.11.2024,6,485,519,34,3114
639,23,18,14.11.2024,2,84,125,41,250
358,30,27,16.11.2024,10,338,394,56,3940
280,21,19,05.11.2024,2,173,240,67,480
986,20,10,23.11.2024,10,464,535,71,5350
93,4,18,01.11.2024,18,78,101,23,1818
399,12,21,12.11.2024,17,121,176,55,2992
866,10,25,11.11.2024,13,491,550,59,7150
172,20,26,22.11.2024,12,92,117,25,1404
507,2,11,23.11.2024,14,202,234,32,3276
832,14,4,26.11.2024,14,423,504,81,7056
434,1,15,01.11.2024,10,235,315,80,3150
776,14,29,30.11.2024,13,28,32,4,416
819,3,12,17.11.2024,12,33,40,7,480
204,22,1,03.11.2024,15,131,180,49,2700
974,3,14,16.11.2024,4,172,184,12,736
540,15,19,02.11.2024,12,82,95,13,1140
77,7,8,19.11.2024,11,168,219,51,2409
58,23,13,09.11.2024,12,123,166,43,1992
328,23,30,15.11.2024,19,46,63,17,1197
127,19,30,24.11.2024,3,384,564,180,1692
653,19,18,13.11.2024,14,483,711,228,9954
868,23,13,19.11.2024,7,226,277,51,1939
127,18,8,07.11.2024,11,362,461,99,5071
643,22,18,15.11.2024,13,283,298,15,3874
704,15,2,25.11.2024,6,486,727,241,4362
711,16,28,16.11.2024,3,280,325,45,975
7,26,21,04.11.2024,19,109,116,7,2204
369,14,16,08.11.2024,7,111,157,46,1099
707,23,20,23.11.2024,16,122,166,44,2656
216,19,28,13.11.2024,10,144,164,20,1640
575,30,5,11.11.2024,8,386,547,161,4376
958,26,29,15.11.2024,13,316,417,101,5421
192,9,6,15.11.2024,16,461,613,152,9808
727,6,8,24.11.2024,18,436,586,150,10548
48,5,8,22.11.2024,6,30,33,3,198
706,1,3,14.11.2024,20,111,154,43,3080
180,17,9,10.11.2024,5,122,144,22,720
676,3,20,19.11.2024,17,92,121,29,2057
819,22,16,11.11.2024,11,434,520,86,5720
276,23,11,05.11.2024,13,48,70,22,910
332,14,19,23.11.2024,20,319,364,45,7280
983,8,4,01.11.2024,1,364,447,83,447
292,8,7,22.11.2024,5,108,151,43,755
641,24,25,05.11.2024,5,257,323,66,1615
224,7,3,14.11.2024,17,356,379,23,6443
408,13,30,10.11.2024,16,34,47,13,752
4,7,18,12.11.2024,2,134,189,55,378
344,20,11,06.11.2024,20,262,311,49,6220
646,10,3,24.11.2024,2,327,460,133,920
305,24,2,05.11.2024,16,150,203,53,3248
890,14,16,26.11.2024,12,263,327,64,3924
431,5,12,19.11.2024,1,424,527,103,527
164,1,27,02.11.2024,8,359,408,49,3264
521,22,12,21.11.2024,13,444,625,181,8125
969,14,24,03.11.2024,10,295,346,51,3460
610,16,21,19.11.2024,7,70,103,33,721
602,23,25,19.11.2024,16,379,541,162,8656
726,9,27,20.11.2024,3,144,210,66,630
519,14,2,19.11.2024,20,447,632,185,12640
15,28,10,20.11.2024,7,89,110,21,770
894,14,10,07.11.2024,5,83,96,13,480
605,9,29,13.11.2024,4,83,93,10,372
562,19,23,30.11.2024,18,407,441,34,7938
888,30,4,11.11.2024,20,158,233,75,4660
234,9,1,01.11.2024,3,108,135,27,405
760,23,30,29.11.2024,6,86,98,12,588
606,17,23,30.11.2024,10,471,558,87,5580
847,29,30,21.11.2024,6,184,252,68,1512
765,17,23,16.11.2024,3,427,597,170,1791
539,5,30,05.11.2024,7,236,316,80,2212
665,16,2,11.11.2024,18,487,575,88,10350
398,17,2,13.11.2024,3,494,563,69,1689
741,9,19,21.11.2024,12,212,268,56,3216
589,20,18,28.11.2024,9,208,289,81,2601
333,17,14,22.11.2024,15,319,417,98,6255
816,13,7,29.11.2024,18,136,143,7,2574
636,28,30,15.11.2024,5,117,165,48,825
52,27,18,02.11.2024,19,442,548,106,10412
394,13,5,01.11.2024,4,221,267,46,1068
327,24,15,22.11.2024,17,215,253,38,4301
512,22,30,17.11.2024,13,175,243,68,3159
368,29,16,12.11.2024,4,496,559,63,2236
482,14,9,01.11.2024,1,45,58,13,58
346,17,26,26.11.2024,14,408,586,178,8204
299,22,2,12.11.2024,3,219,265,46,795
333,4,5,06.11.2024,9,434,506,72,4554
789,17,19,20.11.2024,16,468,492,24,7872
821,28,27,07.11.2024,7,274,400,126,2800
437,1,17,25.11.2024,8,422,598,176,4784
889,2,24,03.11.2024,15,30,34,4,510
199,2,29,20.11.2024,10,409,478,69,4780
939,7,17,21.11.2024,14,49,53,4,742
711,11,24,02.11.2024,18,314,405,91,7290
32,20,25,28.11.2024,9,378,434,56,3906
685,19,1,19.11.2024,14,326,463,137,6482
488,20,16,28.11.2024,19,441,490,49,9310
280,11,5,18.11.2024,9,73,88,15,792
625,9,17,01.11.2024,10,173,184,11,1840
210,12,25,25.11.2024,13,381,484,103,6292
522,1,19,11.11.2024,16,327,484,157,7744
587,9,22,01.11.2024,11,301,401,100,4411
562,2,5,22.11.2024,14,21,28,7,392
257,9,5,21.11.2024,2,405,601,196,1202
363,30,17,20.11.2024,5,179,211,32,1055
862,28,1,15.11.2024,7,425,476,51,3332
233,4,19,24.11.2024,15,339,428,89,6420
546,14,15,12.11.2024,20,195,288,93,5760
673,10,3,17.11.2024,14,374,560,186,7840
704,17,24,06.11.2024,7,22,28,6,196
742,5,27,20.11.2024,11,398,511,113,5621
406,23,17,26.11.2024,9,71,88,17,792
251,21,25,08.11.2024,6,486,604,118,3624
755,21,12,24.11.2024,18,201,267,66,4806
287,6,15,14.11.2024,16,160,206,46,3296
102,28,15,07.11.2024,1,204,231,27,231
605,7,22,21.11.2024,3,198,296,98,888
543,30,29,26.11.2024,3,245,312,67,936
302,25,5,29.11.2024,13,415,589,174,7657
577,10,14,20.11.2024,18,305,323,18,5814
431,30,5,08.11.2024,5,241,269,28,1345
670,16,4,15.11.2024,20,261,342,81,6840
156,29,6,08.11.2024,16,346,453,107,7248
37,23,27,26.11.2024,14,172,202,30,2828
819,23,18,21.11.2024,15,47,68,21,1020
288,26,15,15.11.2024,19,175,204,29,3876
643,26,15,14.11.2024,16,171,195,24,3120
538,3,27,29.11.2024,18,280,380,100,6840
864,15,24,07.11.2024,15,267,323,56,4845
67,11,16,20.11.2024,2,288,341,53,682
523,20,25,23.11.2024,13,100,143,43,1859
216,17,9,18.11.2024,17,233,266,33,4522
24,28,5,01.11.2024,16,211,236,25,3776
608,13,22,04.11.2024,6,75,100,25,600
684,20,1,21.11.2024,11,374,485,111,5335
827,18,4,05.11.2024,19,331,427,96,8113
660,13,28,21.11.2024,4,265,294,29,1176
828,1,21,27.11.2024,16,23,29,6,464
733,25,28,20.11.2024,2,439,470,31,940
601,5,8,16.11.2024,5,303,338,35,1690
567,20,29,08.11.2024,8,152,208,56,1664
679,30,28,14.11.2024,10,312,391,79,3910
48,8,23,11.11.2024,2,222,266,44,532
524,20,14,28.11.2024,17,396,570,174,9690
998,7,11,12.11.2024,15,26,33,7,495
242,24,4,25.11.2024,6,423,570,147,3420
901,7,4,11.11.2024,11,183,196,13,2156
865,25,11,15.11.2024,2,192,257,65,514
538,16,20,20.11.2024,8,268,367,99,2936
287,9,2,10.11.2024,12,491,635,144,7620
108,3,10,03.11.2024,10,446,659,213,6590
668,30,23,04.11.2024,5,469,699,230,3495
813,11,28,02.11.2024,7,212,318,106,2226
117,11,21,25.11.2024,13,413,578,165,7514
617,3,24,02.11.2024,19,327,472,145,8968
462,20,15,18.11.2024,2,439,489,50,978
655,10,26,25.11.2024,9,191,245,54,2205
270,14,16,19.11.2024,10,32,44,12,440
238,27,25,14.11.2024,14,478,677,199,9478
68,14,7,05.11.2024,20,173,199,26,3980
511,17,22,07.11.2024,4,190,281,91,1124
375,15,23,30.11.2024,6,309,422,113,2532
151,22,15,08.11.2024,4,264,392,128,1568
793,24,7,23.11.2024,2,86,122,36,244
340,18,12,30.11.2024,10,328,492,164,4920
233,8,6,10.11.2024,3,200,300,100,900
382,3,18,12.11.2024,9,278,365,87,3285
817,13,1,15.11.2024,7,164,231,67,1617
867,16,23,09.11.2024,13,105,116,11,1508
761,21,19,12.11.2024,18,156,170,14,3060
643,16,9,24.11.2024,20,75,81,6,1620
4,11,1,06.11.2024,6,57,77,20,462
415,19,18,03.11.2024,10,448,490,42,4900
807,25,10,27.11.2024,9,340,417,77,3753
911,2,23,19.11.2024,9,412,471,59,4239
499,26,15,10.11.2024,1,373,413,40,413
830,24,28,05.11.2024,18,214,289,75,5202
248,7,25,30.11.2024,1,410,509,99,509
874,21,12,30.11.2024,1,296,397,101,397
394,23,27,06.11.2024,4,288,327,39,1308
387,15,15,04.11.2024,20,378,566,188,11320
424,14,3,01.11.2024,5,499,691,192,3455
938,8,9,06.11.2024,2,85,121,36,242
132,5,22,23.11.2024,8,149,196,47,1568
41,3,29,07.11.2024,15,487,632,145,9480
913,14,16,12.11.2024,20,375,410,35,8200
885,15,20,03.11.2024,11,92,109,17,1199
834,13,4,09.11.2024,10,33,37,4,370
252,25,28,12.11.2024,3,240,344,104,1032
930,12,14,29.11.2024,10,87,123,36,1230
834,2,4,18.11.2024,13,138,192,54,2496
389,7,3,19.11.2024,19,396,479,83,9101
927,21,13,29.11.2024,20,324,392,68,7840
777,6,21,06.11.2024,16,349,425,76,6800
902,9,26,03.11.2024,10,312,331,19,3310
950,28,26,30.11.2024,18,175,261,86,4698
761,26,11,11.11.2024,3,370,551,181,1653
852,30,26,09.11.2024,10,464,541,77,5410
563,13,16,05.11.2024,6,276,356,80,2136
587,1,10,16.11.2024,8,479,517,38,4136
948,12,9,13.11.2024,3,199,253,54,759
595,27,7,05.11.2024,12,65,75,10,900
801,19,15,17.11.2024,17,244,347,103,5899
219,3,5,28.11.2024,1,159,209,50,209
293,8,15,16.11.2024,14,224,287,63,4018
54,23,17,26.11.2024,12,261,281,20,3372
741,23,18,16.11.2024,8,61,70,9,560
87,11,3,03.11.2024,9,130,164,34,1476
423,6,21,04.11.2024,1,253,328,75,328
562,15,4,02.11.2024,20,342,457,115,9140
328,14,10,05.11.2024,11,385,550,165,6050
417,21,18,21.11.2024,1,89,110,21,110
593,22,7,08.11.2024,3,199,232,33,696
724,24,7,01.11.2024,13,36,41,5,533
56,6,17,14.11.2024,11,489,665,176,7315
344,30,23,01.11.2024,11,459,511,52,5621
296,24,4,04.11.2024,10,398,423,25,4230
419,16,2,04.11.2024,11,56,67,11,737
603,19,5,01.11.2024,4,492,605,113,2420
915,8,7,28.11.2024,17,88,97,9,1649
140,9,2,02.11.2024,11,131,196,65,2156
134,6,22,06.11.2024,2,199,221,22,442
29,4,22,24.11.2024,20,384,550,166,11000
117,25,7,09.11.2024,18,167,192,25,3456
104,7,8,21.11.2024,6,195,250,55,1500
979,4,26,07.11.2024,6,137,180,43,1080
344,27,28,14.11.2024,10,180,207,27,2070
191,17,13,10.11.2024,10,313,388,75,3880
6,6,9,19.11.2024,17,226,257,31,4369
179,24,2,24.11.2024,19,476,553,77,10507
769,15,21,22.11.2024,16,320,461,141,7376
249,9,22,19.11.2024,18,326,395,69,7110
637,16,27,08.11.2024,12,214,300,86,3600
343,23,6,13.11.2024,13,198,238,40,3094
868,3,9,16.11.2024,13,481,585,104,7605
253,28,21,17.11.2024,2,317,393,76,786
308,4,9,16.11.2024,12,125,154,29,1848
596,23,12,06.11.2024,10,442,618,176,6180
972,9,30,25.11.2024,13,228,273,45,3549
239,11,7,18.11.2024,19,355,485,130,9215
418,5,25,21.11.2024,19,285,342,57,6498
256,5,10,07.11.2024,13,257,338,81,4394
305,4,11,16.11.2024,3,95,120,25,360
661,23,30,14.11.2024,7,378,489,111,3423
230,11,9,07.11.2024,10,217,260,43,2600
768,14,8,22.11.2024,19,33,46,13,874
403,24,18,05.11.2024,10,291,383,92,3830
243,20,20,25.11.2024,18,398,432,34,7776
99,12,28,08.11.2024,17,60,74,14,1258
801,17,21,07.11.2024,15,62,72,10,1080
510,26,7,16.11.2024,5,202,255,53,1275
171,25,27,25.11.2024,1,473,555,82,555
629,14,27,16.11.2024,18,454,480,26,8640
918,5,13,24.11.2024,9,295,326,31,2934
126,10,13,26.11.2024,7,304,360,56,2520
792,15,13,06.11.2024,11,328,469,141,5159
767,19,27,21.11.2024,6,207,282,75,1692
353,25,13,07.11.2024,7,307,386,79,2702
767,30,19,28.11.2024,19,323,382,59,7258
221,13,27,19.11.2024,9,263,354,91,3186
684,4,6,21.11.2024,14,357,437,80,6118
300,19,15,03.11.2024,20,217,324,107,6480
27,14,22,29.11.2024,18,128,153,25,2754
615,4,2,04.11.2024,13,72,86,14,1118
792,19,1,04.11.2024,13,393,456,63,5928
617,9,24,19.11.2024,2,385,419,34,838
232,8,9,09.11.2024,7,249,336,87,2352
854,16,22,26.11.2024,7,479,562,83,3934
814,4,10,02.11.2024,19,282,384,102,7296
91,24,2,03.11.2024,14,257,295,38,4130
76,9,30,18.11.2024,3,70,74,4,222
290,19,21,23.11.2024,19,338,368,30,6992
26,2,28,10.11.2024,6,449,479,30,2874
543,18,27,29.11.2024,14,430,630,200,8820
414,30,18,02.11.2024,3,441,582,141,1746
253,10,5,04.11.2024,7,144,209,65,1463
957,11,10,18.11.2024,9,446,669,223,6021
215,11,7,03.11.2024,14,49,63,14,882
688,4,16,27.11.2024,19,68,99,31,1881
392,2,3,11.11.2024,16,67,92,25,1472
89,26,16,04.11.2024,7,441,618,177,4326
101,19,22,10.11.2024,1,498,591,93,591
476,22,28,01.11.2024,6,486,624,138,3744
823,21,3,10.11.2024,3,77,110,33,330
471,28,21,10.11.2024,11,86,109,23,1199
714,3,25,30.11.2024,20,122,152,30,3040
870,17,12,16.11.2024,13,161,201,40,2613
620,3,8,18.11.2024,3,38,51,13,153
309,20,4,22.11.2024,13,79,103,24,1339
294,6,8,21.11.2024,5,77,91,14,455
50,3,23,08.11.2024,3,462,530,68,1590
53,14,20,22.11.2024,14,484,548,64,7672
69,14,18,09.11.2024,12,182,273,91,3276
180,25,21,16.11.2024,10,449,472,23,4720
649,12,10,16.11.2024,3,468,590,122,1770
556,20,23,20.11.2024,9,270,395,125,3555
368,14,13,20.11.2024,10,263,393,130,3930
613,8,2,01.11.2024,12,71,106,35,1272
718,24,11,14.11.2024,15,187,252,65,3780
412,7,12,12.11.2024,17,162,181,19,3077
189,15,21,24.11.2024,3,239,293,54,879
137,25,21,12.11.2024,13,196,229,33,2977
895,1,16,01.11.2024,2,60,86,26,172
670,30,9,04.11.2024,8,22,32,10,256
522,21,14,28.11.2024,6,145,204,59,1224
525,15,25,26.11.2024,4,441,464,23,1856
654,27,14,14.11.2024,18,308,416,108,7488
996,26,25,04.11.2024,16,85,95,10,1520
484,14,6,07.11.2024,17,366,404,38,6868
892,26,22,06.11.2024,5,130,169,39,845
186,6,18,05.11.2024,10,26,31,5,310
335,28,5,17.11.2024,7,192,254,62,1778
610,10,2,01.11.2024,9,64,89,25,801
568,9,15,20.11.2024,4,130,188,58,752
105,23,4,30.11.2024,8,187,198,11,1584
874,25,11,07.11.2024,11,484,714,230,7854
950,5,6,25.11.2024,17,304,446,142,7582
8,26,30,14.11.2024,10,76,104,28,1040
681,12,16,18.11.2024,2,307,387,80,774
247,1,5,30.11.2024,18,28,31,3,558
917,10,4,20.11.2024,10,457,626,169,6260
338,8,10,03.11.2024,20,180,250,70,5000
806,25,17,25.11.2024,4,466,545,79,2180
481,18,14,26.11.2024,15,158,229,71,3435
132,18,2,06.11.2024,3,328,444,116,1332
949,20,8,01.11.2024,13,127,153,26,1989
935,18,21,23.11.2024,1,343,396,53,396
572,19,25,04.11.2024,5,67,95,28,475
636,24,29,23.11.2024,15,140,205,65,3075
246,27,24,13.11.2024,20,296,354,58,7080
340,18,11,12.11.2024,16,396,522,126,8352
314,23,25,01.11.2024,18,385,436,51,7848
917,24,1,27.11.2024,14,309,385,76,5390
653,2,23,10.11.2024,12,449,577,128,6924
821,18,14,01.11.2024,13,52,56,4,728
340,14,15,08.11.2024,8,237,278,41,2224
455,29,2,03.11.2024,13,173,216,43,2808
96,30,8,14.11.2024,18,53,70,17,1260
566,2,5,12.11.2024,8,325,416,91,3328
200,16,24,13.11.2024,20,315,421,106,8420
870,13,10,09.11.2024,10,241,343,102,3430
881,30,6,11.11.2024,1,275,372,97,372
247,24,5,29.11.2024,9,104,123,19,1107
5,25,2,09.11.2024,3,238,264,26,792
114,24,11,11.11.2024,8,472,581,109,4648
111,11,18,11.11.2024,11,240,343,103,3773
599,30,1,13.11.2024,6,420,548,128,3288
388,1,6,09.11.2024,6,197,212,15,1272
782,7,8,22.11.2024,5,318,382,64,1910
615,10,12,06.11.2024,8,427,510,83,4080
551,30,26,05.11.2024,17,206,220,14,3740
21,30,27,05.11.2024,20,229,259,30,5180
903,23,20,20.11.2024,3,232,254,22,762
303,6,20,05.11.2024,5,33,36,3,180
476,18,30,25.11.2024,6,454,551,97,3306
247,19,6,29.11.2024,13,204,233,29,3029
880,27,1,13.11.2024,8,493,700,207,5600
770,2,7,04.11.2024,8,301,384,83,3072
310,18,25,27.11.2024,12,24,26,2,312
429,4,22,19.11.2024,2,71,82,11,164
250,7,12,20.11.2024,8,255,324,69,2592
619,2,1,02.11.2024,1,108,142,34,142
350,14,4,13.11.2024,5,108,130,22,650
733,23,22,09.11.2024,16,51,70,19,1120
363,20,10,01.11.2024,15,298,396,98,5940
921,5,8,01.11.2024,10,401,483,82,4830
824,7,5,24.11.2024,8,60,73,13,584
643,15,15,30.11.2024,18,389,458,69,8244
386,10,15,24.11.2024,10,422,528,106,5280
802,24,4,20.11.2024,10,474,572,98,5720
694,20,23,30.11.2024,4,462,624,162,2496
998,16,14,14.11.2024,14,183,221,38,3094
675,16,21,29.11.2024,14,52,55,3,770
590,6,18,03.11.2024,11,249,267,18,2937
679,3,26,24.11.2024,20,49,54,5,1080
71,22,4,13.11.2024,16,321,435,114,6960
453,1,13,21.11.2024,16,324,370,46,5920
252,5,5,07.11.2024,16,79,96,17,1536
160,3,28,05.11.2024,13,413,530,117,6890
292,21,17,12.11.2024,14,126,160,34,2240
86,10,28,05.11.2024,20,170,180,10,3600
30,24,8,15.11.2024,11,391,454,63,4994
771,18,19,30.11.2024,5,439,600,161,3000
75,7,5,09.11.2024,14,185,250,65,3500
515,28,13,13.11.2024,20,120,179,59,3580
774,18,23,09.11.2024,4,256,332,76,1328
821,22,16,14.11.2024,11,294,425,131,4675
350,29,7,30.11.2024,17,87,95,8,1615
798,9,22,28.11.2024,1,411,580,169,580
168,23,14,13.11.2024,10,108,135,27,1350
813,29,8,28.11.2024,12,51,56,5,672
188,9,11,12.11.2024,8,482,703,221,5624
501,27,12,22.11.2024,13,171,237,66,3081
629,16,14,09.11.2024,17,232,274,42,4658
437,6,6,09.11.2024,19,158,192,34,3648
124,1,10,14.11.2024,5,171,254,83,1270
593,5,19,14.11.2024,11,204,299,95,3289
880,4,5,27.11.2024,2,436,608,172,1216
769,15,29,14.11.2024,16,106,156,50,2496
758,11,23,01.11.2024,20,232,324,92,6480
264,22,29,09.11.2024,5,55,72,17,360
309,14,28,26.11.2024,12,453,513,60,6156
807,7,10,29.11.2024,16,242,361,119,5776
707,30,28,23.11.2024,1,158,190,32,190
505,24,19,15.11.2024,5,199,287,88,1435
299,23,21,02.11.2024,15,32,36,4,540
626,17,5,03.11.2024,10,237,322,85,3220
970,5,25,08.11.2024,7,233,322,89,2254
160,23,2,30.11.2024,19,355,416,61,7904
66,23,30,13.11.2024,16,212,292,80,4672
13,13,7,14.11.2024,8,342,490,148,3920
803,26,17,14.11.2024,7,22,24,2,168
142,29,26,27.11.2024,5,33,49,16,245
51,29,29,24.11.2024,17,160,234,74,3978
130,13,27,09.11.2024,18,118,176,58,3168
218,14,28,15.11.2024,19,203,300,97,5700
522,6,23,18.11.2024,20,215,295,80,5900
654,3,23,07.11.2024,13,24,29,5,377
694,9,20,30.11.2024,10,448,646,198,6460
614,5,1,18.11.2024,12,460,541,81,6492
733,27,2,04.11.2024,7,90,120,30,840
782,28,3,30.11.2024,19,467,569,102,10811
845,21,29,28.11.2024,1,57,83,26,83
299,13,4,16.11.2024,12,398,513,115,6156
708,29,23,21.11.2024,2,280,300,20,600
975,17,24,17.11.2024,19,327,450,123,8550
37,10,9,21.11.2024,3,49,53,4,159
248,3,12,13.11.2024,13,449,540,91,7020
704,7,27,11.11.2024,7,271,364,93,2548
282,17,21,07.11.2024,16,169,202,33,3232
518,2,7,02.11.2024,20,327,358,31,7160
413,17,30,11.11.2024,13,155,171,16,2223
861,27,15,18.11.2024,9,37,55,18,495
623,2,5,29.11.2024,15,399,537,138,8055
415,29,20,17.11.2024,18,330,377,47,6786
719,4,14,03.11.2024,4,196,287,91,1148
435,26,17,14.11.2024,4,61,80,19,320
847,27,13,15.11.2024,12,298,408,110,4896
207,22,7,06.11.2024,14,52,74,22,1036
737,11,28,01.11.2024,11,485,627,142,6897
384,7,9,12.11.2024,18,52,63,11,1134
336,15,23,05.11.2024,18,197,240,43,4320
246,8,19,21.11.2024,19,390,499,109,9481
290,6,13,13.11.2024,5,65,95,30,475
718,16,11,18.11.2024,2,52,62,10,124
834,9,30,14.11.2024,14,283,374,91,5236
214,1,27,28.11.2024,7,23,32,9,224
350,7,6,29.11.2024,15,106,147,41,2205
441,19,18,26.11.2024,8,142,154,12,1232
380,26,24,23.11.2024,2,99,110,11,220
531,12,10,14.11.2024,4,485,510,25,2040
558,15,27,07.11.2024,1,277,361,84,361
484,5,29,24.11.2024,1,327,456,129,456
230,18,28,23.11.2024,6,476,670,194,4020
481,15,30,24.11.2024,4,78,109,31,436
300,5,11,05.11.2024,16,333,488,155,7808
204,1,25,20.11.2024,2,24,35,11,70
150,3,2,27.11.2024,5,364,428,64,2140
199,10,22,10.11.2024,16,124,168,44,2688
54,12,24,22.11.2024,16,427,582,155,9312
458,16,4,25.11.2024,20,420,590,170,11800
925,14,30,04.11.2024,19,300,379,79,7201
386,12,23,20.11.2024,14,188,231,43,3234
789,15,14,10.11.2024,2,311,428,117,856
387,17,28,08.11.2024,7,158,185,27,1295
18,20,23,12.11.2024,5,98,139,41,695
289,5,22,13.11.2024,12,114,144,30,1728
206,23,6,05.11.2024,3,298,415,117,1245
250,20,23,01.11.2024,15,30,41,11,615
490,22,8,14.11.2024,2,386,463,77,926
808,21,19,04.11.2024,3,456,546,90,1638
764,23,4,02.11.2024,3,211,300,89,900
156,14,1,01.11.2024,17,36,44,8,748
574,19,23,07.11.2024,9,425,621,196,5589
613,15,28,18.11.2024,7,126,149,23,1043
513,23,7,12.11.2024,16,449,593,144,9488
111,10,19,13.11.2024,16,294,416,122,6656
394,8,29,23.11.2024,17,464,692,228,11764
397,28,10,22.11.2024,8,410,435,25,3480
213,3,16,23.11.2024,5,412,509,97,2545
374,5,25,17.11.2024,5,169,218,49,1090
271,28,29,19.11.2024,6,494,630,136,3780
132,10,1,02.11.2024,2,351,484,133,968
674,5,1,18.11.2024,13,339,369,30,4797
683,24,13,26.11.2024,1,173,228,55,228
573,25,11,09.11.2024,7,415,529,114,3703
118,13,21,07.11.2024,2,442,603,161,1206
203,8,11,29.11.2024,14,426,621,195,8694
391,20,23,25.11.2024,7,410,447,37,3129
60,2,24,02.11.2024,19,45,64,19,1216
603,8,3,18.11.2024,15,270,372,102,5580
829,10,28,27.11.2024,18,484,546,62,9828
660,8,11,23.11.2024,9,51,66,15,594
966,20,25,06.11.2024,20,348,463,115,9260
236,2,30,09.11.2024,8,324,401,77,3208
91,8,25,14.11.2024,13,102,149,47,1937
26,17,26,26.11.2024,3,87,97,10,291
651,14,17,03.11.2024,12,429,618,189,7416
586,10,25,15.11.2024,9,389,557,168,5013
893,12,30,23.11.2024,8,55,79,24,632
91,2,12,22.11.2024,18,475,642,167,11556
760,8,1,28.11.2024,20,228,334,106,6680
620,15,20,17.11.2024,10,490,535,45,5350
599,4,24,10.11.2024,5,340,450,110,2250
486,14,24,28.11.2024,12,331,460,129,5520
107,13,26,16.11.2024,14,250,360,110,5040
522,16,16,13.11.2024,5,336,435,99,2175
982,7,14,30.11.2024,8,228,293,65,2344
681,22,12,01.11.2024,3,370,454,84,1362
795,26,21,06.11.2024,15,464,523,59,7845
163,6,14,14.11.2024,14,233,332,99,4648
528,1,19,23.11.2024,7,235,289,54,2023
973,13,27,11.11.2024,6,110,161,51,966
617,22,29,23.11.2024,18,484,509,25,9162
299,19,19,08.11.2024,11,291,320,29,3520
332,11,20,16.11.2024,16,243,303,60,4848
998,20,27,16.11.2024,13,162,210,48,2730
193,30,18,12.11.2024,18,32,34,2,612
75,30,23,30.11.2024,10,80,100,20,1000
914,25,13,11.11.2024,16,285,323,38,5168
72,27,5,19.11.2024,12,436,527,91,6324
96,18,18,15.11.2024,3,331,473,142,1419
316,17,14,02.11.2024,2,439,532,93,1064
45,1,23,20.11.2024,6,146,192,46,1152
654,6,17,15.11.2024,18,421,535,114,9630
655,15,2,21.11.2024,8,328,459,131,3672
604,7,1,04.11.2024,4,371,414,43,1656
649,1,3,21.11.2024,17,208,277,69,4709
506,9,6,19.11.2024,1,213,285,72,285
353,5,6,06.11.2024,8,428,529,101,4232
216,27,4,21.11.2024,18,28,31,3,558
43,1,26,16.11.2024,7,30,33,3,231
268,26,6,29.11.2024,13,333,413,80,5369
266,23,26,19.11.2024,15,194,245,51,3675
812,24,21,10.11.2024,1,355,425,70,425
906,26,23,03.11.2024,9,166,246,80,2214
985,20,12,29.11.2024,14,346,504,158,7056
262,2,24,13.11.2024,18,454,637,183,11466
371,21,10,09.11.2024,12,125,150,25,1800
68,9,13,21.11.2024,14,450,670,220,9380
679,27,14,12.11.2024,17,115,160,45,2720
275,17,7,26.11.2024,10,290,416,126,4160
678,30,12,21.11.2024,18,473,631,158,11358
876,14,27,16.11.2024,7,228,280,52,1960
307,17,11,08.11.2024,5,34,46,12,230
472,16,12,17.11.2024,16,22,28,6,448
624,10,8,06.11.2024,14,390,517,127,7238
224,22,27,21.11.2024,9,164,237,73,2133
747,14,20,23.11.2024,11,436,464,28,5104
25,25,24,26.11.2024,10,173,186,13,1860
739,2,20,06.11.2024,18,149,188,39,3384
751,27,1,02.11.2024,15,115,129,14,1935
777,20,25,07.11.2024,19,42,53,11,1007
233,30,24,16.11.2024,5,425,560,135,2800
277,21,26,30.11.2024,12,340,506,166,6072
5,8,18,30.11.2024,1,50,56,6,56
573,12,4,12.11.2024,2,345,469,124,938
652,1,10,11.11.2024,1,336,498,162,498
97,10,7,11.11.2024,8,445,495,50,3960
476,20,9,25.11.2024,8,416,577,161,4616
636,28,27,25.11.2024,11,110,155,45,1705
743,29,4,04.11.2024,5,135,163,28,815
30,9,28,06.11.2024,13,192,278,86,3614
837,9,5,18.11.2024,14,423,517,94,7238
188,26,22,12.11.2024,4,352,453,101,1812
508,8,17,07.11.2024,18,363,439,76,7902
300,11,3,09.11.2024,14,489,689,200,9646
844,30,21,03.11.2024,19,131,144,13,2736
489,22,29,30.11.2024,10,185,224,39,2240
774,22,8,23.11.2024,15,355,521,166,7815
428,5,16,06.11.2024,18,426,527,101,9486
205,8,15,09.11.2024,13,66,94,28,1222
867,3,22,11.11.2024,16,200,248,48,3968
740,25,28,24.11.2024,6,385,449,64,2694
104,6,25,14.11.2024,1,267,343,76,343
524,26,21,15.11.2024,13,97,127,30,1651
956,2,14,19.11.2024,8,60,86,26,688
247,1,26,28.11.2024,8,463,611,148,4888
973,3,14,24.11.2024,16,472,561,89,8976
34,23,11,24.11.2024,20,414,536,122,10720
940,27,5,30.11.2024,14,232,314,82,4396
103,6,25,07.11.2024,9,395,562,167,5058
544,30,18,17.11.2024,2,168,203,35,406
959,3,22,10.11.2024,5,47,58,11,290
836,8,13,10.11.2024,12,42,57,15,684
567,6,26,24.11.2024,8,71,83,12,664
483,12,25,12.11.2024,15,202,229,27,3435
625,3,4,23.11.2024,11,161,170,9,1870
293,21,9,07.11.2024,3,270,370,100,1110
663,10,8,14.11.2024,20,199,291,92,5820
87,29,2,22.11.2024,6,339,445,106,2670
496,4,22,21.11.2024,4,174,215,41,860
700,19,4,22.11.2024,15,310,380,70,5700
802,11,26,03.11.2024,15,123,138,15,2070
115,27,14,05.11.2024,20,60,64,4,1280
516,16,8,27.11.2024,20,95,104,9,2080
564,8,13,19.11.2024,3,398,497,99,1491
696,15,14,25.11.2024,16,75,79,4,1264
141,19,17,22.11.2024,15,254,317,63,4755
300,12,28,20.11.2024,20,423,460,37,9200
885,7,2,09.11.2024,9,173,182,9,1638
182,1,5,25.11.2024,13,376,483,107,6279
574,16,18,20.11.2024,2,446,617,171,1234
318,21,12,29.11.2024,2,102,121,19,242
410,15,25,13.11.2024,2,134,188,54,376
279,1,20,25.11.2024,7,151,205,54,1435
471,22,12,10.11.2024,3,278,382,104,1146
246,26,14,18.11.2024,17,66,72,6,1224
250,27,18,22.11.2024,5,234,254,20,1270
893,25,11,04.11.2024,8,137,167,30,1336
103,18,10,06.11.2024,5,21,25,4,125
674,18,6,12.11.2024,8,103,144,41,1152
758,7,22,24.11.2024,3,443,599,156,1797
536,4,24,25.11.2024,14,127,181,54,2534
244,18,19,22.11.2024,3,331,452,121,1356
252,24,13,20.11.2024,1,244,312,68,312
724,10,21,16.11.2024,14,251,269,18,3766
24,12,5,03.11.2024,9,355,389,34,3501
52,16,30,01.11.2024,15,75,87,12,1305
575,12,28,26.11.2024,1,401,543,142,543
859,20,11,04.11.2024,6,124,131,7,786
381,3,25,04.11.2024,19,382,508,126,9652
818,21,10,12.11.2024,9,469,581,112,5229
484,5,20,13.11.2024,12,182,259,77,3108
615,6,15,14.11.2024,16,58,72,14,1152
752,22,26,04.11.2024,17,260,361,101,6137
867,14,8,19.11.2024,12,212,236,24,2832
412,25,27,13.11.2024,15,281,414,133,6210
382,12,16,07.11.2024,15,67,87,20,1305
873,17,16,24.11.2024,10,415,445,30,4450
747,5,7,22.11.2024,10,340,504,164,5040
310,10,26,13.11.2024,13,104,130,26,1690
745,7,1,10.11.2024,4,54,68,14,272
798,4,22,10.11.2024,6,321,351,30,2106
191,10,17,08.11.2024,4,308,461,153,1844
755,14,7,29.11.2024,14,146,155,9,2170
257,13,11,13.11.2024,18,489,599,110,10782
523,29,16,30.11.2024,1,124,161,37,161
799,8,1,01.11.2024,9,280,355,75,3195
618,30,21,08.11.2024,13,370,503,133,6539
81,25,12,19.11.2024,6,378,422,44,2532
978,23,20,04.11.2024,6,252,271,19,1626
338,20,8,09.11.2024,3,41,48,7,144
387,24,30,22.11.2024,5,298,324,26,1620
463,6,5,17.11.2024,6,155,171,16,1026
198,1,3,18.11.2024,4,234,307,73,1228
969,13,21,02.11.2024,16,181,226,45,3616
628,24,26,27.11.2024,17,335,477,142,8109
489,29,10,19.11.2024,20,235,311,76,6220
324,6,30,28.11.2024,5,71,79,8,395
286,18,28,14.11.2024,11,494,598,104,6578
756,4,18,20.11.2024,18,338,507,169,9126
913,1,14,03.11.2024,16,121,171,50,2736
875,28,23,11.11.2024,14,434,474,40,6636
418,7,27,04.11.2024,6,306,457,151,2742
376,27,12,15.11.2024,6,378,524,146,3144
106,14,20,10.11.2024,20,217,276,59,5520
575,17,3,03.11.2024,19,423,484,61,9196
874,23,23,19.11.2024,19,446,479,33,9101
544,6,23,02.11.2024,4,387,518,131,2072
14,16,3,14.11.2024,16,187,263,76,4208
713,6,4,13.11.2024,8,405,551,146,4408
432,30,4,26.11.2024,8,57,75,18,600
540,11,9,19.11.2024,2,382,409,27,818
706,20,27,02.11.2024,8,249,279,30,2232
366,24,10,12.11.2024,17,393,501,108,8517
350,23,14,29.11.2024,8,346,507,161,4056
562,25,27,04.11.2024,5,251,295,44,1475
