ID_zbozi,ID_lekarna,ID_vedouci,datum,pocet_prodanych_ks,nakupni_cena_CZK,prodejni_cena_CZK,marze_CZK,trzba_CZK
655,4,1,20.05.2024,8,134,149,15,120
105,22,24,06.10.2024,3,322,399,77,231
31,3,7,29.04.2024,17,328,348,20,340
204,23,21,25.12.2024,18,234,269,35,630
604,9,26,04.01.2024,6,377,468,91,546
285,5,7,21.06.2024,4,67,82,15,60
368,28,12,05.11.2024,9,433,463,30,270
471,18,4,12.07.2024,3,302,357,55,165
644,20,29,04.07.2024,19,118,161,43,817
47,22,8,28.05.2024,3,457,528,71,213
104,13,9,20.08.2024,12,103,125,22,264
215,22,9,25.12.2024,3,331,442,111,333
547,24,8,24.03.2024,15,214,251,37,555
948,21,23,12.10.2024,8,370,442,72,576
787,25,2,27.04.2024,2,432,515,83,166
275,3,7,17.10.2024,11,128,172,44,484
406,29,30,25.11.2024,15,93,109,16,240
253,24,18,02.10.2024,9,402,528,126,1134
920,19,13,04.07.2024,8,90,115,25,200
94,25,2,26.02.2024,5,341,383,42,210
697,14,20,02.02.2024,13,215,283,68,884
480,17,9,10.10.2024,1,368,506,138,138
699,29,18,16.05.2024,11,77,91,14,154
162,15,1,14.05.2024,17,410,463,53,901
935,4,28,16.11.2024,10,450,602,152,1520
624,7,5,10.07.2024,6,296,438,142,852
945,17,30,01.01.2024,20,185,235,50,1000
115,30,12,06.06.2024,8,49,57,8,64
581,3,3,05.09.2024,3,409,527,118,354
129,5,22,31.08.2024,18,104,122,18,324
894,20,14,18.04.2024,18,406,560,154,2772
206,23,10,23.07.2024,12,244,355,111,1332
463,4,8,25.04.2024,3,193,204,11,33
568,8,19,22.04.2024,1,56,77,21,21
61,8,3,17.01.2024,11,56,72,16,176
286,22,16,19.04.2024,18,87,120,33,594
904,19,19,30.08.2024,8,421,532,111,888
417,7,4,19.02.2024,14,201,249,48,672
479,28,24,28.01.2024,4,51,63,12,48
348,26,28,25.02.2024,8,118,134,16,128
460,5,14,03.04.2024,9,256,298,42,378
946,3,15,08.10.2024,4,45,60,15,60
554,27,1,17.02.2024,8,105,129,24,192
493,7,28,24.07.2024,2,104,127,23,46
400,9,30,20.08.2024,10,236,322,86,860
749,26,18,04.12.2024,16,99,112,13,208
223,2,19,04.10.2024,2,402,479,77,154
52,19,16,14.09.2024,17,100,108,8,136
521,3,28,05.04.2024,3,324,350,26,78
883,8,13,02.03.2024,19,146,191,45,855
41,20,3,02.08.2024,19,309,397,88,1672
958,9,7,08.12.2024,11,142,166,24,264
135,22,21,02.06.2024,15,181,266,85,1275
959,3,1,22.08.2024,20,308,461,153,3060
76,18,7,16.09.2024,9,87,128,41,369
903,3,29,05.05.2024,12,165,185,20,240
854,18,23,03.06.2024,20,433,582,149,2980
9,22,27,10.10.2024,10,497,670,173,1730
962,29,5,15.05.2024,4,475,522,47,188
567,5,9,24.05.2024,20,127,174,47,940
209,22,21,15.05.2024,17,270,314,44,748
930,28,2,17.02.2024,14,444,521,77,1078
4,11,25,07.03.2024,9,102,141,39,351
565,23,14,14.10.2024,1,77,83,6,6
905,23,29,17.03.2024,18,38,54,16,288
597,18,5,08.08.2024,5,41,49,8,40
921,30,26,21.01.2024,12,127,172,45,540
683,4,12,13.10.2024,14,337,468,131,1834
948,30,8,24.03.2024,6,471,582,111,666
184,24,30,19.06.2024,14,430,581,151,2114
753,26,8,16.05.2024,6,423,578,155,930
392,28,2,28.08.2024,8,122,173,51,408
472,12,10,26.04.2024,8,32,43,11,88
409,11,9,05.02.2024,9,199,266,67,603
410,22,27,01.10.2024,11,500,531,31,341
899,9,6,24.10.2024,9,39,43,4,36
445,12,24,09.06.2024,14,330,493,163,2282
119,13,29,22.10.2024,7,150,160,10,70
447,1,17,02.10.2024,7,206,256,50,350
972,22,30,18.06.2024,20,180,243,63,1260
128,24,29,02.06.2024,17,178,240,62,1054
335,13,23,31.05.2024,18,85,97,12,216
681,13,22,30.03.2024,20,311,369,58,1160
562,27,1,04.06.2024,10,127,158,31,310
594,20,21,13.06.2024,15,246,307,61,915
219,17,16,27.03.2024,3,165,212,47,141
649,20,11,17.02.2024,8,364,433,69,552
826,7,5,13.01.2024,2,145,216,71,142
626,28,25,07.02.2024,15,232,336,104,1560
590,7,23,22.12.2024,13,273,336,63,819
152,21,23,03.01.2024,4,418,519,101,404
181,26,23,22.09.2024,15,45,59,14,210
940,28,4,21.08.2024,5,430,541,111,555
544,18,20,11.06.2024,15,333,472,139,2085
914,17,14,07.10.2024,15,479,537,58,870
883,16,15,12.05.2024,8,450,602,152,1216
785,25,17,05.09.2024,8,160,200,40,320
731,10,8,19.05.2024,11,183,266,83,913
83,5,5,28.04.2024,13,375,420,45,585
220,3,14,27.07.2024,11,297,374,77,847
64,7,27,03.08.2024,13,483,674,191,2483
969,23,1,21.10.2024,13,264,278,14,182
361,10,25,18.07.2024,14,295,409,114,1596
560,26,20,22.04.2024,16,132,155,23,368
498,1,13,21.06.2024,13,390,438,48,624
479,30,5,14.11.2024,18,33,48,15,270
607,19,22,14.01.2024,3,349,434,85,255
888,15,6,26.01.2024,9,214,256,42,378
466,11,11,13.07.2024,9,405,599,194,1746
432,9,27,11.02.2024,16,29,40,11,176
54,12,8,28.11.2024,3,419,620,201,603
42,25,1,06.05.2024,7,449,476,27,189
157,8,5,30.08.2024,4,308,455,147,588
477,23,9,07.07.2024,6,330,437,107,642
766,23,4,24.03.2024,10,75,98,23,230
952,10,19,12.12.2024,13,223,329,106,1378
204,3,19,19.12.2024,8,72,98,26,208
309,28,22,03.11.2024,4,427,637,210,840
802,2,12,29.09.2024,14,358,436,78,1092
519,21,11,07.01.2024,14,441,560,119,1666
444,12,21,23.08.2024,5,242,273,31,155
535,21,9,11.11.2024,18,416,527,111,1998
447,27,24,30.10.2024,9,185,265,80,720
851,30,3,22.05.2024,15,144,200,56,840
584,20,22,13.07.2024,11,34,43,9,99
333,6,16,18.04.2024,12,428,499,71,852
287,29,20,25.12.2024,9,304,321,17,153
971,7,3,03.05.2024,14,270,351,81,1134
247,23,16,26.11.2024,16,249,350,101,1616
96,10,8,26.07.2024,8,176,237,61,488
378,16,18,28.09.2024,12,237,355,118,1416
564,11,12,25.12.2024,15,158,188,30,450
237,4,24,08.04.2024,11,81,112,31,341
974,25,23,04.04.2024,7,130,180,50,350
284,24,19,25.09.2024,20,164,245,81,1620
853,7,10,26.04.2024,12,111,132,21,252
726,18,5,20.05.2024,2,47,61,14,28
715,5,21,08.09.2024,4,466,492,26,104
292,16,16,13.08.2024,11,114,169,55,605
259,28,16,28.02.2024,3,225,286,61,183
591,21,22,28.01.2024,5,96,136,40,200
972,10,3,07.05.2024,4,305,425,120,480
621,20,26,12.11.2024,8,417,536,119,952
462,30,15,01.06.2024,19,239,284,45,855
636,2,20,20.02.2024,7,340,389,49,343
677,3,6,02.05.2024,6,302,327,25,150
3,14,15,18.12.2024,20,260,307,47,940
238,10,23,24.05.2024,15,56,76,20,300
947,9,26,16.11.2024,19,358,505,147,2793
203,14,4,05.10.2024,8,351,392,41,328
273,27,5,06.02.2024,2,104,146,42,84
610,24,27,18.10.2024,10,244,270,26,260
706,10,23,25.07.2024,9,276,357,81,729
449,3,20,21.01.2024,14,396,473,77,1078
257,1,3,27.04.2024,19,320,473,153,2907
784,22,27,17.05.2024,19,40,56,16,304
180,16,17,29.11.2024,15,489,575,86,1290
600,14,21,08.09.2024,3,260,314,54,162
342,11,22,23.02.2024,6,188,232,44,264
508,10,22,24.07.2024,18,38,48,10,180
323,9,11,29.02.2024,13,462,592,130,1690
2,22,28,04.10.2024,15,231,248,17,255
531,12,20,12.09.2024,15,409,439,30,450
274,18,5,27.05.2024,15,470,641,171,2565
125,1,21,07.11.2024,8,383,429,46,368
565,1,18,27.07.2024,3,135,202,67,201
935,4,15,01.03.2024,5,275,404,129,645
299,17,23,19.05.2024,14,447,566,119,1666
484,8,15,09.10.2024,5,216,245,29,145
614,17,24,10.03.2024,3,161,225,64,192
875,14,11,16.09.2024,9,440,463,23,207
744,10,27,27.10.2024,19,357,454,97,1843
153,15,18,04.09.2024,12,190,247,57,684
557,13,15,13.06.2024,7,377,436,59,413
393,8,28,29.07.2024,2,182,252,70,140
723,30,26,14.07.2024,13,359,505,146,1898
668,5,16,19.01.2024,5,277,411,134,670
340,28,4,13.08.2024,4,289,422,133,532
16,24,5,28.07.2024,5,58,73,15,75
993,9,11,15.11.2024,13,352,382,30,390
337,28,22,30.09.2024,13,182,242,60,780
909,25,16,04.10.2024,2,336,363,27,54
647,22,30,27.05.2024,8,402,438,36,288
101,25,21,26.12.2024,4,247,278,31,124
307,29,1,24.01.2024,11,427,459,32,352
368,12,14,15.03.2024,8,291,360,69,552
699,26,6,28.03.2024,6,60,79,19,114
392,20,22,03.05.2024,16,487,639,152,2432
238,15,21,10.05.2024,15,150,203,53,795
921,26,15,27.05.2024,18,100,108,8,144
968,12,19,02.06.2024,14,373,434,61,854
866,10,7,15.07.2024,16,74,86,12,192
586,12,19,31.05.2024,10,31,46,15,150
675,13,9,05.01.2024,19,462,628,166,3154
763,2,30,06.11.2024,16,446,650,204,3264
294,25,26,27.04.2024,20,430,520,90,1800
652,7,20,08.05.2024,5,341,373,32,160
643,21,2,07.06.2024,15,37,48,11,165
750,5,3,31.05.2024,11,402,497,95,1045
206,5,26,03.10.2024,12,291,371,80,960
280,27,6,11.05.2024,16,432,511,79,1264
892,11,26,28.02.2024,15,58,65,7,105
990,8,28,12.12.2024,13,453,640,187,2431
375,3,26,21.07.2024,1,155,200,45,45
466,12,22,10.12.2024,9,319,390,71,639
654,12,4,11.12.2024,8,261,277,16,128
906,18,11,08.11.2024,8,351,379,28,224
844,15,30,24.12.2024,10,352,434,82,820
144,2,2,04.06.2024,16,79,86,7,112
909,18,5,17.07.2024,15,209,283,74,1110
761,23,18,02.08.2024,19,400,551,151,2869
907,14,21,20.02.2024,16,335,413,78,1248
975,9,2,19.12.2024,12,131,164,33,396
974,8,28,04.07.2024,4,371,451,80,320
924,21,12,01.02.2024,13,161,183,22,286
126,28,27,20.08.2024,3,359,411,52,156
655,20,1,26.01.2024,11,144,215,71,781
806,19,7,05.02.2024,18,126,166,40,720
833,28,8,17.06.2024,5,423,616,193,965
3,9,28,15.03.2024,5,296,344,48,240
179,4,22,14.01.2024,5,27,33,6,30
808,8,19,14.06.2024,1,109,127,18,18
130,24,14,26.09.2024,4,401,433,32,128
460,25,12,19.09.2024,19,75,94,19,361
227,20,2,03.12.2024,17,174,219,45,765
988,1,2,02.09.2024,13,238,323,85,1105
503,23,30,15.08.2024,3,480,521,41,123
623,5,3,05.03.2024,9,339,453,114,1026
562,23,11,14.07.2024,20,291,344,53,1060
518,20,14,20.02.2024,4,456,613,157,628
899,25,18,20.04.2024,14,251,364,113,1582
424,11,27,20.08.2024,13,232,320,88,1144
321,14,11,06.12.2024,9,211,312,101,909
704,30,16,04.02.2024,3,445,484,39,117
443,4,24,09.07.2024,5,304,327,23,115
980,18,18,17.06.2024,4,230,278,48,192
682,25,14,27.01.2024,10,327,389,62,620
107,19,17,18.04.2024,5,356,451,95,475
868,4,12,11.10.2024,12,78,109,31,372
588,8,26,07.08.2024,18,412,584,172,3096
629,22,21,12.10.2024,1,331,486,155,155
850,23,9,15.01.2024,6,159,217,58,348
317,30,11,28.06.2024,1,112,161,49,49
580,22,13,05.02.2024,5,399,533,134,670
32,3,24,28.09.2024,7,212,263,51,357
350,6,12,08.06.2024,11,417,615,198,2178
611,3,29,27.01.2024,5,100,139,39,195
51,22,3,19.05.2024,15,358,444,86,1290
622,15,14,19.05.2024,7,406,520,114,798
354,14,4,25.05.2024,19,269,346,77,1463
316,2,8,21.07.2024,20,48,51,3,60
309,7,25,11.03.2024,9,168,201,33,297
8,16,24,08.08.2024,6,86,105,19,114
721,8,17,13.10.2024,12,56,69,13,156
760,2,14,10.01.2024,15,491,533,42,630
321,19,14,20.10.2024,13,383,512,129,1677
297,4,13,11.01.2024,11,107,151,44,484
633,15,27,19.12.2024,12,65,81,16,192
109,8,14,28.10.2024,13,288,313,25,325
892,10,24,22.06.2024,8,190,266,76,608
79,17,21,28.02.2024,17,281,320,39,663
795,12,12,26.11.2024,5,140,153,13,65
263,7,6,04.11.2024,5,409,569,160,800
78,6,25,17.11.2024,16,257,357,100,1600
779,19,15,14.12.2024,19,349,466,117,2223
640,11,28,17.11.2024,11,97,121,24,264
481,15,21,04.06.2024,9,322,346,24,216
520,3,10,24.08.2024,15,39,42,3,45
852,10,3,26.11.2024,3,334,440,106,318
394,15,19,10.10.2024,2,250,365,115,230
586,21,7,13.06.2024,20,263,335,72,1440
981,2,15,22.02.2024,11,385,419,34,374
662,6,2,06.05.2024,15,244,314,70,1050
625,6,12,09.07.2024,10,218,269,51,510
347,22,20,27.01.2024,11,53,64,11,121
572,22,13,25.05.2024,9,390,559,169,1521
988,30,20,17.03.2024,11,61,80,19,209
145,30,12,07.06.2024,13,86,113,27,351
961,3,10,13.10.2024,13,349,491,142,1846
833,5,22,25.12.2024,17,67,90,23,391
434,17,12,10.01.2024,12,178,201,23,276
220,11,25,05.09.2024,7,135,202,67,469
159,3,10,21.02.2024,17,414,535,121,2057
757,29,17,20.01.2024,11,468,653,185,2035
135,20,13,19.03.2024,6,112,159,47,282
790,20,26,25.03.2024,15,42,52,10,150
693,24,8,15.08.2024,20,165,229,64,1280
803,15,8,30.09.2024,8,178,264,86,688
804,16,29,09.04.2024,12,367,542,175,2100
452,15,25,24.05.2024,13,277,357,80,1040
990,6,27,12.04.2024,20,90,130,40,800
54,21,16,09.07.2024,18,498,546,48,864
867,17,28,04.03.2024,10,62,86,24,240
280,15,29,19.09.2024,5,445,555,110,550
970,30,8,18.08.2024,12,496,527,31,372
55,13,17,10.07.2024,8,217,325,108,864
384,8,1,12.06.2024,4,449,616,167,668
344,26,5,11.03.2024,2,166,243,77,154
484,23,27,12.03.2024,16,249,330,81,1296
928,3,1,11.05.2024,7,447,499,52,364
963,24,20,27.09.2024,14,76,106,30,420
244,10,4,25.01.2024,8,234,313,79,632
638,15,3,26.02.2024,16,325,420,95,1520
648,17,19,03.05.2024,5,169,210,41,205
630,12,8,19.10.2024,14,115,155,40,560
88,17,12,04.02.2024,17,298,381,83,1411
520,18,1,18.07.2024,16,42,56,14,224
383,9,24,09.01.2024,12,423,457,34,408
247,24,22,17.11.2024,4,415,544,129,516
775,11,5,23.01.2024,12,299,360,61,732
659,6,27,16.12.2024,15,376,476,100,1500
187,26,5,02.02.2024,15,38,45,7,105
45,26,7,22.01.2024,11,497,591,94,1034
408,27,18,30.08.2024,9,38,53,15,135
196,10,12,25.01.2024,11,159,176,17,187
377,14,29,23.07.2024,15,478,708,230,3450
348,6,16,20.12.2024,16,208,305,97,1552
532,9,26,12.02.2024,14,60,75,15,210
843,6,18,30.05.2024,11,72,78,6,66
677,10,10,16.08.2024,20,387,481,94,1880
707,15,12,16.08.2024,2,392,565,173,346
362,20,14,20.05.2024,2,58,78,20,40
416,12,17,13.12.2024,6,35,39,4,24
623,22,26,12.08.2024,2,84,91,7,14
798,21,12,04.07.2024,13,310,330,20,260
158,22,15,08.07.2024,12,247,344,97,1164
588,5,17,06.07.2024,13,180,242,62,806
256,4,1,05.04.2024,16,285,349,64,1024
576,4,9,13.05.2024,15,129,193,64,960
293,23,30,08.09.2024,7,82,91,9,63
76,15,6,31.12.2024,15,64,91,27,405
991,28,11,07.12.2024,12,383,413,30,360
556,10,29,02.06.2024,6,384,526,142,852
718,21,6,04.07.2024,17,134,148,14,238
206,26,5,01.05.2024,16,33,40,7,112
587,12,15,09.10.2024,5,333,482,149,745
68,10,13,02.09.2024,17,230,321,91,1547
844,19,3,05.03.2024,11,348,377,29,319
478,22,17,25.06.2024,5,469,667,198,990
565,21,19,03.04.2024,5,241,308,67,335
890,2,27,04.03.2024,17,98,116,18,306
166,11,30,29.12.2024,8,197,291,94,752
532,29,10,10.02.2024,9,120,160,40,360
565,9,5,16.11.2024,10,334,431,97,970
515,21,6,30.10.2024,19,98,110,12,228
640,24,29,05.11.2024,11,451,661,210,2310
43,27,28,15.01.2024,3,43,64,21,63
790,19,9,29.11.2024,7,412,539,127,889
633,21,1,11.09.2024,18,168,225,57,1026
310,16,8,16.12.2024,13,172,216,44,572
706,2,6,13.08.2024,14,267,336,69,966
349,20,5,09.06.2024,11,395,590,195,2145
354,13,5,08.07.2024,17,307,337,30,510
248,15,4,16.05.2024,15,146,163,17,255
52,10,13,11.11.2024,14,147,218,71,994
924,6,27,16.06.2024,19,389,463,74,1406
782,6,16,20.09.2024,15,275,398,123,1845
510,1,3,20.07.2024,17,254,377,123,2091
221,19,12,25.01.2024,2,164,209,45,90
904,27,21,10.12.2024,16,166,214,48,768
868,4,14,09.03.2024,9,392,476,84,756
413,12,2,24.07.2024,2,311,405,94,188
372,18,10,07.02.2024,13,278,348,70,910
564,9,27,15.11.2024,20,80,89,9,180
100,13,12,22.06.2024,18,500,607,107,1926
148,7,20,17.09.2024,13,276,295,19,247
40,5,23,19.06.2024,16,285,358,73,1168
621,29,17,12.03.2024,11,496,658,162,1782
167,13,20,02.06.2024,19,192,245,53,1007
522,18,16,28.12.2024,19,173,219,46,874
18,12,11,10.12.2024,4,233,306,73,292
816,29,24,18.12.2024,1,325,411,86,86
991,21,26,23.10.2024,19,136,187,51,969
598,16,6,25.09.2024,20,416,594,178,3560
152,27,22,04.05.2024,2,313,462,149,298
113,7,1,13.08.2024,11,234,262,28,308
708,7,14,13.09.2024,20,491,620,129,2580
869,24,24,01.02.2024,5,285,326,41,205
333,22,16,26.09.2024,13,180,266,86,1118
471,30,18,24.06.2024,18,201,272,71,1278
889,24,22,25.11.2024,9,332,421,89,801
981,8,9,12.10.2024,10,135,199,64,640
305,25,10,26.12.2024,7,373,510,137,959
325,16,12,13.10.2024,9,167,185,18,162
693,18,13,21.07.2024,12,415,586,171,2052
298,2,10,31.12.2024,3,197,289,92,276
672,9,24,02.09.2024,7,123,175,52,364
278,30,18,22.12.2024,9,90,99,9,81
759,19,8,04.05.2024,2,362,528,166,332
232,21,8,27.01.2024,4,231,277,46,184
484,4,22,11.03.2024,1,301,449,148,148
162,14,21,31.08.2024,16,353,402,49,784
988,10,11,26.05.2024,2,484,676,192,384
668,19,8,30.09.2024,2,487,713,226,452
428,29,27,31.03.2024,2,448,550,102,204
508,6,30,28.05.2024,2,24,28,4,8
618,4,30,20.06.2024,10,252,377,125,1250
557,17,16,09.03.2024,17,259,304,45,765
829,4,11,24.03.2024,15,351,409,58,870
191,1,24,21.06.2024,10,310,420,110,1100
198,6,20,23.11.2024,13,443,550,107,1391
336,3,13,08.12.2024,4,114,170,56,224
489,11,30,07.05.2024,1,153,187,34,34
458,25,9,17.06.2024,10,318,437,119,1190
12,9,21,03.07.2024,8,51,69,18,144
477,10,6,26.07.2024,17,492,715,223,3791
721,25,10,19.12.2024,4,347,507,160,640
303,12,20,23.04.2024,8,88,111,23,184
466,24,20,10.07.2024,14,379,492,113,1582
483,25,18,06.12.2024,7,410,476,66,462
773,20,28,11.02.2024,17,248,319,71,1207
371,3,30,15.10.2024,4,51,73,22,88
925,17,7,20.10.2024,18,96,108,12,216
875,17,15,29.02.2024,7,387,508,121,847
94,29,17,16.08.2024,2,252,280,28,56
426,15,19,30.01.2024,18,256,346,90,1620
316,24,1,21.07.2024,9,438,460,22,198
224,19,3,24.01.2024,14,196,268,72,1008
555,2,30,05.02.2024,16,36,42,6,96
185,25,5,24.11.2024,14,211,316,105,1470
392,15,28,12.07.2024,13,61,83,22,286
678,28,18,09.03.2024,12,80,90,10,120
551,13,17,06.03.2024,8,447,470,23,184
24,10,15,10.12.2024,18,237,306,69,1242
844,8,8,23.08.2024,12,99,116,17,204
960,29,24,27.02.2024,2,434,585,151,302
630,25,30,09.01.2024,8,125,135,10,80
609,2,15,02.11.2024,2,145,201,56,112
412,15,8,03.10.2024,7,406,584,178,1246
58,5,17,28.05.2024,8,437,639,202,1616
590,11,19,02.11.2024,11,141,167,26,286
147,22,17,23.04.2024,14,173,203,30,420
571,19,29,30.03.2024,14,304,387,83,1162
996,12,21,09.12.2024,13,422,543,121,1573
714,14,14,17.03.2024,10,212,240,28,280
551,16,8,25.04.2024,10,459,628,169,1690
826,15,30,30.01.2024,18,231,343,112,2016
571,17,5,17.07.2024,8,150,171,21,168
663,3,30,18.08.2024,12,67,86,19,228
850,7,2,17.05.2024,13,364,481,117,1521
41,28,3,06.04.2024,19,390,527,137,2603
223,16,7,19.06.2024,10,485,513,28,280
960,7,24,01.03.2024,16,488,566,78,1248
619,23,7,22.07.2024,8,302,361,59,472
290,13,15,30.09.2024,12,177,207,30,360
526,29,16,26.08.2024,4,431,643,212,848
481,25,27,12.06.2024,7,209,249,40,280
47,19,28,23.04.2024,5,28,33,5,25
958,19,19,01.08.2024,10,98,112,14,140
236,13,19,05.05.2024,16,301,405,104,1664
702,11,9,07.09.2024,16,255,287,32,512
815,12,6,12.03.2024,18,270,306,36,648
911,18,21,31.01.2024,17,37,53,16,272
77,27,22,25.01.2024,1,231,257,26,26
646,8,3,28.12.2024,5,24,28,4,20
467,12,2,12.11.2024,20,487,617,130,2600
500,1,1,29.09.2024,18,230,243,13,234
543,24,9,01.10.2024,10,28,36,8,80
715,22,14,01.04.2024,4,490,536,46,184
153,8,7,13.11.2024,17,149,211,62,1054
274,26,13,10.02.2024,12,227,285,58,696
250,23,8,02.06.2024,3,354,530,176,528
666,25,2,17.02.2024,13,214,261,47,611
488,2,21,05.01.2024,6,62,79,17,102
445,21,26,18.06.2024,19,459,683,224,4256
917,17,30,22.01.2024,8,128,186,58,464
709,29,19,31.08.2024,9,43,63,20,180
701,30,9,05.10.2024,19,356,379,23,437
952,28,11,09.01.2024,7,320,357,37,259
841,23,27,22.07.2024,3,173,194,21,63
247,19,27,18.07.2024,18,189,231,42,756
758,5,26,18.12.2024,3,276,382,106,318
355,2,4,11.08.2024,8,449,487,38,304
620,25,20,31.10.2024,13,416,498,82,1066
650,9,26,18.08.2024,16,136,165,29,464
964,13,14,05.04.2024,19,358,437,79,1501
791,20,10,06.05.2024,3,62,73,11,33
390,23,26,20.11.2024,5,398,488,90,450
370,4,3,03.01.2024,10,247,299,52,520
277,4,5,14.02.2024,6,240,300,60,360
569,17,14,22.02.2024,1,65,79,14,14
96,20,20,15.06.2024,13,26,31,5,65
398,25,3,13.10.2024,8,312,401,89,712
702,13,6,12.03.2024,9,174,204,30,270
150,3,6,10.08.2024,9,235,278,43,387
802,3,12,08.05.2024,8,389,518,129,1032
609,20,7,22.08.2024,4,89,106,17,68
972,13,11,13.11.2024,13,431,620,189,2457
451,11,14,29.11.2024,20,89,105,16,320
618,23,7,02.09.2024,11,110,163,53,583
992,11,10,21.12.2024,16,314,440,126,2016
334,13,9,20.07.2024,12,78,115,37,444
205,19,18,02.04.2024,18,33,49,16,288
473,23,7,12.08.2024,10,445,606,161,1610
839,28,26,28.07.2024,16,91,121,30,480
248,9,22,19.03.2024,14,424,517,93,1302
460,20,16,25.10.2024,13,293,374,81,1053
943,28,23,02.08.2024,18,38,53,15,270
369,23,29,01.10.2024,20,346,506,160,3200
112,25,8,02.12.2024,12,105,141,36,432
46,19,21,12.12.2024,13,405,486,81,1053
816,14,4,06.01.2024,4,152,175,23,92
765,17,18,24.10.2024,19,133,166,33,627
401,15,25,13.12.2024,19,373,476,103,1957
354,1,16,23.02.2024,10,232,340,108,1080
88,4,27,13.03.2024,12,179,216,37,444
804,7,17,04.09.2024,12,263,288,25,300
740,23,15,12.06.2024,3,173,185,12,36
728,4,1,24.06.2024,4,366,516,150,600
953,24,8,21.09.2024,6,302,339,37,222
574,14,15,28.04.2024,13,342,387,45,585
656,22,14,21.07.2024,1,397,527,130,130
203,15,19,07.08.2024,13,22,30,8,104
211,9,25,26.12.2024,3,315,345,30,90
893,18,6,06.07.2024,11,120,151,31,341
269,22,28,07.09.2024,17,347,413,66,1122
398,20,13,27.10.2024,4,198,239,41,164
469,20,6,10.12.2024,10,490,650,160,1600
87,22,5,09.06.2024,4,142,169,27,108
188,12,23,13.03.2024,17,218,270,52,884
142,19,13,04.08.2024,6,269,359,90,540
711,30,21,29.03.2024,18,105,133,28,504
144,6,11,18.08.2024,20,47,68,21,420
975,1,16,10.03.2024,7,437,534,97,679
576,17,21,10.09.2024,14,370,470,100,1400
728,27,15,07.09.2024,6,62,81,19,114
815,25,8,29.05.2024,2,160,184,24,48
296,6,25,22.08.2024,19,400,559,159,3021
508,18,17,27.02.2024,19,78,91,13,247
557,27,12,04.10.2024,2,409,562,153,306
560,7,14,22.02.2024,8,172,248,76,608
34,15,9,27.06.2024,3,244,351,107,321
121,25,26,01.05.2024,7,435,601,166,1162
706,12,28,29.12.2024,20,343,426,83,1660
631,5,26,15.04.2024,7,432,465,33,231
360,18,9,01.11.2024,18,106,127,21,378
721,10,10,20.10.2024,9,459,588,129,1161
922,22,27,18.02.2024,5,404,567,163,815
941,2,9,01.12.2024,5,379,546,167,835
256,5,23,13.06.2024,8,409,585,176,1408
403,16,5,22.10.2024,9,341,422,81,729
463,3,21,17.02.2024,13,283,393,110,1430
712,30,29,07.07.2024,15,269,322,53,795
3,28,25,17.02.2024,15,345,465,120,1800
367,28,3,30.09.2024,13,131,195,64,832
845,7,16,17.05.2024,11,444,523,79,869
561,19,5,16.10.2024,16,423,510,87,1392
699,25,2,24.01.2024,4,340,477,137,548
471,1,4,21.03.2024,15,253,266,13,195
982,14,7,18.12.2024,5,471,632,161,805
163,28,30,20.05.2024,3,355,430,75,225
85,12,22,28.11.2024,6,46,57,11,66
313,24,23,29.04.2024,14,355,387,32,448
98,1,7,01.09.2024,3,87,115,28,84
532,22,15,05.01.2024,1,376,453,77,77
124,28,14,21.12.2024,5,264,286,22,110
393,3,24,22.02.2024,4,180,219,39,156
307,5,13,09.03.2024,5,55,71,16,80
9,20,21,25.03.2024,15,199,274,75,1125
644,24,5,29.07.2024,20,371,463,92,1840
223,3,29,21.02.2024,5,405,448,43,215
748,13,12,07.08.2024,11,425,473,48,528
284,21,3,07.05.2024,18,327,432,105,1890
623,10,25,19.12.2024,1,454,650,196,196
897,10,7,22.09.2024,20,280,318,38,760
402,10,21,28.01.2024,8,273,334,61,488
247,16,21,31.10.2024,3,290,420,130,390
13,12,30,11.06.2024,5,218,313,95,475
583,14,12,06.10.2024,6,410,517,107,642
789,3,1,27.10.2024,3,27,32,5,15
41,30,2,22.07.2024,17,166,221,55,935
514,25,14,04.08.2024,13,62,83,21,273
551,20,5,22.05.2024,3,178,193,15,45
944,7,26,20.03.2024,18,187,229,42,756
650,25,27,28.11.2024,3,178,243,65,195
748,28,8,30.01.2024,8,64,94,30,240
119,15,20,07.11.2024,2,178,240,62,124
674,24,6,02.03.2024,1,382,425,43,43
12,6,16,26.06.2024,17,284,398,114,1938
739,9,6,09.07.2024,5,403,565,162,810
276,24,29,01.03.2024,1,191,270,79,79
279,17,3,14.05.2024,19,341,370,29,551
467,17,12,29.01.2024,16,459,599,140,2240
377,6,9,22.02.2024,19,365,502,137,2603
234,24,17,02.01.2024,2,459,660,201,402
251,2,16,05.07.2024,13,491,549,58,754
954,28,2,10.10.2024,14,134,160,26,364
427,30,24,12.06.2024,9,442,480,38,342
382,4,17,10.12.2024,2,111,128,17,34
529,2,13,05.02.2024,15,463,545,82,1230
866,10,11,14.02.2024,18,253,267,14,252
206,10,19,04.06.2024,20,144,181,37,740
606,16,25,10.04.2024,18,409,576,167,3006
155,1,30,28.07.2024,1,139,180,41,41
652,27,23,05.01.2024,11,20,28,8,88
386,28,24,06.06.2024,4,125,161,36,144
244,14,16,31.01.2024,5,384,452,68,340
45,30,8,23.09.2024,14,378,549,171,2394
470,24,3,24.10.2024,4,278,309,31,124
840,13,3,30.10.2024,19,51,64,13,247
988,5,8,29.05.2024,9,455,542,87,783
821,13,23,16.06.2024,11,251,294,43,473
77,7,5,26.10.2024,4,99,109,10,40
461,15,11,27.07.2024,4,294,356,62,248
789,7,15,06.06.2024,15,155,222,67,1005
93,6,26,17.12.2024,10,443,606,163,1630
618,2,7,16.06.2024,5,66,90,24,120
992,12,13,19.09.2024,2,366,434,68,136
840,6,1,26.07.2024,15,304,422,118,1770
256,4,15,22.02.2024,5,82,87,5,25
851,25,8,07.03.2024,7,441,543,102,714
703,21,21,13.02.2024,19,320,373,53,1007
833,3,1,03.02.2024,7,482,646,164,1148
829,5,3,18.06.2024,4,41,60,19,76
52,6,30,20.10.2024,14,440,605,165,2310
509,1,13,15.12.2024,14,108,131,23,322
931,6,9,23.05.2024,15,472,527,55,825
629,20,20,05.05.2024,10,275,340,65,650
564,16,2,14.02.2024,9,216,240,24,216
205,21,29,26.09.2024,8,342,512,170,1360
557,26,1,14.07.2024,12,265,343,78,936
497,12,30,16.10.2024,17,184,225,41,697
185,1,11,01.11.2024,8,35,51,16,128
798,9,2,29.08.2024,17,203,283,80,1360
239,6,4,06.05.2024,8,156,201,45,360
811,30,24,29.01.2024,8,314,449,135,1080
817,13,12,29.03.2024,6,141,186,45,270
826,24,23,02.07.2024,19,34,46,12,228
361,19,19,13.03.2024,19,116,165,49,931
830,29,16,04.10.2024,10,109,139,30,300
93,2,8,04.11.2024,8,30,39,9,72
1,11,30,10.11.2024,7,432,479,47,329
735,6,30,14.06.2024,2,31,35,4,8
722,30,5,26.02.2024,17,460,559,99,1683
75,12,23,05.12.2024,13,320,351,31,403
310,11,5,21.03.2024,14,425,569,144,2016
499,21,11,30.03.2024,18,375,544,169,3042
629,26,12,24.04.2024,19,437,493,56,1064
315,24,23,30.05.2024,5,110,152,42,210
972,23,19,19.07.2024,19,36,41,5,95
326,30,26,09.11.2024,8,347,453,106,848
960,16,5,18.06.2024,3,141,170,29,87
328,6,21,15.02.2024,11,248,262,14,154
215,8,23,04.02.2024,12,151,212,61,732
738,1,2,16.07.2024,15,395,489,94,1410
171,29,14,09.09.2024,13,199,258,59,767
104,27,16,22.10.2024,8,103,129,26,208
819,28,2,30.05.2024,1,183,214,31,31
108,3,11,28.03.2024,13,102,141,39,507
561,29,3,22.06.2024,20,334,485,151,3020
722,1,14,30.11.2024,6,330,479,149,894
161,2,4,18.06.2024,7,117,144,27,189
568,24,30,03.10.2024,9,358,421,63,567
244,4,2,20.07.2024,19,301,430,129,2451
158,2,12,02.01.2024,14,64,76,12,168
678,21,20,02.09.2024,7,69,73,4,28
175,21,10,11.02.2024,16,452,498,46,736
804,13,16,07.09.2024,9,66,88,22,198
397,6,12,14.07.2024,12,115,144,29,348
270,15,15,14.05.2024,8,448,525,77,616
64,5,25,22.12.2024,4,63,85,22,88
828,18,14,28.10.2024,8,303,326,23,184
397,27,17,02.08.2024,18,371,534,163,2934
487,19,29,30.04.2024,16,173,188,15,240
925,28,23,18.01.2024,17,312,454,142,2414
820,19,22,13.11.2024,5,81,120,39,195
460,6,6,18.04.2024,7,84,90,6,42
81,22,14,13.04.2024,5,447,589,142,710
328,30,24,04.02.2024,3,218,283,65,195
566,11,28,21.05.2024,17,254,372,118,2006
13,26,23,15.11.2024,19,287,402,115,2185
116,14,5,16.03.2024,19,321,421,100,1900
988,4,30,24.02.2024,19,419,459,40,760
293,28,18,25.06.2024,14,155,189,34,476
498,19,20,30.08.2024,2,108,127,19,38
148,20,20,14.12.2024,13,39,48,9,117
901,11,23,01.05.2024,2,401,507,106,212
276,29,12,11.01.2024,11,438,616,178,1958
319,9,27,08.09.2024,4,464,535,71,284
308,24,15,13.06.2024,9,393,486,93,837
662,3,7,14.08.2024,7,487,692,205,1435
759,16,25,21.09.2024,12,440,473,33,396
811,6,3,08.06.2024,17,226,251,25,425
872,17,29,18.10.2024,1,108,123,15,15
853,7,27,30.01.2024,8,36,45,9,72
941,12,23,11.04.2024,9,208,295,87,783
518,13,21,04.03.2024,1,143,174,31,31
609,15,6,30.08.2024,19,302,365,63,1197
168,27,29,12.05.2024,3,165,175,10,30
51,6,28,19.10.2024,7,458,527,69,483
231,22,7,17.05.2024,14,282,299,17,238
800,25,22,05.01.2024,16,486,539,53,848
178,20,26,05.01.2024,8,149,197,48,384
966,10,23,29.12.2024,9,236,343,107,963
873,12,15,09.05.2024,7,258,306,48,336
534,27,20,22.07.2024,19,72,76,4,76
679,27,27,10.07.2024,18,351,462,111,1998
290,10,22,25.02.2024,16,52,62,10,160
284,21,11,21.05.2024,9,355,486,131,1179
914,21,10,06.04.2024,5,284,396,112,560
922,2,26,03.11.2024,13,358,427,69,897
144,24,1,01.12.2024,16,171,200,29,464
429,13,13,19.01.2024,19,382,572,190,3610
836,7,11,31.12.2024,8,371,479,108,864
804,16,30,09.12.2024,12,279,331,52,624
175,27,22,12.10.2024,6,170,186,16,96
132,24,9,13.10.2024,6,368,535,167,1002
671,3,8,30.06.2024,8,401,578,177,1416
431,26,29,18.06.2024,12,153,201,48,576
475,28,4,28.08.2024,2,463,618,155,310
595,20,3,29.08.2024,7,276,305,29,203
698,13,17,01.06.2024,14,47,68,21,294
155,5,7,24.06.2024,14,311,452,141,1974
469,5,11,02.04.2024,3,269,323,54,162
182,11,21,30.01.2024,1,251,294,43,43
780,25,6,22.10.2024,6,270,379,109,654
799,3,5,10.11.2024,14,344,428,84,1176
440,16,13,03.01.2024,2,293,334,41,82
383,1,29,13.06.2024,17,117,124,7,119
5,21,24,07.05.2024,8,375,542,167,1336
320,5,4,15.07.2024,17,321,381,60,1020
67,27,2,01.06.2024,10,253,349,96,960
611,17,11,10.08.2024,5,195,292,97,485
502,12,25,06.04.2024,6,484,708,224,1344
414,1,8,24.04.2024,5,128,177,49,245
604,17,6,04.03.2024,12,384,516,132,1584
39,13,29,23.11.2024,9,414,534,120,1080
50,20,2,04.12.2024,4,354,505,151,604
50,23,4,01.08.2024,15,214,237,23,345
259,16,23,19.03.2024,7,375,509,134,938
10,10,14,04.12.2024,4,359,461,102,408
638,20,23,11.03.2024,14,445,647,202,2828
524,24,20,01.03.2024,10,78,109,31,310
510,7,20,12.04.2024,9,445,572,127,1143
207,12,23,28.07.2024,10,102,109,7,70
509,30,7,18.12.2024,16,189,218,29,464
14,22,3,26.02.2024,19,362,461,99,1881
973,3,25,18.09.2024,3,390,536,146,438
927,9,21,28.04.2024,15,171,200,29,435
52,4,27,30.03.2024,2,456,538,82,164
821,22,11,06.08.2024,4,68,97,29,116
912,2,1,11.03.2024,6,188,228,40,240
449,20,9,17.02.2024,12,437,526,89,1068
117,13,13,21.08.2024,9,447,547,100,900
872,16,26,03.08.2024,6,77,85,8,48
744,2,28,22.03.2024,4,233,340,107,428
495,26,19,13.12.2024,15,112,148,36,540
798,12,20,15.01.2024,5,267,391,124,620
116,29,14,13.08.2024,2,52,61,9,18
322,1,23,13.12.2024,17,412,570,158,2686
742,19,8,08.12.2024,11,285,366,81,891
718,20,4,09.08.2024,8,266,321,55,440
693,21,13,17.03.2024,18,476,711,235,4230
56,1,21,21.03.2024,17,454,573,119,2023
508,28,6,08.02.2024,16,184,213,29,464
994,9,2,16.09.2024,8,301,403,102,816
413,27,8,10.02.2024,15,247,348,101,1515
459,3,28,12.09.2024,15,181,200,19,285
510,24,21,10.01.2024,4,226,279,53,212
571,18,1,16.02.2024,20,336,449,113,2260
912,17,18,15.04.2024,15,194,235,41,615
56,27,8,20.08.2024,11,306,427,121,1331
615,16,23,02.12.2024,12,386,484,98,1176
100,25,22,23.04.2024,1,194,235,41,41
649,26,10,07.10.2024,17,211,288,77,1309
47,29,6,09.09.2024,5,440,604,164,820
739,14,4,10.05.2024,20,120,136,16,320
953,28,13,20.04.2024,15,442,620,178,2670
734,11,4,31.07.2024,2,494,659,165,330
689,19,4,18.08.2024,15,357,470,113,1695
517,5,16,03.01.2024,17,396,424,28,476
958,14,27,26.10.2024,16,493,630,137,2192
944,30,6,20.12.2024,19,108,149,41,779
132,4,13,02.12.2024,20,330,478,148,2960
517,29,13,02.08.2024,20,488,664,176,3520
255,9,13,24.06.2024,10,251,354,103,1030
142,14,20,24.12.2024,17,173,247,74,1258
561,28,11,30.12.2024,18,343,394,51,918
215,20,23,28.05.2024,12,491,664,173,2076
728,21,6,14.09.2024,18,375,501,126,2268
728,4,25,29.06.2024,18,265,348,83,1494
966,22,23,01.08.2024,18,166,240,74,1332
433,26,1,24.09.2024,4,32,39,7,28
55,22,2,12.04.2024,9,404,567,163,1467
294,22,9,15.03.2024,2,373,523,150,300
209,25,18,17.01.2024,12,436,547,111,1332
631,28,22,14.10.2024,8,400,536,136,1088
399,8,17,22.12.2024,10,374,505,131,1310
949,13,13,01.08.2024,11,302,324,22,242
762,9,7,13.11.2024,15,444,511,67,1005
649,23,23,27.11.2024,12,406,534,128,1536
757,20,7,09.04.2024,10,249,281,32,320
700,3,6,29.03.2024,17,81,99,18,306
439,9,18,15.05.2024,5,102,134,32,160
262,1,11,26.08.2024,5,40,45,5,25
331,20,2,16.11.2024,20,451,608,157,3140
503,26,19,08.10.2024,12,57,80,23,276
326,17,8,04.04.2024,17,54,76,22,374
164,14,18,01.10.2024,13,67,81,14,182
905,7,22,18.06.2024,11,204,241,37,407
974,25,20,28.09.2024,16,307,436,129,2064
665,1,4,08.12.2024,12,248,287,39,468
658,20,30,14.11.2024,8,40,54,14,112
329,13,30,28.02.2024,13,151,195,44,572
290,1,30,21.09.2024,12,283,399,116,1392
457,16,2,31.05.2024,7,184,236,52,364
971,4,6,02.10.2024,18,23,31,8,144
216,22,21,19.04.2024,14,447,490,43,602
551,27,23,10.08.2024,3,402,546,144,432
25,15,23,18.06.2024,2,64,69,5,10
183,26,9,12.10.2024,3,314,446,132,396
933,9,14,17.07.2024,15,342,421,79,1185
324,1,13,10.12.2024,4,293,308,15,60
738,20,3,26.10.2024,2,378,541,163,326
367,30,17,24.02.2024,10,422,573,151,1510
622,3,10,12.08.2024,13,222,315,93,1209
32,16,6,30.09.2024,8,89,123,34,272
816,26,28,06.10.2024,10,344,384,40,400
694,29,30,27.11.2024,12,25,32,7,84
569,5,4,22.01.2024,1,313,413,100,100
551,18,3,05.06.2024,7,403,558,155,1085
744,12,7,30.07.2024,17,92,103,11,187
227,20,27,09.05.2024,7,78,88,10,70
819,19,28,28.01.2024,18,256,343,87,1566
75,10,22,04.02.2024,9,70,80,10,90
595,16,11,01.07.2024,5,363,488,125,625
103,10,20,05.02.2024,7,182,231,49,343
337,20,22,05.06.2024,19,98,128,30,570
374,26,11,07.08.2024,6,22,26,4,24
805,8,23,24.11.2024,14,161,230,69,966
138,22,24,18.06.2024,16,256,320,64,1024
794,10,16,09.10.2024,4,109,146,37,148
84,27,9,12.03.2024,18,120,140,20,360
908,21,3,08.02.2024,1,454,580,126,126
32,27,19,23.10.2024,13,413,543,130,1690
929,2,18,13.05.2024,18,477,715,238,4284
484,21,25,17.03.2024,12,220,253,33,396
791,19,24,28.05.2024,5,257,328,71,355
93,13,12,14.09.2024,1,359,416,57,57
988,26,20,16.12.2024,6,407,522,115,690
457,6,6,16.10.2024,19,357,515,158,3002
150,24,24,04.09.2024,12,40,46,6,72
500,8,3,15.05.2024,12,139,149,10,120
212,17,30,03.07.2024,13,260,380,120,1560
903,2,2,28.11.2024,11,72,98,26,286
534,21,27,20.05.2024,9,316,409,93,837
179,13,21,12.07.2024,12,320,430,110,1320
856,3,17,08.05.2024,13,484,557,73,949
416,12,27,25.06.2024,16,425,538,113,1808
619,1,17,12.03.2024,15,104,120,16,240
527,21,9,18.04.2024,5,115,129,14,70
617,23,27,01.03.2024,8,232,328,96,768
738,4,16,11.12.2024,16,265,303,38,608
166,21,27,29.07.2024,1,144,154,10,10
588,19,6,09.03.2024,17,40,58,18,306
151,2,6,12.05.2024,6,284,421,137,822
614,19,21,10.01.2024,10,63,72,9,90
622,16,28,03.09.2024,6,132,188,56,336
616,5,26,25.10.2024,6,339,457,118,708
271,6,24,17.12.2024,11,492,617,125,1375
605,3,8,12.07.2024,13,87,96,9,117
208,17,28,15.09.2024,14,443,495,52,728
99,6,16,10.11.2024,20,39,56,17,340
545,17,25,01.03.2024,3,266,358,92,276
924,20,18,01.01.2024,14,287,356,69,966
896,2,23,28.09.2024,14,137,202,65,910
494,26,25,14.07.2024,12,321,453,132,1584
930,25,27,22.12.2024,19,70,87,17,323
261,16,25,29.04.2024,3,165,218,53,159
557,14,9,06.04.2024,1,383,530,147,147
8,19,17,01.03.2024,17,23,28,5,85
211,23,26,10.06.2024,14,205,225,20,280
437,21,19,09.05.2024,9,457,590,133,1197
579,12,20,21.05.2024,13,406,464,58,754
566,26,18,04.09.2024,6,209,272,63,378
496,9,10,22.10.2024,12,416,569,153,1836
754,5,28,03.12.2024,4,402,464,62,248
802,23,6,21.02.2024,7,280,344,64,448
347,26,18,10.11.2024,2,102,125,23,46
652,1,26,16.02.2024,5,261,383,122,610
446,3,3,14.05.2024,8,209,227,18,144
39,24,13,24.07.2024,20,355,456,101,2020
729,20,2,30.03.2024,16,244,257,13,208
871,22,30,22.09.2024,10,119,127,8,80
614,17,17,23.12.2024,8,334,376,42,336
37,12,8,01.12.2024,1,100,109,9,9
283,25,13,29.06.2024,13,227,298,71,923
531,1,24,26.12.2024,3,490,534,44,132
292,24,27,13.10.2024,19,198,239,41,779
836,9,8,06.11.2024,7,252,370,118,826
589,1,9,30.03.2024,14,279,306,27,378
75,17,10,23.06.2024,4,431,552,121,484
264,29,18,21.10.2024,9,375,468,93,837
387,19,16,04.05.2024,11,417,524,107,1177
472,29,19,15.01.2024,16,79,92,13,208
392,21,26,22.04.2024,8,429,511,82,656
979,12,17,01.10.2024,1,378,538,160,160
255,10,3,23.07.2024,11,58,75,17,187
183,16,11,30.06.2024,7,477,624,147,1029
188,24,22,07.04.2024,16,397,453,56,896
754,8,28,15.05.2024,7,137,156,19,133
256,27,20,01.07.2024,5,418,459,41,205
943,3,22,05.12.2024,16,334,352,18,288
878,18,2,03.09.2024,12,337,402,65,780
920,29,29,21.10.2024,9,271,307,36,324
783,30,17,23.05.2024,13,133,185,52,676
132,2,17,04.08.2024,16,296,315,19,304
356,13,28,17.12.2024,6,254,378,124,744
716,17,15,10.06.2024,1,26,35,9,9
389,19,4,15.06.2024,12,333,479,146,1752
192,18,9,01.05.2024,9,261,387,126,1134
352,12,6,12.09.2024,14,127,157,30,420
771,12,12,24.07.2024,9,250,283,33,297
135,19,22,27.04.2024,4,389,456,67,268
242,18,14,14.07.2024,7,94,133,39,273
757,5,16,05.01.2024,6,235,300,65,390
915,28,21,21.09.2024,18,388,463,75,1350
499,10,9,14.10.2024,19,44,54,10,190
708,6,2,20.04.2024,9,263,375,112,1008
99,15,24,20.06.2024,9,204,247,43,387
571,30,26,11.05.2024,12,30,37,7,84
360,28,22,06.11.2024,7,315,412,97,679
665,18,6,25.05.2024,12,186,252,66,792
500,25,24,16.08.2024,3,215,285,70,210
475,21,5,26.03.2024,11,235,314,79,869
586,13,28,06.02.2024,3,102,123,21,63
322,11,21,29.05.2024,9,329,441,112,1008
278,29,15,04.07.2024,19,286,425,139,2641
424,6,6,12.01.2024,5,392,453,61,305
258,24,23,10.02.2024,7,105,129,24,168
98,3,30,30.08.2024,18,47,50,3,54
407,17,25,12.02.2024,4,154,205,51,204
87,21,30,18.07.2024,10,137,159,22,220
291,15,21,05.03.2024,5,289,412,123,615
30,2,22,01.07.2024,11,462,584,122,1342
999,28,18,19.05.2024,18,247,274,27,486
972,23,18,31.03.2024,19,325,408,83,1577
767,21,29,15.10.2024,14,288,385,97,1358
547,10,30,26.06.2024,16,296,341,45,720
92,15,10,06.07.2024,14,153,171,18,252
11,1,17,10.03.2024,12,166,209,43,516
9,23,30,08.09.2024,16,173,182,9,144
441,26,10,01.11.2024,8,427,450,23,184
383,7,14,14.10.2024,14,222,258,36,504
733,24,21,18.07.2024,13,132,154,22,286
433,21,8,21.09.2024,20,433,590,157,3140
279,10,21,29.09.2024,9,231,262,31,279
71,6,5,28.05.2024,4,346,434,88,352
464,9,23,14.11.2024,16,116,139,23,368
156,2,18,12.01.2024,6,72,85,13,78
129,23,15,05.01.2024,8,66,74,8,64
506,7,11,03.08.2024,10,422,595,173,1730
381,15,23,17.01.2024,11,61,87,26,286
975,5,2,16.05.2024,13,56,72,16,208
186,7,29,08.05.2024,13,444,469,25,325
998,25,23,07.05.2024,13,414,616,202,2626
254,24,2,11.04.2024,15,396,553,157,2355
534,22,7,30.08.2024,13,368,546,178,2314
959,11,6,18.11.2024,2,401,590,189,378
534,4,9,03.09.2024,10,121,147,26,260
54,28,22,21.04.2024,4,140,187,47,188
333,1,6,21.05.2024,19,81,99,18,342
249,1,2,24.10.2024,16,372,490,118,1888
381,25,3,07.05.2024,6,275,300,25,150
634,11,30,16.11.2024,2,50,60,10,20
158,23,18,24.02.2024,5,269,311,42,210
572,26,21,26.06.2024,15,395,449,54,810
706,13,12,09.03.2024,9,480,513,33,297
724,15,18,30.05.2024,18,376,478,102,1836
581,6,18,27.06.2024,11,394,497,103,1133
889,27,20,10.10.2024,6,55,71,16,96
461,10,27,14.05.2024,18,207,260,53,954
795,21,17,13.07.2024,6,472,500,28,168
878,12,25,13.11.2024,8,184,253,69,552
675,18,27,17.07.2024,7,288,391,103,721
785,18,5,09.11.2024,10,185,228,43,430
330,4,4,24.09.2024,3,42,60,18,54
133,6,28,17.01.2024,7,74,94,20,140
102,2,19,24.11.2024,13,356,452,96,1248
639,23,19,11.05.2024,2,207,238,31,62
736,3,1,16.04.2024,16,495,718,223,3568
82,15,26,23.11.2024,2,204,265,61,122
961,29,14,07.07.2024,2,441,585,144,288
542,2,24,06.02.2024,10,59,87,28,280
984,17,4,21.02.2024,8,292,357,65,520
198,17,22,07.05.2024,19,340,502,162,3078
572,24,18,31.07.2024,4,412,551,139,556
367,22,15,25.12.2024,14,472,518,46,644
812,6,18,24.07.2024,17,192,258,66,1122
547,20,15,29.06.2024,11,301,450,149,1639
333,28,12,30.07.2024,14,442,608,166,2324
624,8,19,06.10.2024,7,212,296,84,588
949,24,9,03.07.2024,15,249,369,120,1800
1,24,2,25.05.2024,20,28,36,8,160
912,10,1,02.06.2024,8,129,185,56,448
23,25,27,19.12.2024,9,490,637,147,1323
570,19,30,19.10.2024,5,68,73,5,25
365,5,5,15.05.2024,12,475,623,148,1776
239,9,26,02.06.2024,3,312,384,72,216
940,7,24,09.02.2024,11,425,539,114,1254
500,27,29,19.12.2024,19,439,640,201,3819
610,21,10,20.01.2024,19,215,233,18,342
58,30,25,20.06.2024,12,470,666,196,2352
427,30,28,02.03.2024,8,402,540,138,1104
617,30,1,20.11.2024,13,47,56,9,117
43,11,18,16.10.2024,5,187,239,52,260
227,5,2,10.12.2024,13,248,344,96,1248
590,17,3,23.04.2024,14,168,236,68,952
152,5,11,12.02.2024,16,312,432,120,1920
562,13,9,13.02.2024,13,276,344,68,884
715,5,25,10.03.2024,16,306,349,43,688
405,21,19,10.04.2024,18,335,502,167,3006
537,8,8,06.02.2024,9,417,519,102,918
702,30,19,15.02.2024,4,363,449,86,344
375,12,7,13.06.2024,12,324,436,112,1344
789,10,6,28.06.2024,20,440,658,218,4360
453,20,5,13.08.2024,2,493,699,206,412
205,22,12,20.03.2024,3,77,106,29,87
249,20,30,16.03.2024,10,27,33,6,60
824,4,10,18.08.2024,16,31,37,6,96
758,18,7,14.04.2024,18,287,398,111,1998
562,16,20,13.03.2024,1,212,278,66,66
680,17,2,10.05.2024,6,50,59,9,54
809,23,20,18.05.2024,2,258,347,89,178
9,3,13,04.12.2024,9,359,515,156,1404
676,12,28,25.02.2024,1,169,243,74,74
665,13,8,13.07.2024,17,383,419,36,612
324,16,28,01.11.2024,18,65,74,9,162
513,15,18,30.12.2024,1,40,46,6,6
543,10,11,07.09.2024,13,401,449,48,624
356,22,12,30.06.2024,10,140,210,70,700
514,9,26,01.02.2024,9,469,574,105,945
835,1,18,23.05.2024,8,97,117,20,160
403,22,5,14.02.2024,13,286,424,138,1794
628,28,21,17.12.2024,8,233,270,37,296
157,14,10,05.11.2024,11,249,322,73,803
212,21,5,24.10.2024,18,370,522,152,2736
884,5,10,18.12.2024,17,485,539,54,918
931,25,5,01.12.2024,19,489,548,59,1121
70,18,18,01.03.2024,6,182,260,78,468
150,24,1,12.06.2024,14,230,273,43,602
764,30,27,22.11.2024,9,97,136,39,351
110,5,6,14.01.2024,20,335,392,57,1140
581,20,8,01.11.2024,8,138,188,50,400
368,3,23,01.09.2024,5,277,396,119,595
481,23,21,10.07.2024,6,456,558,102,612
486,5,6,08.04.2024,8,36,44,8,64
993,1,30,18.05.2024,14,133,184,51,714
208,25,7,03.02.2024,6,494,731,237,1422
450,28,20,07.09.2024,11,463,581,118,1298
253,14,13,22.01.2024,20,396,563,167,3340
738,11,13,09.11.2024,19,324,418,94,1786
657,29,23,20.01.2024,17,75,94,19,323
847,29,2,05.05.2024,17,295,362,67,1139
753,2,18,17.07.2024,17,411,548,137,2329
51,7,10,13.08.2024,13,472,560,88,1144
848,10,15,26.03.2024,14,170,225,55,770
56,23,17,13.03.2024,15,444,595,151,2265
93,24,17,27.02.2024,6,418,549,131,786
916,23,18,10.03.2024,13,231,276,45,585
26,6,15,29.10.2024,7,471,591,120,840
257,11,23,28.11.2024,6,387,534,147,882
94,4,23,18.08.2024,12,63,81,18,216
394,24,26,18.09.2024,20,101,123,22,440
390,2,25,28.03.2024,11,309,446,137,1507
884,5,6,15.03.2024,6,413,566,153,918
430,10,10,16.08.2024,10,340,385,45,450
921,5,7,02.01.2024,20,411,478,67,1340
470,16,28,12.09.2024,18,433,456,23,414
904,16,8,21.04.2024,19,357,451,94,1786
420,15,3,03.11.2024,20,23,27,4,80
561,9,20,17.11.2024,18,439,624,185,3330
51,6,5,29.01.2024,12,38,42,4,48
34,22,19,04.11.2024,10,189,277,88,880
51,4,14,01.04.2024,6,364,429,65,390
677,23,23,31.10.2024,19,423,551,128,2432
990,15,24,23.10.2024,12,496,529,33,396
787,10,11,07.07.2024,13,439,474,35,455
438,27,18,03.02.2024,10,261,290,29,290
712,28,9,17.06.2024,17,231,297,66,1122
713,7,20,30.01.2024,4,312,430,118,472
645,17,3,04.09.2024,20,498,700,202,4040
724,10,14,07.11.2024,11,152,196,44,484
639,12,30,07.03.2024,20,308,392,84,1680
747,21,16,09.09.2024,6,472,625,153,918
726,10,7,01.01.2024,4,32,40,8,32
816,4,24,16.04.2024,20,232,287,55,1100
342,12,18,22.11.2024,7,25,33,8,56
707,10,9,04.02.2024,10,173,221,48,480
332,25,1,28.02.2024,11,194,238,44,484
583,20,1,30.03.2024,7,189,269,80,560
945,22,16,30.08.2024,2,350,389,39,78
160,21,15,01.10.2024,11,256,359,103,1133
424,30,24,29.01.2024,17,173,226,53,901
695,11,18,01.10.2024,1,126,165,39,39
340,26,30,30.06.2024,3,96,113,17,51
32,11,13,16.11.2024,18,451,507,56,1008
621,13,6,31.10.2024,4,462,648,186,744
316,23,28,10.06.2024,2,159,197,38,76
509,29,8,09.07.2024,15,444,656,212,3180
222,17,10,30.03.2024,4,211,296,85,340
797,7,30,17.02.2024,15,279,296,17,255
495,29,17,19.03.2024,7,194,284,90,630
751,28,17,07.06.2024,11,93,130,37,407
101,27,17,12.12.2024,5,125,172,47,235
471,13,23,24.09.2024,4,22,26,4,16
46,22,28,31.10.2024,3,190,239,49,147
48,4,17,03.12.2024,10,31,41,10,100
320,21,29,17.04.2024,11,122,139,17,187
284,18,11,13.08.2024,4,159,178,19,76
281,4,1,14.11.2024,18,283,310,27,486
556,12,18,12.06.2024,9,92,136,44,396
824,10,19,05.05.2024,6,56,67,11,66
914,11,18,15.08.2024,2,86,91,5,10
925,22,2,24.02.2024,13,47,51,4,52
402,6,23,01.11.2024,19,342,488,146,2774
717,15,20,01.07.2024,10,190,269,79,790
731,25,22,30.09.2024,3,492,684,192,576
477,19,5,17.02.2024,15,69,87,18,270
701,21,23,26.08.2024,16,138,204,66,1056
148,28,29,11.11.2024,9,487,591,104,936
188,23,30,06.12.2024,11,423,608,185,2035
333,15,16,16.01.2024,3,263,290,27,81
491,15,28,28.03.2024,10,413,498,85,850
589,5,17,22.02.2024,13,438,601,163,2119
110,11,18,28.11.2024,3,425,504,79,237
473,13,19,30.07.2024,8,337,391,54,432
163,16,13,03.02.2024,11,126,178,52,572
606,14,26,10.08.2024,19,423,509,86,1634
711,8,6,05.12.2024,3,398,585,187,561
588,27,16,28.02.2024,19,325,409,84,1596
569,4,27,15.08.2024,6,177,262,85,510
72,20,4,16.12.2024,20,414,587,173,3460
336,16,21,04.12.2024,2,66,76,10,20
143,29,19,21.11.2024,1,407,454,47,47
153,15,18,29.05.2024,13,335,439,104,1352
201,7,22,11.06.2024,10,311,438,127,1270
696,10,30,10.08.2024,12,65,85,20,240
627,17,13,06.03.2024,10,51,62,11,110
563,2,1,26.12.2024,18,440,656,216,3888
113,28,10,16.01.2024,8,241,329,88,704
404,21,11,30.12.2024,13,227,277,50,650
559,7,22,29.03.2024,16,91,103,12,192
394,27,30,03.07.2024,14,98,116,18,252
894,22,5,09.03.2024,1,56,75,19,19
148,24,29,06.09.2024,14,89,97,8,112
658,26,14,21.08.2024,20,496,616,120,2400
185,15,17,05.08.2024,18,439,550,111,1998
364,8,6,05.08.2024,20,23,30,7,140
868,24,8,30.12.2024,17,157,194,37,629
560,19,12,18.01.2024,2,310,393,83,166
378,4,19,03.09.2024,3,92,127,35,105
540,28,25,23.05.2024,15,284,308,24,360
912,20,3,05.05.2024,16,342,473,131,2096
984,22,3,16.12.2024,18,428,561,133,2394
628,2,29,24.06.2024,18,418,441,23,414
465,17,29,28.08.2024,19,395,474,79,1501
362,26,10,28.05.2024,6,38,52,14,84
612,24,10,15.10.2024,9,51,68,17,153
593,6,19,27.01.2024,10,434,600,166,1660
28,10,16,12.02.2024,5,278,302,24,120
803,9,9,08.03.2024,20,163,191,28,560
264,1,24,27.02.2024,20,109,159,50,1000
757,5,22,16.08.2024,12,433,489,56,672
802,23,8,05.09.2024,6,429,552,123,738
34,11,3,15.03.2024,20,498,707,209,4180
858,16,25,30.07.2024,13,141,190,49,637
744,21,6,17.04.2024,19,395,564,169,3211
56,21,9,29.02.2024,2,105,132,27,54
488,10,16,29.09.2024,8,214,291,77,616
400,16,9,15.03.2024,17,465,579,114,1938
296,30,26,17.08.2024,13,367,437,70,910
543,22,2,19.02.2024,18,346,418,72,1296
865,14,20,29.11.2024,9,191,224,33,297
822,4,9,01.12.2024,19,220,277,57,1083
692,24,8,10.12.2024,19,414,471,57,1083
346,22,23,02.04.2024,11,300,316,16,176
9,27,3,07.01.2024,14,70,90,20,280
702,15,12,22.04.2024,10,148,168,20,200
25,20,3,30.01.2024,20,356,517,161,3220
223,20,21,03.03.2024,4,64,92,28,112
134,13,22,27.11.2024,19,431,640,209,3971
918,4,23,04.04.2024,9,170,214,44,396
959,3,21,20.08.2024,9,413,513,100,900
926,22,25,14.06.2024,9,102,143,41,369
284,25,2,14.07.2024,13,190,285,95,1235
265,27,9,01.04.2024,15,55,70,15,225
951,7,20,20.07.2024,6,350,445,95,570
148,18,25,08.08.2024,7,334,447,113,791
935,15,23,12.05.2024,4,37,40,3,12
586,24,9,16.08.2024,1,479,610,131,131
669,21,1,20.01.2024,13,156,174,18,234
338,29,13,21.10.2024,1,283,387,104,104
790,16,16,11.08.2024,13,452,623,171,2223
832,26,3,03.10.2024,8,21,26,5,40
706,27,25,03.09.2024,4,310,400,90,360
368,11,22,04.06.2024,13,48,64,16,208
982,21,3,06.07.2024,18,456,676,220,3960
83,27,15,28.05.2024,7,110,143,33,231
991,13,22,07.04.2024,10,376,461,85,850
110,21,23,02.07.2024,16,63,91,28,448
449,24,7,12.03.2024,2,118,125,7,14
608,8,16,18.07.2024,3,425,550,125,375
316,16,18,18.08.2024,1,38,46,8,8
346,26,24,22.01.2024,13,80,92,12,156
670,22,17,22.08.2024,18,96,133,37,666
239,30,3,19.01.2024,5,270,363,93,465
483,30,30,12.11.2024,2,144,197,53,106
134,1,6,19.11.2024,2,483,574,91,182
813,4,15,08.11.2024,6,447,588,141,846
838,27,4,28.02.2024,16,324,457,133,2128
226,3,26,13.04.2024,14,192,272,80,1120
756,22,13,15.06.2024,4,370,484,114,456
141,11,27,19.04.2024,2,323,364,41,82
65,4,9,13.03.2024,14,106,145,39,546
567,6,15,04.05.2024,19,40,44,4,76
811,28,21,09.11.2024,13,418,469,51,663
901,16,3,04.01.2024,1,111,163,52,52
724,21,19,25.05.2024,14,375,530,155,2170
792,16,23,05.03.2024,7,93,124,31,217
536,15,14,02.05.2024,6,332,452,120,720
611,6,23,12.09.2024,20,65,87,22,440
802,10,12,02.08.2024,1,305,353,48,48
121,17,4,12.11.2024,12,461,642,181,2172
553,17,8,25.08.2024,7,161,173,12,84
116,26,5,16.12.2024,16,274,309,35,560
687,30,2,28.01.2024,12,165,189,24,288
258,11,20,20.08.2024,2,73,101,28,56
948,18,6,21.03.2024,1,268,343,75,75
73,29,8,15.08.2024,19,316,378,62,1178
204,24,22,15.06.2024,8,418,460,42,336
234,4,8,30.07.2024,7,212,308,96,672
76,16,19,05.09.2024,2,475,592,117,234
222,30,20,20.08.2024,6,218,266,48,288
469,24,7,19.11.2024,12,158,180,22,264
131,2,23,18.10.2024,2,163,181,18,36
873,15,15,02.08.2024,6,409,493,84,504
908,10,20,21.03.2024,20,483,544,61,1220
994,18,28,27.04.2024,3,230,330,100,300
501,28,7,29.10.2024,16,448,564,116,1856
15,24,14,06.05.2024,8,187,233,46,368
228,29,30,29.10.2024,5,487,637,150,750
6,14,2,21.01.2024,16,395,551,156,2496
35,14,17,20.07.2024,16,434,612,178,2848
842,4,15,10.09.2024,8,62,81,19,152
13,23,24,27.07.2024,7,87,105,18,126
245,21,3,09.01.2024,16,362,430,68,1088
721,15,28,19.10.2024,19,32,48,16,304
475,25,5,26.12.2024,13,114,160,46,598
380,21,15,26.12.2024,1,460,613,153,153
395,29,23,19.06.2024,17,36,43,7,119
771,9,23,09.11.2024,18,314,442,128,2304
807,22,3,13.11.2024,11,396,582,186,2046
528,30,22,05.07.2024,2,76,93,17,34
477,20,2,06.07.2024,12,109,146,37,444
722,3,18,29.12.2024,7,90,134,44,308
245,18,4,28.11.2024,16,397,585,188,3008
595,28,23,17.04.2024,8,184,222,38,304
274,17,22,04.08.2024,9,47,51,4,36
354,15,16,13.09.2024,17,444,491,47,799
727,18,22,29.09.2024,10,251,334,83,830
820,22,23,03.02.2024,7,476,689,213,1491
90,3,13,01.04.2024,10,59,65,6,60
283,4,23,16.03.2024,16,97,140,43,688
534,21,1,30.05.2024,14,369,477,108,1512
136,16,12,03.08.2024,15,397,532,135,2025
299,7,3,12.01.2024,8,447,660,213,1704
661,11,14,23.10.2024,11,355,476,121,1331
335,16,19,06.12.2024,17,451,585,134,2278
469,10,19,08.03.2024,10,107,150,43,430
233,16,12,27.05.2024,2,95,115,20,40
467,6,20,23.03.2024,18,166,188,22,396
180,27,23,20.12.2024,5,102,118,16,80
43,11,19,05.03.2024,15,153,186,33,495
211,18,23,18.01.2024,11,196,219,23,253
460,18,6,30.09.2024,10,82,120,38,380
415,30,16,15.03.2024,15,495,591,96,1440
5,24,18,16.09.2024,11,351,480,129,1419
486,29,10,20.10.2024,5,429,560,131,655
929,30,15,22.06.2024,4,394,499,105,420
42,5,22,09.10.2024,4,177,188,11,44
633,27,8,16.08.2024,12,67,80,13,156
623,21,7,25.10.2024,17,133,186,53,901
786,9,7,12.01.2024,3,295,423,128,384
694,22,3,19.09.2024,13,119,151,32,416
618,20,17,29.01.2024,12,223,249,26,312
875,14,12,16.07.2024,12,26,31,5,60
360,10,15,14.10.2024,3,130,179,49,147
455,24,14,14.08.2024,10,103,145,42,420
994,29,14,31.07.2024,5,447,587,140,700
89,5,7,04.06.2024,16,464,597,133,2128
344,3,30,29.10.2024,13,65,68,3,39
655,30,9,31.07.2024,6,304,382,78,468
582,25,30,11.03.2024,7,115,164,49,343
297,18,16,22.01.2024,10,447,587,140,1400
506,18,24,25.08.2024,8,33,46,13,104
158,9,10,23.11.2024,16,83,112,29,464
915,10,14,01.04.2024,16,484,658,174,2784
251,1,4,21.05.2024,16,54,71,17,272
371,19,16,16.10.2024,14,464,541,77,1078
703,16,23,02.03.2024,12,282,389,107,1284
18,28,9,24.03.2024,19,49,55,6,114
473,29,23,10.03.2024,12,103,111,8,96
370,14,21,01.07.2024,2,168,198,30,60
655,30,3,20.09.2024,7,412,549,137,959
784,4,20,26.03.2024,18,185,267,82,1476
847,28,22,03.06.2024,9,370,505,135,1215
372,4,18,23.10.2024,12,441,492,51,612
141,17,10,09.07.2024,16,230,277,47,752
933,6,4,21.04.2024,5,277,318,41,205
193,26,29,13.10.2024,20,373,531,158,3160
539,28,18,30.12.2024,18,379,527,148,2664
117,14,15,09.02.2024,4,439,487,48,192
18,16,12,08.06.2024,12,91,129,38,456
912,20,17,24.06.2024,6,383,455,72,432
763,27,4,23.04.2024,5,458,624,166,830
705,8,10,05.03.2024,7,86,128,42,294
436,23,25,27.02.2024,3,29,41,12,36
776,14,2,10.04.2024,4,36,51,15,60
526,19,2,28.08.2024,4,485,564,79,316
68,10,22,06.01.2024,4,420,464,44,176
617,7,19,12.04.2024,6,363,439,76,456
93,5,28,22.05.2024,19,198,239,41,779
876,17,25,09.11.2024,8,278,363,85,680
102,27,19,08.01.2024,17,131,180,49,833
988,10,6,02.10.2024,1,391,428,37,37
220,30,17,28.12.2024,16,207,282,75,1200
190,15,22,24.02.2024,6,447,541,94,564
389,14,7,20.09.2024,8,228,251,23,184
322,4,15,26.02.2024,17,89,113,24,408
370,23,10,12.10.2024,2,62,74,12,24
119,13,10,21.08.2024,20,396,471,75,1500
1000,27,15,25.04.2024,18,228,269,41,738
876,14,7,05.02.2024,16,500,678,178,2848
184,1,22,08.09.2024,4,222,277,55,220
675,22,3,02.03.2024,5,222,273,51,255
605,4,24,27.03.2024,3,206,307,101,303
347,7,20,25.07.2024,4,139,198,59,236
743,16,9,31.12.2024,19,323,379,56,1064
809,26,21,23.07.2024,12,263,355,92,1104
973,13,16,18.09.2024,9,95,133,38,342
111,4,9,07.09.2024,16,138,184,46,736
138,1,4,28.01.2024,3,275,373,98,294
996,6,13,05.11.2024,11,98,116,18,198
639,4,25,09.02.2024,17,412,524,112,1904
478,7,10,04.12.2024,16,271,346,75,1200
556,11,26,03.10.2024,18,29,43,14,252
33,14,29,01.03.2024,13,250,298,48,624
386,15,15,19.01.2024,2,110,143,33,66
882,25,10,27.12.2024,6,271,337,66,396
320,23,13,06.09.2024,4,311,421,110,440
676,18,22,03.10.2024,19,260,329,69,1311
875,6,17,29.01.2024,13,154,196,42,546
995,13,20,12.12.2024,12,412,614,202,2424
329,2,1,29.10.2024,2,85,121,36,72
358,26,24,25.10.2024,1,411,596,185,185
350,13,4,07.08.2024,12,202,250,48,576
58,22,8,06.05.2024,8,351,418,67,536
87,30,23,03.02.2024,10,78,94,16,160
21,18,11,20.01.2024,15,356,512,156,2340
582,17,29,03.08.2024,9,30,41,11,99
603,1,11,12.07.2024,19,219,262,43,817
101,26,16,21.02.2024,7,192,245,53,371
831,25,22,22.06.2024,6,334,396,62,372
993,14,7,11.09.2024,3,450,645,195,585
220,10,9,25.01.2024,10,313,385,72,720
232,20,24,17.02.2024,19,68,90,22,418
280,3,19,28.09.2024,16,238,272,34,544
815,3,21,03.06.2024,17,431,511,80,1360
680,18,11,12.04.2024,14,225,262,37,518
528,15,22,07.10.2024,6,471,498,27,162
721,17,28,05.04.2024,19,275,315,40,760
986,27,24,27.08.2024,9,499,667,168,1512
829,20,28,10.08.2024,19,392,522,130,2470
535,7,12,24.08.2024,5,143,160,17,85
702,25,10,10.08.2024,14,183,263,80,1120
934,3,21,14.04.2024,14,156,222,66,924
662,6,9,17.12.2024,20,140,173,33,660
117,5,7,15.01.2024,8,428,609,181,1448
476,16,18,11.08.2024,14,351,512,161,2254
207,6,9,10.03.2024,1,152,214,62,62
285,22,18,31.03.2024,2,389,493,104,208
21,2,28,12.02.2024,11,328,388,60,660
66,29,14,05.07.2024,3,223,329,106,318
742,27,5,30.04.2024,4,312,431,119,476
956,4,17,06.12.2024,19,416,611,195,3705
258,16,29,16.02.2024,8,327,361,34,272
827,11,11,26.10.2024,13,432,599,167,2171
242,30,14,21.04.2024,5,74,84,10,50
994,9,15,28.07.2024,9,461,606,145,1305
503,18,12,24.12.2024,4,182,236,54,216
487,22,8,22.05.2024,5,205,259,54,270
377,27,10,11.01.2024,20,37,53,16,320
679,26,2,19.12.2024,8,149,194,45,360
317,21,23,04.07.2024,4,293,422,129,516
879,15,13,05.01.2024,13,494,736,242,3146
262,10,3,30.04.2024,10,127,182,55,550
165,30,15,19.11.2024,11,470,665,195,2145
660,14,26,18.01.2024,9,463,503,40,360
799,16,16,30.07.2024,11,387,480,93,1023
941,27,4,23.03.2024,9,279,301,22,198
431,20,24,07.10.2024,11,252,343,91,1001
781,2,21,24.11.2024,6,342,427,85,510
657,5,1,24.07.2024,7,341,405,64,448
590,3,4,21.03.2024,8,284,389,105,840
787,27,21,07.03.2024,20,371,458,87,1740
962,11,15,01.09.2024,5,153,173,20,100
608,27,11,24.05.2024,7,63,78,15,105
187,13,29,12.07.2024,19,134,142,8,152
24,30,18,27.11.2024,20,340,392,52,1040
92,15,7,14.05.2024,6,45,55,10,60
440,20,9,17.03.2024,3,208,234,26,78
581,4,1,26.09.2024,14,415,608,193,2702
465,27,22,10.09.2024,4,134,184,50,200
196,28,27,16.05.2024,10,402,511,109,1090
134,14,28,15.04.2024,20,130,195,65,1300
290,24,22,06.04.2024,14,112,138,26,364
150,1,10,14.05.2024,8,336,421,85,680
255,12,19,16.12.2024,15,63,66,3,45
137,28,11,20.12.2024,13,371,425,54,702
393,23,14,01.11.2024,9,57,62,5,45
61,2,11,30.04.2024,16,485,587,102,1632
621,22,26,02.11.2024,2,22,26,4,8
635,13,10,21.07.2024,12,87,129,42,504
573,2,19,01.04.2024,9,106,135,29,261
953,11,29,27.08.2024,5,65,78,13,65
544,14,5,13.05.2024,4,180,193,13,52
131,16,28,23.05.2024,12,494,614,120,1440
925,29,9,09.11.2024,9,284,338,54,486
915,6,11,08.09.2024,5,304,436,132,660
674,21,26,13.08.2024,2,116,130,14,28
236,6,2,28.08.2024,9,103,141,38,342
447,4,29,10.09.2024,2,246,298,52,104
727,18,16,22.08.2024,16,77,110,33,528
888,5,4,27.06.2024,3,124,179,55,165
185,27,6,17.09.2024,9,308,447,139,1251
600,7,19,03.01.2024,17,412,538,126,2142
427,30,3,06.05.2024,16,366,400,34,544
337,1,10,14.12.2024,4,221,269,48,192
952,4,27,14.06.2024,5,34,37,3,15
851,23,22,02.09.2024,15,341,505,164,2460
609,22,1,17.06.2024,2,355,472,117,234
464,11,24,18.10.2024,5,128,184,56,280
821,21,10,14.06.2024,2,400,433,33,66
975,20,13,17.02.2024,13,150,170,20,260
989,25,28,23.07.2024,3,30,43,13,39
167,13,25,25.07.2024,10,351,487,136,1360
670,5,4,01.06.2024,16,430,535,105,1680
826,30,10,16.12.2024,20,87,105,18,360
99,27,12,19.09.2024,7,270,338,68,476
398,16,9,15.10.2024,20,236,257,21,420
433,26,12,10.11.2024,6,242,323,81,486
96,2,17,23.06.2024,15,366,421,55,825
703,23,5,10.09.2024,17,342,459,117,1989
86,10,15,11.08.2024,3,484,683,199,597
308,5,5,16.12.2024,10,450,523,73,730
438,10,19,25.01.2024,18,59,86,27,486
526,4,17,05.08.2024,14,68,86,18,252
738,19,27,09.05.2024,12,150,197,47,564
788,17,1,28.02.2024,15,111,156,45,675
864,13,2,12.02.2024,14,468,640,172,2408
322,19,24,20.08.2024,15,339,479,140,2100
350,30,28,05.04.2024,7,114,124,10,70
619,9,28,10.12.2024,4,242,312,70,280
6,13,4,07.01.2024,6,355,449,94,564
709,13,28,02.12.2024,20,391,496,105,2100
634,27,20,03.07.2024,13,431,511,80,1040
129,5,1,07.04.2024,4,437,462,25,100
994,7,28,14.01.2024,7,266,357,91,637
666,8,14,16.11.2024,18,117,127,10,180
789,15,5,30.08.2024,14,31,34,3,42
925,5,24,25.12.2024,15,268,338,70,1050
881,15,19,04.05.2024,7,170,222,52,364
854,13,2,19.06.2024,1,72,96,24,24
731,14,14,10.09.2024,19,325,448,123,2337
298,2,16,23.07.2024,16,282,371,89,1424
627,30,22,06.09.2024,8,385,415,30,240
20,14,19,10.06.2024,18,52,61,9,162
664,14,29,30.08.2024,4,273,363,90,360
662,12,15,23.12.2024,14,30,34,4,56
744,7,16,25.06.2024,15,138,176,38,570
602,30,22,22.06.2024,20,456,652,196,3920
673,15,5,30.05.2024,13,233,332,99,1287
690,21,24,03.07.2024,16,429,638,209,3344
166,20,7,24.05.2024,3,361,457,96,288
178,7,6,06.11.2024,16,71,100,29,464
966,16,10,30.04.2024,7,305,327,22,154
19,12,29,13.05.2024,12,366,410,44,528
848,28,29,14.09.2024,2,433,467,34,68
441,4,20,26.04.2024,4,307,353,46,184
265,11,26,30.06.2024,2,414,598,184,368
274,29,5,19.12.2024,17,329,445,116,1972
724,2,30,12.08.2024,15,450,626,176,2640
999,4,26,08.11.2024,20,420,603,183,3660
105,27,18,22.01.2024,17,73,82,9,153
121,28,7,04.07.2024,6,392,463,71,426
453,25,17,12.09.2024,4,98,131,33,132
343,27,5,03.03.2024,7,244,363,119,833
788,25,1,05.05.2024,16,194,229,35,560
176,3,9,09.07.2024,14,204,272,68,952
252,5,25,28.09.2024,14,423,488,65,910
822,14,14,28.07.2024,15,456,585,129,1935
699,12,1,14.08.2024,5,414,437,23,115
826,17,3,13.02.2024,11,181,223,42,462
791,6,14,01.02.2024,13,408,435,27,351
945,21,5,21.10.2024,2,343,511,168,336
819,22,29,23.09.2024,10,234,288,54,540
698,23,18,04.06.2024,11,485,584,99,1089
847,9,29,27.09.2024,20,491,548,57,1140
414,15,21,15.04.2024,18,339,476,137,2466
668,15,23,25.06.2024,13,417,475,58,754
309,3,2,02.10.2024,11,219,301,82,902
758,29,5,23.09.2024,18,165,189,24,432
524,18,10,23.09.2024,11,407,544,137,1507
24,1,29,03.10.2024,19,152,176,24,456
793,10,24,04.08.2024,17,76,105,29,493
862,12,9,17.11.2024,17,201,222,21,357
775,21,4,17.08.2024,10,313,432,119,1190
465,11,8,24.10.2024,19,385,559,174,3306
643,22,18,31.10.2024,8,199,236,37,296
683,26,27,20.10.2024,5,385,470,85,425
756,8,4,16.06.2024,17,318,361,43,731
798,12,15,20.02.2024,5,384,477,93,465
422,3,3,01.02.2024,14,474,525,51,714
220,15,3,08.07.2024,17,226,297,71,1207
532,25,13,15.05.2024,19,275,368,93,1767
451,23,30,07.09.2024,14,441,495,54,756
518,5,16,30.12.2024,15,86,128,42,630
526,28,17,01.03.2024,7,253,320,67,469
765,6,18,08.07.2024,4,328,470,142,568
113,4,12,19.10.2024,10,40,51,11,110
121,12,10,10.07.2024,10,170,216,46,460
811,5,5,28.10.2024,14,44,65,21,294
313,29,10,20.04.2024,6,439,607,168,1008
3,4,18,27.06.2024,3,465,498,33,99
493,19,10,16.10.2024,15,480,577,97,1455
387,16,27,06.11.2024,5,410,456,46,230
652,15,25,18.08.2024,15,96,138,42,630
334,3,26,15.11.2024,20,229,280,51,1020
922,13,11,03.10.2024,2,363,527,164,328
754,9,21,15.02.2024,6,382,405,23,138
646,26,25,28.12.2024,10,307,411,104,1040
660,18,3,08.04.2024,20,297,389,92,1840
55,19,17,06.04.2024,16,277,403,126,2016
124,22,30,29.09.2024,6,29,34,5,30
211,8,27,27.12.2024,19,247,269,22,418
547,20,11,24.07.2024,19,43,55,12,228
957,1,11,11.08.2024,6,232,246,14,84
541,11,13,11.05.2024,3,78,116,38,114
555,6,10,14.03.2024,6,150,209,59,354
158,10,14,13.12.2024,6,50,66,16,96
334,6,1,31.12.2024,2,172,211,39,78
328,5,14,14.06.2024,9,212,312,100,900
922,4,2,13.04.2024,8,405,534,129,1032
243,16,17,15.09.2024,13,78,91,13,169
326,15,18,27.07.2024,3,267,284,17,51
649,8,30,10.01.2024,9,303,450,147,1323
692,4,8,11.10.2024,5,175,228,53,265
457,3,28,21.11.2024,17,124,174,50,850
146,12,18,27.03.2024,8,295,436,141,1128
985,30,18,19.08.2024,2,20,28,8,16
985,27,20,28.05.2024,6,20,22,2,12
944,16,9,02.11.2024,9,449,609,160,1440
360,27,21,18.04.2024,19,450,576,126,2394
47,6,24,30.09.2024,19,55,65,10,190
405,23,4,12.03.2024,18,163,236,73,1314
216,20,17,11.06.2024,11,345,403,58,638
771,23,15,19.05.2024,8,359,536,177,1416
350,7,15,02.11.2024,11,28,41,13,143
137,21,30,02.01.2024,20,263,277,14,280
10,22,6,30.07.2024,18,478,652,174,3132
501,25,13,02.10.2024,3,423,611,188,564
667,3,18,16.01.2024,15,364,402,38,570
996,27,13,03.11.2024,12,218,246,28,336
787,26,23,05.01.2024,4,256,311,55,220
198,15,1,23.04.2024,1,408,480,72,72
944,23,12,08.04.2024,3,437,579,142,426
311,26,23,23.04.2024,8,272,404,132,1056
38,9,16,26.12.2024,20,127,134,7,140
841,21,13,26.02.2024,9,311,397,86,774
175,18,7,03.12.2024,19,364,494,130,2470
579,6,3,28.10.2024,5,401,433,32,160
266,30,19,26.04.2024,17,393,551,158,2686
197,28,22,12.01.2024,18,334,389,55,990
574,29,15,02.01.2024,14,348,471,123,1722
666,2,28,14.06.2024,14,452,677,225,3150
281,4,22,22.09.2024,15,273,331,58,870
778,2,29,24.04.2024,2,162,237,75,150
546,15,11,03.01.2024,13,119,143,24,312
902,19,26,13.01.2024,8,373,463,90,720
77,30,8,10.04.2024,6,188,224,36,216
642,21,4,15.01.2024,16,241,341,100,1600
607,26,21,20.06.2024,9,146,160,14,126
245,11,27,28.01.2024,11,286,403,117,1287
967,3,25,03.11.2024,20,244,340,96,1920
641,15,19,04.03.2024,3,51,75,24,72
387,11,29,21.12.2024,3,420,465,45,135
942,26,15,29.01.2024,10,332,442,110,1100
68,4,22,29.01.2024,18,46,54,8,144
391,13,4,12.11.2024,14,139,200,61,854
807,22,20,06.01.2024,15,216,272,56,840
439,29,20,13.11.2024,4,193,259,66,264
692,26,1,20.08.2024,17,188,247,59,1003
111,4,1,31.10.2024,3,323,454,131,393
199,29,19,05.03.2024,17,151,183,32,544
493,24,20,15.08.2024,6,144,160,16,96
46,2,5,08.06.2024,19,243,311,68,1292
668,25,12,08.06.2024,19,473,612,139,2641
150,5,16,07.06.2024,20,195,230,35,700
994,1,17,27.10.2024,5,49,57,8,40
839,27,18,28.01.2024,14,196,223,27,378
206,21,30,13.04.2024,3,194,220,26,78
488,23,23,27.08.2024,20,374,448,74,1480
593,19,11,11.11.2024,10,234,280,46,460
108,15,29,22.01.2024,16,132,193,61,976
655,8,23,27.04.2024,15,339,388,49,735
493,24,25,18.06.2024,13,125,154,29,377
846,1,12,06.01.2024,3,203,216,13,39
118,5,10,13.08.2024,7,343,451,108,756
784,12,2,16.01.2024,7,121,143,22,154
225,29,9,30.03.2024,11,453,589,136,1496
183,7,1,31.03.2024,9,486,532,46,414
852,22,5,13.07.2024,4,193,284,91,364
313,15,8,08.07.2024,12,358,404,46,552
540,26,20,10.08.2024,3,80,89,9,27
947,5,26,07.04.2024,7,292,356,64,448
384,11,20,07.08.2024,8,491,526,35,280
631,19,7,01.10.2024,10,424,474,50,500
254,2,21,23.05.2024,5,455,582,127,635
599,29,16,17.04.2024,3,421,531,110,330
680,20,3,26.03.2024,17,218,303,85,1445
661,25,17,10.07.2024,16,285,359,74,1184
330,23,12,26.09.2024,16,386,571,185,2960
486,9,19,24.07.2024,19,352,375,23,437
225,29,7,19.08.2024,8,222,255,33,264
436,29,13,19.10.2024,6,498,712,214,1284
261,18,3,09.03.2024,3,171,214,43,129
361,8,19,22.01.2024,15,282,375,93,1395
437,15,15,09.08.2024,14,208,294,86,1204
325,9,13,13.01.2024,6,246,284,38,228
661,3,12,12.02.2024,10,451,575,124,1240
560,21,3,21.05.2024,8,70,77,7,56
369,2,18,12.04.2024,11,120,162,42,462
257,10,24,15.12.2024,9,117,160,43,387
142,28,25,05.10.2024,9,24,34,10,90
289,27,12,25.07.2024,13,440,577,137,1781
672,1,16,30.11.2024,17,409,605,196,3332
887,13,8,26.04.2024,7,262,303,41,287
602,26,18,27.08.2024,15,194,273,79,1185
321,28,7,07.08.2024,14,127,158,31,434
874,18,1,10.07.2024,5,315,455,140,700
313,24,1,12.09.2024,12,193,222,29,348
436,22,25,25.07.2024,18,173,207,34,612
24,19,26,17.01.2024,5,98,146,48,240
339,19,21,04.11.2024,20,313,451,138,2760
391,7,13,02.02.2024,18,217,246,29,522
112,11,19,19.08.2024,10,67,76,9,90
692,18,6,17.01.2024,20,270,287,17,340
204,3,30,16.07.2024,10,125,144,19,190
676,17,3,20.08.2024,2,208,267,59,118
176,11,28,29.07.2024,13,100,150,50,650
133,18,14,01.09.2024,3,219,324,105,315
887,7,5,15.04.2024,10,241,342,101,1010
681,16,6,05.11.2024,19,500,595,95,1805
208,17,23,16.12.2024,15,161,184,23,345
147,15,3,23.07.2024,20,433,503,70,1400
337,30,19,08.09.2024,15,256,335,79,1185
755,3,10,26.11.2024,15,197,269,72,1080
729,26,10,19.07.2024,20,441,624,183,3660
180,14,8,01.04.2024,20,395,492,97,1940
394,30,22,03.04.2024,19,68,83,15,285
969,2,8,21.03.2024,9,471,628,157,1413
299,22,30,04.02.2024,7,485,617,132,924
781,18,4,07.07.2024,3,406,446,40,120
785,25,11,28.07.2024,15,104,121,17,255
519,2,15,14.01.2024,3,347,473,126,378
768,15,13,24.06.2024,13,458,521,63,819
39,1,9,28.02.2024,5,187,253,66,330
476,16,15,04.02.2024,3,300,404,104,312
731,15,5,29.08.2024,9,450,505,55,495
859,1,20,21.02.2024,6,170,188,18,108
760,13,6,09.02.2024,1,366,429,63,63
452,12,6,20.04.2024,2,477,646,169,338
222,15,23,25.01.2024,17,348,469,121,2057
676,29,4,18.07.2024,10,247,265,18,180
5,2,25,12.07.2024,7,495,575,80,560
931,8,7,16.02.2024,1,235,250,15,15
15,11,27,08.04.2024,3,132,196,64,192
99,26,27,06.12.2024,6,390,439,49,294
426,17,4,16.06.2024,11,307,409,102,1122
640,7,30,04.10.2024,13,500,621,121,1573
238,7,4,01.07.2024,11,108,114,6,66
670,11,1,18.07.2024,7,254,292,38,266
674,27,9,28.11.2024,20,208,223,15,300
907,7,14,03.06.2024,20,275,410,135,2700
105,23,18,18.10.2024,6,148,219,71,426
615,11,21,22.12.2024,13,367,538,171,2223
790,23,5,19.06.2024,6,345,481,136,816
705,11,28,07.12.2024,16,54,65,11,176
624,30,19,17.08.2024,13,281,376,95,1235
239,17,19,26.12.2024,1,139,147,8,8
778,29,4,07.06.2024,8,397,493,96,768
250,20,3,31.01.2024,5,211,269,58,290
207,5,13,14.04.2024,2,141,207,66,132
613,15,24,17.06.2024,5,162,193,31,155
806,25,2,23.09.2024,14,351,497,146,2044
769,1,8,18.06.2024,11,144,165,21,231
56,30,30,06.12.2024,8,430,585,155,1240
737,8,20,14.07.2024,17,184,208,24,408
645,1,3,08.09.2024,3,118,127,9,27
145,7,5,16.02.2024,6,323,419,96,576
815,30,7,30.04.2024,17,60,75,15,255
479,10,6,11.04.2024,8,237,268,31,248
255,10,10,22.10.2024,15,345,394,49,735
884,26,16,10.02.2024,12,223,272,49,588
483,15,14,15.09.2024,20,396,493,97,1940
160,27,26,03.09.2024,1,410,501,91,91
875,3,25,02.06.2024,20,295,330,35,700
745,6,9,13.07.2024,15,176,221,45,675
385,18,20,03.09.2024,3,190,211,21,63
481,7,5,07.04.2024,1,26,37,11,11
748,24,12,08.09.2024,13,493,610,117,1521
405,24,12,15.07.2024,16,177,237,60,960
603,3,14,20.01.2024,4,217,319,102,408
167,7,25,11.08.2024,9,414,605,191,1719
740,12,17,29.12.2024,16,345,469,124,1984
714,2,21,16.07.2024,14,396,460,64,896
490,2,30,04.07.2024,1,377,509,132,132
152,9,20,21.08.2024,5,150,174,24,120
593,22,27,23.03.2024,1,79,110,31,31
660,23,30,15.07.2024,13,381,501,120,1560
923,3,17,06.04.2024,14,104,148,44,616
259,23,10,13.09.2024,18,357,517,160,2880
601,10,24,29.07.2024,3,75,100,25,75
796,26,12,14.03.2024,9,403,461,58,522
767,13,23,06.06.2024,1,106,150,44,44
2,4,3,22.12.2024,14,288,356,68,952
296,24,14,28.03.2024,6,211,239,28,168
138,7,16,03.04.2024,17,76,95,19,323
834,7,6,12.04.2024,2,403,456,53,106
778,7,9,28.07.2024,15,340,497,157,2355
112,28,21,26.03.2024,3,170,185,15,45
128,9,3,24.06.2024,1,319,369,50,50
497,22,25,21.02.2024,1,51,60,9,9
979,1,22,25.10.2024,2,69,79,10,20
811,1,13,04.11.2024,17,409,478,69,1173
498,16,25,21.06.2024,20,239,287,48,960
699,29,11,10.06.2024,8,204,275,71,568
388,20,2,01.07.2024,11,432,473,41,451
468,28,23,24.07.2024,5,33,44,11,55
890,17,9,24.12.2024,8,208,261,53,424
703,22,28,31.08.2024,17,231,311,80,1360
4,21,27,13.06.2024,1,344,417,73,73
47,26,24,15.06.2024,15,139,184,45,675
410,24,20,11.02.2024,12,239,352,113,1356
965,30,16,03.12.2024,4,395,483,88,352
622,7,23,14.03.2024,17,468,612,144,2448
878,23,17,17.01.2024,5,274,386,112,560
309,27,22,07.10.2024,15,106,154,48,720
978,4,16,05.12.2024,18,143,166,23,414
175,25,22,24.12.2024,3,74,92,18,54
733,1,6,16.06.2024,13,412,485,73,949
737,9,22,31.08.2024,4,360,400,40,160
548,21,24,08.09.2024,3,427,581,154,462
893,8,30,21.10.2024,20,53,71,18,360
387,30,23,14.07.2024,18,458,571,113,2034
239,8,9,29.02.2024,10,64,70,6,60
349,24,19,06.04.2024,4,313,380,67,268
874,11,13,22.10.2024,1,179,193,14,14
549,7,28,17.07.2024,14,183,256,73,1022
817,22,30,05.03.2024,17,359,474,115,1955
228,4,13,05.01.2024,18,456,573,117,2106
149,27,10,22.04.2024,16,368,462,94,1504
616,10,5,06.12.2024,2,326,389,63,126
515,23,4,20.05.2024,19,264,352,88,1672
221,16,10,26.12.2024,13,50,75,25,325
342,5,27,17.04.2024,8,378,522,144,1152
946,28,25,01.04.2024,16,392,481,89,1424
835,22,30,22.03.2024,1,300,368,68,68
433,22,16,27.06.2024,13,220,238,18,234
745,10,10,22.12.2024,7,378,543,165,1155
404,4,5,14.06.2024,19,463,654,191,3629
871,30,23,04.06.2024,15,355,399,44,660
141,15,23,04.09.2024,10,479,534,55,550
224,26,24,10.04.2024,1,205,282,77,77
590,4,22,16.03.2024,13,238,323,85,1105
173,30,2,19.02.2024,12,262,296,34,408
54,4,17,28.11.2024,11,323,402,79,869
153,21,24,25.07.2024,8,37,41,4,32
407,16,10,18.12.2024,20,108,145,37,740
385,25,23,09.12.2024,3,418,526,108,324
838,21,13,20.05.2024,15,208,219,11,165
120,3,4,07.09.2024,17,135,143,8,136
587,19,16,20.05.2024,4,426,561,135,540
394,16,21,25.12.2024,14,172,225,53,742
102,11,3,31.12.2024,18,114,140,26,468
718,1,13,11.10.2024,18,421,596,175,3150
501,3,17,26.10.2024,18,385,546,161,2898
668,4,25,16.04.2024,4,112,161,49,196
712,6,1,11.10.2024,15,429,511,82,1230
41,5,19,15.04.2024,6,64,83,19,114
872,25,2,13.02.2024,4,279,330,51,204
990,18,6,04.08.2024,1,147,174,27,27
969,17,29,30.05.2024,18,247,275,28,504
503,23,11,24.09.2024,12,330,426,96,1152
215,23,4,05.12.2024,2,141,150,9,18
146,10,28,20.04.2024,5,328,426,98,490
606,12,9,06.03.2024,20,236,256,20,400
262,9,13,28.11.2024,6,224,281,57,342
968,9,22,05.08.2024,5,294,336,42,210
645,24,9,20.11.2024,7,385,469,84,588
674,21,27,18.09.2024,20,103,128,25,500
158,11,26,10.08.2024,13,33,49,16,208
254,3,9,04.03.2024,18,76,103,27,486
417,3,11,23.11.2024,3,205,299,94,282
797,9,5,25.04.2024,9,25,27,2,18
993,8,13,23.02.2024,4,109,140,31,124
897,10,19,07.09.2024,4,290,350,60,240
586,28,10,09.10.2024,9,331,362,31,279
50,6,11,18.07.2024,6,196,277,81,486
695,26,18,09.10.2024,20,471,675,204,4080
489,19,5,12.05.2024,1,371,475,104,104
160,22,5,14.03.2024,13,310,428,118,1534
55,30,24,23.11.2024,12,382,535,153,1836
695,20,14,27.12.2024,15,113,141,28,420
363,26,15,14.09.2024,10,161,238,77,770
534,23,29,27.04.2024,10,345,495,150,1500
971,10,14,09.06.2024,3,344,374,30,90
748,8,3,25.03.2024,19,49,53,4,76
293,18,30,09.09.2024,1,237,321,84,84
955,24,5,02.09.2024,16,283,384,101,1616
694,29,18,23.12.2024,4,227,240,13,52
195,30,27,04.01.2024,14,379,489,110,1540
354,8,24,04.12.2024,17,370,490,120,2040
622,15,6,11.12.2024,17,482,555,73,1241
77,12,27,09.03.2024,17,200,296,96,1632
433,16,13,28.03.2024,12,77,93,16,192
696,8,27,03.10.2024,4,168,199,31,124
301,9,7,02.01.2024,19,221,254,33,627
313,30,30,25.11.2024,17,442,642,200,3400
958,15,29,12.11.2024,16,49,59,10,160
631,15,11,01.06.2024,12,74,78,4,48
912,24,6,24.07.2024,12,24,26,2,24
504,7,3,27.09.2024,17,480,537,57,969
127,30,16,04.01.2024,5,413,556,143,715
232,16,13,10.07.2024,10,206,256,50,500
187,18,26,17.05.2024,4,244,328,84,336
450,6,5,30.06.2024,14,22,27,5,70
892,23,7,26.02.2024,7,165,176,11,77
405,14,24,18.06.2024,2,102,138,36,72
972,16,22,16.05.2024,4,235,298,63,252
508,26,22,31.12.2024,5,186,258,72,360
800,29,13,13.09.2024,13,87,96,9,117
111,26,1,05.03.2024,5,196,250,54,270
786,22,8,27.01.2024,11,239,356,117,1287
756,1,14,02.09.2024,10,164,208,44,440
780,14,8,12.11.2024,5,393,503,110,550
256,9,25,28.02.2024,9,378,439,61,549
841,14,7,30.08.2024,4,378,521,143,572
626,6,7,29.10.2024,5,137,151,14,70
411,2,9,08.04.2024,5,238,252,14,70
205,3,28,27.01.2024,13,228,293,65,845
717,21,8,23.04.2024,11,238,301,63,693
523,14,21,27.01.2024,10,76,89,13,130
288,12,23,02.08.2024,8,183,266,83,664
187,2,1,27.01.2024,11,128,151,23,253
287,30,20,21.02.2024,14,114,133,19,266
504,12,11,04.06.2024,4,69,93,24,96
700,18,25,07.03.2024,11,204,282,78,858
371,24,25,28.10.2024,17,329,400,71,1207
666,9,7,26.10.2024,13,64,93,29,377
134,21,24,04.11.2024,4,41,54,13,52
935,29,21,07.04.2024,7,380,475,95,665
102,3,18,12.11.2024,11,174,239,65,715
780,7,18,19.03.2024,2,85,97,12,24
564,23,9,13.10.2024,12,478,581,103,1236
645,23,4,11.08.2024,3,267,331,64,192
954,17,26,12.01.2024,6,326,383,57,342
991,5,10,24.01.2024,19,51,72,21,399
711,7,24,22.07.2024,16,370,477,107,1712
526,3,6,12.08.2024,17,216,281,65,1105
400,13,20,19.05.2024,7,114,120,6,42
586,7,19,22.12.2024,1,470,690,220,220
526,15,17,28.12.2024,17,152,180,28,476
226,10,23,17.05.2024,18,80,90,10,180
47,18,8,29.05.2024,2,347,387,40,80
905,9,30,09.03.2024,9,467,656,189,1701
658,8,27,17.04.2024,18,79,83,4,72
356,21,20,07.07.2024,11,62,92,30,330
906,18,9,09.03.2024,14,479,635,156,2184
333,2,21,06.01.2024,12,132,182,50,600
287,6,9,09.01.2024,18,356,531,175,3150
797,25,19,24.02.2024,13,354,413,59,767
642,21,20,09.10.2024,7,438,547,109,763
333,9,7,24.10.2024,13,99,124,25,325
748,24,14,07.07.2024,5,481,609,128,640
508,6,15,04.04.2024,6,116,152,36,216
966,24,6,27.11.2024,10,30,36,6,60
907,6,27,20.07.2024,20,116,125,9,180
74,14,8,20.08.2024,13,71,98,27,351
141,24,25,07.01.2024,20,71,87,16,320
22,4,27,07.01.2024,2,87,101,14,28
86,9,5,17.11.2024,20,26,37,11,220
10,26,4,04.10.2024,11,456,624,168,1848
208,5,16,15.10.2024,15,437,491,54,810
340,16,5,04.05.2024,2,298,406,108,216
643,18,4,11.01.2024,2,72,93,21,42
106,17,29,31.07.2024,5,20,29,9,45
25,8,14,16.07.2024,5,200,269,69,345
232,30,29,16.12.2024,13,371,537,166,2158
843,29,4,08.09.2024,6,76,87,11,66
980,10,12,09.02.2024,20,190,210,20,400
946,30,30,13.02.2024,2,329,368,39,78
439,17,11,03.11.2024,6,367,456,89,534
915,22,22,03.06.2024,20,438,516,78,1560
897,4,9,12.09.2024,12,497,581,84,1008
929,23,26,09.02.2024,1,461,678,217,217
153,25,21,16.03.2024,11,95,116,21,231
739,26,26,01.09.2024,3,77,101,24,72
983,24,9,15.03.2024,3,185,277,92,276
187,25,13,29.06.2024,11,273,339,66,726
711,14,20,21.11.2024,11,90,127,37,407
670,30,8,15.07.2024,14,301,383,82,1148
547,16,18,01.10.2024,8,216,235,19,152
733,14,17,22.10.2024,8,379,413,34,272
371,1,7,09.01.2024,12,305,385,80,960
137,30,4,31.01.2024,12,204,292,88,1056
888,25,27,12.03.2024,10,255,284,29,290
874,18,30,03.08.2024,8,127,181,54,432
58,24,5,01.03.2024,5,213,294,81,405
713,14,12,28.01.2024,4,359,471,112,448
489,27,20,21.03.2024,1,95,115,20,20
81,8,3,07.01.2024,19,445,630,185,3515
154,25,6,28.08.2024,5,403,519,116,580
972,10,16,29.07.2024,11,247,346,99,1089
712,1,10,26.02.2024,5,50,72,22,110
33,20,25,29.03.2024,17,102,108,6,102
853,14,22,20.08.2024,18,384,547,163,2934
942,19,17,05.06.2024,8,236,347,111,888
279,3,17,12.07.2024,5,400,458,58,290
634,2,8,19.07.2024,6,441,611,170,1020
573,20,27,09.02.2024,15,264,314,50,750
658,13,27,13.07.2024,6,47,66,19,114
663,14,7,18.05.2024,4,73,79,6,24
618,25,28,20.06.2024,1,142,167,25,25
555,4,3,18.04.2024,20,25,35,10,200
317,7,18,13.04.2024,2,143,167,24,48
584,19,2,15.10.2024,16,43,46,3,48
96,10,1,01.07.2024,10,223,284,61,610
323,25,13,01.07.2024,5,379,513,134,670
340,14,29,14.09.2024,4,277,392,115,460
154,1,19,14.07.2024,16,320,461,141,2256
39,10,6,18.03.2024,15,60,87,27,405
96,23,8,20.04.2024,5,413,567,154,770
987,17,17,07.11.2024,17,496,692,196,3332
459,26,5,22.06.2024,10,204,271,67,670
963,14,2,30.12.2024,13,142,162,20,260
626,20,3,19.03.2024,19,341,511,170,3230
100,26,1,14.03.2024,10,300,432,132,1320
817,26,29,14.02.2024,16,68,85,17,272
174,30,10,23.03.2024,3,163,213,50,150
362,3,3,01.04.2024,15,152,227,75,1125
263,25,29,14.08.2024,5,83,123,40,200
500,2,12,26.05.2024,13,229,329,100,1300
940,22,5,13.08.2024,12,282,403,121,1452
975,11,12,12.02.2024,14,279,349,70,980
899,29,22,22.01.2024,20,349,375,26,520
810,8,23,14.10.2024,1,99,142,43,43
298,13,6,18.10.2024,13,457,495,38,494
398,28,15,08.12.2024,3,198,249,51,153
658,18,29,26.08.2024,4,63,71,8,32
111,30,30,22.07.2024,14,122,150,28,392
67,11,11,05.11.2024,16,128,175,47,752
488,4,9,20.08.2024,2,299,335,36,72
482,5,21,19.04.2024,11,310,330,20,220
616,25,13,01.02.2024,12,424,527,103,1236
485,7,2,18.04.2024,1,408,554,146,146
277,9,21,31.03.2024,3,92,99,7,21
415,3,10,30.12.2024,15,466,577,111,1665
220,22,29,12.05.2024,6,445,478,33,198
917,29,14,24.06.2024,10,104,118,14,140
965,14,16,31.08.2024,18,372,522,150,2700
989,23,14,30.06.2024,19,219,311,92,1748
575,26,29,01.11.2024,7,59,81,22,154
593,20,5,14.06.2024,11,27,30,3,33
470,30,5,12.09.2024,11,78,110,32,352
691,14,9,23.09.2024,1,250,369,119,119
878,5,21,18.08.2024,19,69,74,5,95
764,7,14,22.12.2024,18,416,468,52,936
387,7,12,17.04.2024,7,367,481,114,798
15,12,27,05.07.2024,1,174,253,79,79
515,27,28,04.03.2024,16,352,528,176,2816
424,14,12,29.06.2024,18,238,306,68,1224
784,11,4,31.03.2024,15,239,291,52,780
567,20,6,04.10.2024,14,215,253,38,532
676,23,22,11.08.2024,10,379,504,125,1250
948,29,28,20.02.2024,3,432,616,184,552
92,21,1,11.11.2024,14,73,93,20,280
770,20,30,05.10.2024,4,344,430,86,344
596,26,2,07.12.2024,10,456,565,109,1090
229,25,15,09.10.2024,13,78,89,11,143
481,4,12,25.08.2024,14,484,687,203,2842
721,26,24,21.07.2024,1,211,296,85,85
520,10,9,03.12.2024,9,177,253,76,684
815,30,14,10.12.2024,8,22,32,10,80
425,2,1,14.01.2024,5,424,517,93,465
837,17,27,03.11.2024,11,191,215,24,264
586,14,8,11.10.2024,13,118,157,39,507
403,27,2,22.10.2024,14,85,125,40,560
400,24,6,25.07.2024,11,284,318,34,374
237,4,23,05.03.2024,17,80,107,27,459
804,13,27,17.11.2024,9,448,582,134,1206
972,11,7,17.02.2024,3,33,41,8,24
644,25,19,19.03.2024,1,336,460,124,124
943,3,19,14.07.2024,1,400,552,152,152
465,21,21,02.07.2024,6,142,191,49,294
228,10,7,01.10.2024,8,391,548,157,1256
805,13,25,13.05.2024,2,160,174,14,28
148,21,1,22.11.2024,19,463,508,45,855
471,30,20,03.03.2024,4,92,108,16,64
917,6,3,09.02.2024,16,452,548,96,1536
859,7,13,21.02.2024,16,427,453,26,416
76,16,21,09.02.2024,7,371,460,89,623
912,11,21,18.08.2024,6,112,133,21,126
926,6,22,17.10.2024,20,457,486,29,580
1000,11,12,04.09.2024,20,327,424,97,1940
163,17,24,10.05.2024,4,118,156,38,152
549,1,17,19.09.2024,5,130,187,57,285
118,29,7,16.01.2024,11,90,103,13,143
746,23,5,17.05.2024,9,266,303,37,333
95,12,23,09.10.2024,10,259,359,100,1000
508,14,17,23.07.2024,7,148,167,19,133
704,28,29,23.05.2024,13,72,95,23,299
785,19,10,25.03.2024,7,389,494,105,735
905,15,14,01.11.2024,9,437,522,85,765
111,20,13,07.08.2024,7,310,375,65,455
920,21,27,02.02.2024,15,105,152,47,705
982,17,9,27.10.2024,14,170,225,55,770
899,21,17,29.06.2024,13,35,39,4,52
829,11,14,05.04.2024,12,145,157,12,144
673,12,12,15.03.2024,11,82,86,4,44
705,1,23,17.06.2024,7,258,337,79,553
330,29,8,14.10.2024,3,217,256,39,117
218,17,7,22.02.2024,18,162,222,60,1080
969,29,26,09.12.2024,3,313,454,141,423
432,22,25,10.08.2024,11,436,521,85,935
202,2,26,09.09.2024,16,43,64,21,336
432,4,4,19.08.2024,6,327,391,64,384
393,8,19,11.01.2024,10,29,39,10,100
877,19,1,24.08.2024,10,87,124,37,370
413,2,29,30.09.2024,17,40,48,8,136
17,3,16,18.02.2024,14,390,462,72,1008
325,25,12,23.07.2024,3,304,425,121,363
506,20,2,20.07.2024,10,376,561,185,1850
506,28,21,03.03.2024,12,500,664,164,1968
30,8,2,06.01.2024,5,73,109,36,180
883,23,24,11.08.2024,8,107,117,10,80
742,29,26,07.07.2024,18,22,32,10,180
889,2,9,23.01.2024,4,44,65,21,84
77,9,11,18.12.2024,20,425,602,177,3540
277,23,6,11.03.2024,19,255,282,27,513
327,28,5,26.10.2024,14,346,433,87,1218
126,17,17,03.05.2024,19,264,356,92,1748
1000,9,11,04.09.2024,8,67,78,11,88
304,23,3,29.06.2024,18,447,645,198,3564
676,21,24,15.04.2024,3,58,86,28,84
62,7,1,09.12.2024,7,259,367,108,756
193,16,4,23.06.2024,7,436,574,138,966
541,17,28,09.06.2024,10,382,479,97,970
158,28,17,24.02.2024,5,132,193,61,305
395,15,28,13.11.2024,17,123,172,49,833
193,3,9,04.08.2024,6,371,441,70,420
891,19,21,22.02.2024,5,256,370,114,570
763,4,8,09.01.2024,15,115,135,20,300
488,22,17,19.08.2024,12,155,171,16,192
564,3,12,08.08.2024,7,97,119,22,154
442,17,11,28.01.2024,15,159,193,34,510
51,21,13,04.08.2024,7,170,193,23,161
181,20,9,28.09.2024,20,272,349,77,1540
112,22,2,26.11.2024,8,76,87,11,88
55,29,2,21.10.2024,9,142,153,11,99
104,9,8,13.11.2024,13,220,270,50,650
226,24,27,20.12.2024,9,273,312,39,351
805,7,12,22.11.2024,10,381,502,121,1210
752,1,4,04.04.2024,17,484,661,177,3009
489,24,10,18.12.2024,8,107,128,21,168
72,6,6,19.06.2024,15,92,136,44,660
683,16,14,20.06.2024,1,110,164,54,54
903,3,6,13.12.2024,1,324,392,68,68
486,19,1,07.09.2024,8,261,287,26,208
839,1,19,14.12.2024,10,447,515,68,680
516,6,25,16.03.2024,4,71,84,13,52
754,11,15,08.09.2024,12,299,349,50,600
499,9,12,22.08.2024,1,443,535,92,92
728,11,29,22.09.2024,20,267,294,27,540
703,17,24,23.11.2024,1,95,142,47,47
877,8,22,13.03.2024,12,274,292,18,216
592,24,23,08.08.2024,12,125,173,48,576
199,30,13,23.11.2024,4,160,231,71,284
696,18,29,18.08.2024,17,109,127,18,306
696,12,29,18.06.2024,13,321,397,76,988
283,10,7,22.01.2024,19,286,391,105,1995
855,20,4,09.08.2024,15,310,461,151,2265
812,12,10,26.02.2024,1,275,403,128,128
151,15,22,17.03.2024,17,168,224,56,952
681,6,10,06.09.2024,10,53,75,22,220
16,15,2,21.04.2024,10,442,582,140,1400
55,16,10,03.01.2024,14,200,269,69,966
1,2,9,11.03.2024,12,469,552,83,996
880,17,22,14.10.2024,5,64,88,24,120
147,24,7,09.08.2024,19,490,532,42,798
225,2,16,30.06.2024,8,435,590,155,1240
396,14,13,20.02.2024,9,491,582,91,819
319,6,19,11.08.2024,11,431,565,134,1474
700,25,7,08.05.2024,5,233,303,70,350
309,10,3,01.06.2024,19,494,658,164,3116
559,6,13,11.08.2024,4,90,116,26,104
711,11,17,16.12.2024,12,259,313,54,648
478,14,14,24.08.2024,1,487,634,147,147
981,25,14,15.02.2024,5,334,487,153,765
806,8,19,19.09.2024,12,85,113,28,336
922,19,29,30.05.2024,2,406,581,175,350
129,13,22,04.01.2024,15,433,603,170,2550
531,15,27,28.01.2024,3,48,56,8,24
666,4,11,31.10.2024,4,440,520,80,320
494,23,11,01.02.2024,4,399,524,125,500
524,24,23,28.01.2024,7,284,317,33,231
759,16,5,24.04.2024,5,174,232,58,290
737,30,1,05.09.2024,20,372,424,52,1040
69,1,5,05.11.2024,4,286,313,27,108
210,4,16,13.01.2024,17,247,303,56,952
949,4,10,26.07.2024,16,114,162,48,768
862,28,18,13.05.2024,20,368,459,91,1820
674,20,4,09.08.2024,5,345,366,21,105
146,27,24,02.12.2024,8,107,137,30,240
717,18,7,31.08.2024,16,168,198,30,480
103,19,16,07.07.2024,9,220,269,49,441
820,4,15,01.08.2024,14,95,101,6,84
469,4,19,18.07.2024,1,317,376,59,59
661,21,29,02.12.2024,20,247,264,17,340
929,12,5,27.08.2024,15,161,170,9,135
163,12,17,14.09.2024,7,198,288,90,630
538,13,17,02.02.2024,6,355,397,42,252
672,24,19,22.06.2024,15,386,554,168,2520
144,9,26,03.12.2024,10,492,604,112,1120
939,27,21,04.09.2024,13,261,345,84,1092
185,19,23,16.09.2024,17,152,168,16,272
332,19,19,27.06.2024,19,336,478,142,2698
70,2,1,22.03.2024,8,69,93,24,192
512,30,22,31.08.2024,11,409,472,63,693
791,26,30,01.05.2024,4,480,694,214,856
746,29,13,03.08.2024,3,51,68,17,51
118,2,28,07.02.2024,15,410,500,90,1350
647,27,1,30.03.2024,11,75,102,27,297
387,5,21,20.10.2024,18,122,139,17,306
503,15,22,26.05.2024,8,123,170,47,376
445,27,17,08.04.2024,3,318,337,19,57
983,22,4,14.04.2024,2,434,483,49,98
6,12,25,27.07.2024,19,299,430,131,2489
349,6,22,24.11.2024,17,274,311,37,629
213,19,27,30.08.2024,17,200,242,42,714
922,18,28,11.03.2024,3,244,303,59,177
386,28,3,18.10.2024,3,85,119,34,102
306,4,4,12.09.2024,8,46,61,15,120
339,1,8,28.05.2024,9,219,299,80,720
70,28,28,21.03.2024,10,58,75,17,170
248,28,17,08.11.2024,17,179,220,41,697
59,18,23,26.02.2024,19,261,384,123,2337
270,21,1,17.01.2024,11,235,274,39,429
343,29,25,31.01.2024,5,124,161,37,185
752,11,30,05.12.2024,2,140,178,38,76
825,19,29,08.11.2024,2,197,294,97,194
973,14,20,09.11.2024,3,474,615,141,423
970,5,9,22.01.2024,4,38,48,10,40
231,21,12,08.08.2024,16,175,245,70,1120
898,8,1,29.01.2024,1,416,583,167,167
201,18,20,13.07.2024,1,302,383,81,81
397,25,13,22.12.2024,5,240,328,88,440
563,5,4,12.08.2024,4,479,636,157,628
926,12,12,09.04.2024,11,243,356,113,1243
244,8,3,28.10.2024,1,136,168,32,32
771,29,26,01.10.2024,19,43,64,21,399
16,28,24,07.05.2024,2,59,63,4,8
450,6,10,23.01.2024,11,199,263,64,704
912,8,10,07.03.2024,20,223,282,59,1180
126,22,3,09.02.2024,9,500,647,147,1323
507,23,24,01.07.2024,8,247,339,92,736
965,12,25,09.10.2024,10,464,624,160,1600
540,29,9,12.06.2024,18,277,304,27,486
355,29,14,27.12.2024,20,268,315,47,940
209,30,5,23.09.2024,8,176,244,68,544
216,4,12,13.03.2024,2,140,191,51,102
666,25,15,28.02.2024,1,275,392,117,117
277,9,19,15.07.2024,10,443,658,215,2150
62,9,28,08.11.2024,13,273,289,16,208
392,13,15,23.01.2024,8,125,153,28,224
676,14,18,27.01.2024,10,36,47,11,110
357,30,1,07.11.2024,11,492,700,208,2288
269,26,25,29.10.2024,7,407,432,25,175
744,27,20,10.08.2024,14,420,579,159,2226
754,25,2,25.02.2024,18,218,322,104,1872
955,22,10,30.09.2024,15,237,310,73,1095
582,25,17,13.05.2024,6,215,271,56,336
947,8,5,08.01.2024,9,429,582,153,1377
281,3,8,04.10.2024,10,192,251,59,590
40,20,9,04.07.2024,9,357,415,58,522
669,26,25,07.11.2024,1,83,99,16,16
677,11,27,15.05.2024,6,247,311,64,384
451,1,15,19.01.2024,12,265,354,89,1068
570,7,14,30.01.2024,19,500,543,43,817
919,20,18,09.06.2024,3,245,277,32,96
785,26,9,12.05.2024,16,85,98,13,208
179,5,28,12.11.2024,2,139,153,14,28
40,6,22,16.09.2024,15,316,377,61,915
567,23,8,01.02.2024,9,151,160,9,81
866,28,28,29.06.2024,18,387,414,27,486
241,12,4,09.02.2024,17,247,272,25,425
80,8,7,15.06.2024,19,210,299,89,1691
698,14,3,24.11.2024,14,468,551,83,1162
26,11,20,03.07.2024,11,228,331,103,1133
384,16,10,14.11.2024,1,102,124,22,22
298,30,5,29.10.2024,1,74,98,24,24
828,11,17,17.09.2024,19,384,463,79,1501
221,13,27,25.10.2024,2,356,490,134,268
391,25,21,10.02.2024,3,498,745,247,741
579,17,19,18.11.2024,18,395,489,94,1692
751,4,28,27.09.2024,2,330,417,87,174
538,17,15,11.06.2024,9,119,170,51,459
301,30,8,17.06.2024,8,429,599,170,1360
371,8,15,10.06.2024,4,374,433,59,236
751,29,14,04.07.2024,3,200,260,60,180
79,30,12,30.11.2024,16,329,380,51,816
806,14,8,18.10.2024,5,493,637,144,720
796,30,14,11.12.2024,19,360,400,40,760
267,26,10,23.06.2024,11,80,87,7,77
432,17,5,21.10.2024,16,343,496,153,2448
203,29,6,20.08.2024,1,105,116,11,11
270,25,18,30.12.2024,16,400,438,38,608
891,2,27,08.08.2024,1,373,420,47,47
75,5,17,28.09.2024,13,482,598,116,1508
131,13,23,12.10.2024,8,384,454,70,560
345,29,27,21.06.2024,19,331,439,108,2052
740,2,3,30.06.2024,15,486,600,114,1710
461,24,27,11.08.2024,10,407,515,108,1080
138,24,6,28.10.2024,17,62,69,7,119
8,19,19,08.07.2024,15,214,256,42,630
181,17,24,28.10.2024,9,415,454,39,351
305,16,11,25.01.2024,19,285,414,129,2451
594,17,28,06.08.2024,10,185,226,41,410
776,6,5,22.01.2024,7,240,308,68,476
589,29,20,09.06.2024,4,197,232,35,140
122,10,9,06.09.2024,15,134,194,60,900
296,30,9,06.11.2024,4,493,569,76,304
286,5,4,15.04.2024,18,449,574,125,2250
173,1,20,21.01.2024,18,295,416,121,2178
7,16,27,14.01.2024,12,124,146,22,264
971,19,14,15.08.2024,17,84,120,36,612
303,30,4,27.12.2024,4,247,358,111,444
506,9,3,11.03.2024,9,394,532,138,1242
992,12,26,10.02.2024,8,392,425,33,264
161,17,11,21.05.2024,15,342,472,130,1950
689,25,3,27.12.2024,11,476,698,222,2442
444,4,30,27.12.2024,17,182,207,25,425
572,22,27,16.11.2024,2,344,458,114,228
252,5,19,11.07.2024,8,364,414,50,400
482,5,16,05.04.2024,16,164,182,18,288
651,29,3,21.09.2024,7,21,26,5,35
503,18,20,16.04.2024,6,39,48,9,54
270,20,13,19.11.2024,19,140,187,47,893
496,17,22,02.04.2024,10,450,519,69,690
300,22,16,07.09.2024,13,326,395,69,897
493,10,4,22.04.2024,4,471,685,214,856
783,10,14,16.08.2024,11,146,197,51,561
119,6,15,12.06.2024,4,197,269,72,288
722,5,25,04.09.2024,16,327,404,77,1232
241,1,10,17.05.2024,17,130,189,59,1003
802,14,2,14.10.2024,11,153,207,54,594
422,13,26,14.08.2024,14,224,261,37,518
56,9,16,22.04.2024,11,345,489,144,1584
316,15,14,23.04.2024,19,468,526,58,1102
212,25,21,26.02.2024,20,332,398,66,1320
620,18,1,11.01.2024,13,66,92,26,338
342,30,12,10.10.2024,3,355,381,26,78
216,12,18,11.04.2024,6,449,580,131,786
881,23,8,28.05.2024,6,486,592,106,636
424,7,18,07.05.2024,1,38,54,16,16
774,17,4,13.09.2024,13,425,539,114,1482
161,10,10,13.01.2024,8,343,479,136,1088
254,2,9,04.03.2024,13,355,437,82,1066
838,24,29,18.05.2024,3,59,64,5,15
740,23,25,31.07.2024,1,27,37,10,10
555,20,30,18.03.2024,4,396,521,125,500
401,7,27,06.11.2024,10,421,503,82,820
525,24,1,03.06.2024,9,254,290,36,324
271,21,19,29.08.2024,13,169,210,41,533
228,14,18,22.05.2024,16,165,241,76,1216
547,17,8,14.07.2024,1,274,377,103,103
975,12,25,06.10.2024,4,251,289,38,152
999,1,13,28.04.2024,15,209,264,55,825
112,21,10,19.06.2024,5,434,579,145,725
86,4,18,27.03.2024,7,462,681,219,1533
608,8,3,13.03.2024,13,335,478,143,1859
536,24,27,17.10.2024,8,50,70,20,160
259,14,10,21.06.2024,5,38,45,7,35
579,20,14,03.01.2024,9,373,427,54,486
576,26,16,06.10.2024,16,180,267,87,1392
242,11,15,28.12.2024,16,283,368,85,1360
758,24,3,23.02.2024,14,378,410,32,448
131,25,1,23.03.2024,17,403,445,42,714
203,15,28,28.02.2024,2,473,587,114,228
175,21,26,25.09.2024,16,91,126,35,560
561,14,13,05.01.2024,10,80,100,20,200
302,24,30,12.12.2024,9,287,343,56,504
911,12,19,28.11.2024,6,92,109,17,102
702,7,26,10.11.2024,12,285,377,92,1104
484,15,7,18.06.2024,5,104,134,30,150
850,16,1,11.06.2024,14,111,124,13,182
69,1,10,25.12.2024,7,122,166,44,308
551,15,11,18.02.2024,2,339,427,88,176
161,3,12,21.11.2024,18,472,544,72,1296
644,1,30,08.04.2024,9,165,234,69,621
889,14,19,05.06.2024,12,339,473,134,1608
957,9,18,04.10.2024,7,59,78,19,133
106,24,7,23.05.2024,6,154,201,47,282
130,26,17,27.10.2024,13,189,247,58,754
874,19,20,21.05.2024,20,362,528,166,3320
215,6,1,28.04.2024,7,66,97,31,217
630,5,5,25.03.2024,16,467,490,23,368
80,29,2,11.03.2024,17,433,540,107,1819
681,16,11,03.06.2024,17,409,451,42,714
574,13,13,16.07.2024,16,201,239,38,608
535,11,17,10.02.2024,20,451,517,66,1320
171,21,27,22.05.2024,5,450,561,111,555
453,16,23,08.05.2024,4,305,444,139,556
668,12,6,13.01.2024,12,457,576,119,1428
687,12,24,05.08.2024,7,335,436,101,707
943,7,13,10.07.2024,6,497,689,192,1152
11,7,15,03.07.2024,17,119,125,6,102
318,11,4,07.07.2024,9,277,406,129,1161
622,9,2,27.11.2024,9,348,440,92,828
45,23,23,09.05.2024,9,340,366,26,234
586,27,1,29.08.2024,20,343,430,87,1740
178,16,24,27.11.2024,18,433,475,42,756
379,1,20,31.12.2024,5,381,526,145,725
892,28,5,12.02.2024,14,447,639,192,2688
58,15,21,29.12.2024,2,180,197,17,34
558,9,28,09.04.2024,20,397,420,23,460
858,22,28,11.06.2024,6,483,722,239,1434
740,12,17,08.01.2024,13,233,332,99,1287
686,2,3,08.04.2024,17,95,131,36,612
86,6,15,23.01.2024,9,331,377,46,414
518,14,6,21.11.2024,1,179,210,31,31
360,4,11,26.08.2024,19,448,611,163,3097
580,30,15,15.02.2024,4,490,534,44,176
748,3,6,11.06.2024,19,340,505,165,3135
786,6,26,06.01.2024,7,346,422,76,532
84,29,24,06.05.2024,10,448,608,160,1600
966,29,28,07.04.2024,5,178,191,13,65
723,10,6,22.05.2024,5,309,368,59,295
232,27,7,19.05.2024,7,110,164,54,378
266,23,15,15.05.2024,3,270,327,57,171
373,12,25,24.11.2024,17,250,356,106,1802
704,27,6,19.01.2024,19,217,243,26,494
583,7,23,10.08.2024,12,350,495,145,1740
816,10,7,24.06.2024,17,302,430,128,2176
814,9,3,19.09.2024,7,152,175,23,161
268,2,30,29.02.2024,17,357,476,119,2023
487,5,15,27.10.2024,11,210,274,64,704
675,19,29,18.01.2024,11,379,416,37,407
368,28,29,05.01.2024,6,235,297,62,372
345,21,29,21.02.2024,6,487,590,103,618
167,15,18,05.04.2024,1,244,345,101,101
468,19,19,21.12.2024,14,394,485,91,1274
855,8,9,10.07.2024,20,192,243,51,1020
411,10,2,29.04.2024,17,75,93,18,306
793,9,19,24.07.2024,19,34,38,4,76
171,30,10,01.11.2024,17,121,179,58,986
582,25,5,07.03.2024,11,423,627,204,2244
994,3,10,13.03.2024,12,254,312,58,696
472,1,22,16.03.2024,7,472,532,60,420
315,3,6,30.04.2024,7,243,265,22,154
251,5,22,11.10.2024,12,22,28,6,72
353,4,16,08.10.2024,13,377,432,55,715
484,22,13,25.08.2024,8,410,600,190,1520
397,5,11,09.03.2024,13,415,497,82,1066
290,27,22,05.08.2024,20,221,285,64,1280
356,16,22,27.10.2024,1,133,193,60,60
183,25,8,07.07.2024,12,194,247,53,636
2,20,20,22.07.2024,3,350,404,54,162
512,7,2,18.04.2024,10,242,264,22,220
394,21,6,05.08.2024,5,165,196,31,155
692,27,16,18.01.2024,9,235,266,31,279
408,22,17,24.02.2024,15,432,470,38,570
703,24,4,01.12.2024,13,431,609,178,2314
165,11,5,21.10.2024,17,216,294,78,1326
12,16,21,09.12.2024,13,236,330,94,1222
311,14,9,20.11.2024,4,329,465,136,544
931,15,17,09.07.2024,16,384,461,77,1232
548,12,4,01.04.2024,14,292,406,114,1596
892,22,3,17.03.2024,1,192,284,92,92
725,19,9,11.04.2024,17,436,578,142,2414
894,15,14,25.01.2024,15,164,175,11,165
889,16,15,06.07.2024,2,475,627,152,304
379,9,14,21.06.2024,10,412,584,172,1720
556,9,6,30.05.2024,12,233,246,13,156
333,10,21,19.01.2024,20,77,93,16,320
38,18,24,21.07.2024,8,109,119,10,80
97,5,24,15.03.2024,16,240,348,108,1728
354,15,23,12.11.2024,8,490,697,207,1656
855,30,24,25.09.2024,19,254,271,17,323
335,12,2,16.03.2024,20,390,521,131,2620
904,4,13,19.09.2024,3,192,282,90,270
768,10,14,24.07.2024,1,114,168,54,54
264,24,21,10.02.2024,14,79,111,32,448
585,9,10,11.11.2024,17,296,425,129,2193
250,23,26,26.01.2024,12,313,395,82,984
779,30,14,20.05.2024,6,161,205,44,264
47,20,13,02.04.2024,10,159,167,8,80
213,1,26,31.07.2024,5,160,187,27,135
614,26,21,11.06.2024,4,133,153,20,80
727,11,8,02.02.2024,20,167,230,63,1260
624,27,15,28.10.2024,14,345,455,110,1540
555,13,16,12.10.2024,1,195,235,40,40
355,27,15,18.03.2024,15,457,633,176,2640
216,18,23,28.03.2024,13,150,185,35,455
677,28,19,10.02.2024,16,307,458,151,2416
86,7,24,28.09.2024,12,175,207,32,384
323,15,22,27.08.2024,1,99,132,33,33
171,20,12,16.10.2024,14,232,348,116,1624
24,25,10,11.10.2024,16,140,171,31,496
551,5,13,06.11.2024,4,69,85,16,64
217,4,19,28.05.2024,6,462,518,56,336
797,24,13,08.10.2024,14,200,278,78,1092
429,29,20,22.05.2024,11,414,502,88,968
109,22,29,17.12.2024,11,277,358,81,891
402,8,28,25.07.2024,16,407,512,105,1680
846,30,15,21.03.2024,6,224,264,40,240
546,27,11,25.08.2024,6,369,538,169,1014
393,19,21,02.08.2024,14,230,261,31,434
30,20,8,11.03.2024,20,337,430,93,1860
83,20,19,28.07.2024,1,186,246,60,60
171,19,21,29.08.2024,3,209,222,13,39
616,29,26,30.11.2024,13,302,387,85,1105
198,28,30,23.03.2024,15,208,286,78,1170
246,6,16,30.12.2024,7,185,205,20,140
67,29,1,15.04.2024,19,256,322,66,1254
701,20,15,03.05.2024,6,256,326,70,420
114,26,20,18.06.2024,6,145,182,37,222
986,3,1,17.01.2024,14,463,594,131,1834
482,28,13,06.02.2024,14,153,221,68,952
551,4,23,06.11.2024,18,385,408,23,414
493,27,24,31.01.2024,10,435,535,100,1000
843,24,25,21.01.2024,12,224,307,83,996
524,21,21,13.08.2024,14,423,468,45,630
150,28,9,23.10.2024,4,389,438,49,196
423,22,11,13.03.2024,8,427,541,114,912
271,4,11,24.11.2024,3,254,369,115,345
504,25,8,13.05.2024,11,171,233,62,682
339,26,15,24.12.2024,9,310,364,54,486
37,25,5,16.03.2024,17,167,177,10,170
902,12,19,04.07.2024,10,177,261,84,840
163,19,21,05.06.2024,16,385,480,95,1520
302,5,24,21.12.2024,5,95,126,31,155
880,13,9,22.11.2024,8,34,49,15,120
598,10,5,26.10.2024,1,152,185,33,33
521,24,28,21.09.2024,13,264,351,87,1131
175,12,21,20.03.2024,19,456,582,126,2394
536,12,13,05.09.2024,6,465,598,133,798
180,16,29,13.07.2024,1,362,534,172,172
351,8,10,15.04.2024,8,96,113,17,136
797,24,26,02.03.2024,7,202,257,55,385
584,30,21,07.01.2024,17,479,552,73,1241
208,12,22,17.01.2024,13,340,372,32,416
338,17,3,18.05.2024,18,293,419,126,2268
551,28,3,29.01.2024,15,310,398,88,1320
251,9,26,03.04.2024,8,136,185,49,392
468,6,2,07.11.2024,9,302,355,53,477
761,7,24,02.02.2024,5,287,340,53,265
213,8,8,26.10.2024,19,264,332,68,1292
550,29,26,27.01.2024,11,424,566,142,1562
202,16,4,14.08.2024,3,263,300,37,111
556,19,7,02.11.2024,16,173,226,53,848
596,14,28,27.02.2024,15,418,560,142,2130
604,26,21,10.11.2024,15,20,23,3,45
417,20,9,09.09.2024,6,188,240,52,312
527,10,21,02.06.2024,9,464,598,134,1206
350,9,22,14.10.2024,17,178,237,59,1003
115,25,6,06.09.2024,1,183,266,83,83
522,16,16,24.03.2024,6,53,74,21,126
690,10,4,14.08.2024,11,346,470,124,1364
843,6,7,25.02.2024,8,129,153,24,192
313,11,25,28.09.2024,16,72,98,26,416
950,20,7,19.10.2024,5,185,207,22,110
785,13,26,28.03.2024,6,332,448,116,696
334,17,16,30.11.2024,20,423,524,101,2020
744,9,8,14.05.2024,16,498,715,217,3472
311,12,5,05.06.2024,11,392,474,82,902
764,11,15,06.06.2024,14,308,378,70,980
428,1,25,25.07.2024,2,229,277,48,96
825,5,15,20.05.2024,1,439,600,161,161
214,22,23,11.05.2024,10,446,543,97,970
330,14,26,14.07.2024,11,305,397,92,1012
205,26,7,12.11.2024,17,245,352,107,1819
110,3,8,23.03.2024,11,390,494,104,1144
739,19,16,24.01.2024,13,372,551,179,2327
724,16,8,23.05.2024,20,320,390,70,1400
104,2,21,24.06.2024,9,295,359,64,576
946,10,4,29.08.2024,5,470,652,182,910
333,25,24,30.07.2024,5,467,522,55,275
307,19,7,14.10.2024,3,244,283,39,117
587,18,25,04.12.2024,9,305,393,88,792
299,23,1,12.03.2024,3,465,653,188,564
729,24,11,03.07.2024,15,402,582,180,2700
189,11,15,26.04.2024,15,205,246,41,615
694,23,9,10.05.2024,20,402,591,189,3780
144,4,21,29.07.2024,14,222,314,92,1288
818,2,27,27.09.2024,2,487,728,241,482
383,1,19,11.08.2024,2,278,401,123,246
335,26,18,08.09.2024,10,314,377,63,630
69,24,3,16.10.2024,3,305,427,122,366
545,6,26,19.09.2024,3,313,459,146,438
625,21,7,07.02.2024,14,438,514,76,1064
463,29,29,18.03.2024,11,57,65,8,88
590,11,15,27.09.2024,14,475,503,28,392
589,10,1,15.11.2024,13,29,31,2,26
331,14,5,12.05.2024,8,319,432,113,904
335,18,15,30.11.2024,7,414,588,174,1218
948,12,29,22.10.2024,5,116,162,46,230
212,10,6,21.02.2024,1,293,387,94,94
865,2,25,06.03.2024,18,198,293,95,1710
336,28,11,27.04.2024,7,123,146,23,161
435,9,8,21.04.2024,12,33,37,4,48
921,15,4,11.07.2024,1,247,356,109,109
875,24,7,13.07.2024,2,248,309,61,122
204,7,25,13.07.2024,19,437,483,46,874
993,6,17,23.10.2024,17,82,92,10,170
215,4,16,05.11.2024,12,403,604,201,2412
426,7,7,16.02.2024,17,204,258,54,918
521,4,15,09.01.2024,1,214,302,88,88
410,28,4,30.06.2024,12,178,254,76,912
445,28,21,02.06.2024,8,379,412,33,264
660,26,13,29.08.2024,1,160,221,61,61
919,11,2,13.03.2024,8,110,143,33,264
132,17,5,12.03.2024,16,410,438,28,448
611,26,7,04.12.2024,10,210,279,69,690
844,6,14,29.03.2024,6,499,640,141,846
156,24,26,08.12.2024,6,206,298,92,552
113,26,6,16.01.2024,16,124,147,23,368
641,12,30,15.05.2024,20,184,196,12,240
27,11,1,28.08.2024,2,396,571,175,350
936,14,2,03.10.2024,13,410,541,131,1703
538,6,6,21.02.2024,1,198,288,90,90
95,14,3,27.02.2024,16,257,384,127,2032
877,29,18,13.08.2024,5,458,605,147,735
653,1,10,31.08.2024,16,480,699,219,3504
132,11,22,03.10.2024,12,334,451,117,1404
99,16,16,19.10.2024,7,84,96,12,84
133,26,5,25.04.2024,3,400,437,37,111
414,10,29,10.11.2024,4,147,169,22,88
190,24,22,03.06.2024,11,383,570,187,2057
685,19,17,21.09.2024,19,472,552,80,1520
922,5,11,04.08.2024,12,358,399,41,492
755,30,28,18.01.2024,13,343,368,25,325
203,6,1,14.03.2024,2,447,629,182,364
166,13,11,06.01.2024,19,266,337,71,1349
353,7,21,22.10.2024,13,251,376,125,1625
465,20,9,06.10.2024,15,80,111,31,465
672,25,17,21.06.2024,11,476,540,64,704
350,26,28,06.09.2024,18,253,341,88,1584
685,28,11,22.09.2024,9,52,73,21,189
437,21,1,05.10.2024,5,68,78,10,50
469,27,4,02.03.2024,18,384,454,70,1260
895,12,10,19.08.2024,14,303,452,149,2086
85,28,17,03.04.2024,13,439,647,208,2704
524,7,5,14.12.2024,8,417,441,24,192
752,24,12,26.09.2024,20,419,469,50,1000
881,17,17,25.01.2024,18,205,265,60,1080
711,17,6,10.07.2024,6,71,96,25,150
651,21,28,12.11.2024,8,451,662,211,1688
734,5,18,08.11.2024,14,459,524,65,910
51,13,10,18.07.2024,17,235,341,106,1802
480,11,5,02.06.2024,1,58,67,9,9
570,22,10,16.04.2024,20,324,480,156,3120
61,25,14,12.03.2024,5,266,378,112,560
783,26,8,19.07.2024,6,350,433,83,498
606,7,8,28.06.2024,3,135,200,65,195
283,5,29,24.07.2024,4,391,541,150,600
968,22,5,15.04.2024,15,92,124,32,480
779,11,1,22.11.2024,4,286,340,54,216
106,25,21,02.11.2024,16,138,186,48,768
306,27,4,04.10.2024,20,252,282,30,600
902,25,30,23.06.2024,9,40,49,9,81
913,9,4,16.11.2024,15,238,313,75,1125
898,23,23,06.09.2024,10,135,174,39,390
91,24,20,02.11.2024,12,143,206,63,756
681,16,27,25.12.2024,14,235,253,18,252
108,28,25,23.05.2024,9,483,562,79,711
521,11,14,07.12.2024,9,202,220,18,162
104,23,26,05.09.2024,8,319,406,87,696
606,14,22,16.05.2024,4,419,596,177,708
500,18,20,16.10.2024,13,330,424,94,1222
948,22,13,22.01.2024,20,75,99,24,480
813,21,4,21.10.2024,4,80,119,39,156
245,12,19,10.12.2024,20,235,333,98,1960
736,24,2,26.06.2024,15,456,573,117,1755
885,17,2,23.07.2024,14,362,528,166,2324
222,19,6,13.01.2024,11,70,83,13,143
423,26,1,21.08.2024,9,203,288,85,765
353,12,8,21.05.2024,15,421,451,30,450
470,23,21,14.05.2024,6,127,165,38,228
885,18,21,13.06.2024,13,405,489,84,1092
836,6,28,12.09.2024,3,190,230,40,120
552,24,26,26.04.2024,11,444,527,83,913
937,24,3,23.11.2024,13,180,239,59,767
655,6,25,14.07.2024,7,155,222,67,469
498,12,11,12.08.2024,12,406,455,49,588
173,11,1,27.02.2024,7,317,377,60,420
519,23,21,13.10.2024,10,407,530,123,1230
183,13,20,22.12.2024,3,121,132,11,33
729,20,30,05.12.2024,13,456,533,77,1001
734,11,18,30.06.2024,13,88,129,41,533
107,28,24,30.05.2024,20,311,462,151,3020
332,8,15,21.01.2024,8,300,336,36,288
281,1,16,24.04.2024,8,145,209,64,512
451,21,26,20.04.2024,5,26,31,5,25
988,1,28,09.11.2024,16,449,560,111,1776
570,18,19,08.04.2024,14,115,165,50,700
595,13,21,21.10.2024,13,402,469,67,871
816,12,26,14.05.2024,14,209,254,45,630
948,30,8,12.06.2024,18,202,219,17,306
710,5,11,25.12.2024,8,427,552,125,1000
132,4,30,16.09.2024,16,294,350,56,896
827,27,20,26.04.2024,12,387,529,142,1704
1000,18,27,24.04.2024,15,157,205,48,720
55,15,20,12.08.2024,16,322,401,79,1264
977,6,1,13.10.2024,15,306,411,105,1575
918,12,16,27.12.2024,5,52,71,19,95
67,24,9,18.10.2024,9,479,660,181,1629
731,20,16,08.08.2024,5,222,255,33,165
463,10,18,22.12.2024,10,189,218,29,290
818,29,17,27.07.2024,5,412,533,121,605
698,19,11,04.01.2024,20,47,64,17,340
367,19,4,06.02.2024,20,52,67,15,300
748,6,24,09.04.2024,8,327,457,130,1040
184,27,6,16.01.2024,16,393,434,41,656
92,4,13,20.10.2024,13,432,533,101,1313
714,16,5,24.06.2024,6,69,82,13,78
182,23,14,09.05.2024,16,66,75,9,144
412,7,8,28.06.2024,3,193,242,49,147
97,17,9,11.01.2024,20,51,76,25,500
61,22,12,18.02.2024,6,20,30,10,60
542,1,1,16.06.2024,13,176,187,11,143
927,19,19,10.07.2024,3,108,123,15,45
636,16,6,01.10.2024,7,196,214,18,126
700,30,5,03.11.2024,12,313,354,41,492
452,23,28,31.03.2024,17,96,136,40,680
456,1,20,20.01.2024,18,474,702,228,4104
964,4,26,08.06.2024,10,75,91,16,160
185,19,17,26.03.2024,4,274,312,38,152
159,20,30,21.06.2024,15,495,666,171,2565
852,13,26,17.08.2024,4,362,470,108,432
347,8,12,13.03.2024,8,438,557,119,952
814,13,2,02.07.2024,2,489,730,241,482
492,26,27,03.12.2024,19,70,100,30,570
94,22,21,13.06.2024,17,308,403,95,1615
545,17,13,06.10.2024,7,164,196,32,224
459,25,7,29.05.2024,14,226,282,56,784
85,16,1,08.09.2024,4,184,240,56,224
625,13,10,11.09.2024,10,414,562,148,1480
57,17,27,22.01.2024,7,65,77,12,84
602,24,29,19.10.2024,18,108,145,37,666
757,2,18,15.01.2024,2,175,214,39,78
361,18,2,16.12.2024,14,398,509,111,1554
870,6,17,08.07.2024,2,486,557,71,142
469,6,29,23.04.2024,11,57,78,21,231
508,7,19,23.11.2024,20,27,29,2,40
391,7,29,18.12.2024,4,493,582,89,356
927,8,22,18.06.2024,6,219,311,92,552
381,30,27,24.07.2024,2,99,110,11,22
253,20,22,12.05.2024,14,368,481,113,1582
885,29,21,07.06.2024,7,469,630,161,1127
936,9,14,19.12.2024,1,232,330,98,98
387,9,27,07.04.2024,16,149,197,48,768
642,23,13,22.01.2024,15,85,115,30,450
229,3,21,28.02.2024,4,101,147,46,184
501,3,6,01.10.2024,11,105,155,50,550
263,22,23,21.12.2024,13,165,213,48,624
292,28,19,13.05.2024,4,409,451,42,168
843,29,29,13.04.2024,3,304,435,131,393
206,5,17,19.01.2024,16,265,291,26,416
235,2,27,17.07.2024,6,62,86,24,144
826,3,8,11.08.2024,20,209,261,52,1040
147,15,20,22.01.2024,17,412,613,201,3417
787,7,24,11.06.2024,2,311,329,18,36
157,11,28,08.05.2024,6,199,250,51,306
924,21,2,19.07.2024,13,98,145,47,611
518,3,8,04.04.2024,7,191,257,66,462
450,1,28,13.08.2024,3,451,523,72,216
542,10,18,23.03.2024,5,300,445,145,725
59,4,22,03.02.2024,14,285,368,83,1162
634,24,6,13.06.2024,12,39,43,4,48
107,22,8,04.01.2024,13,21,27,6,78
834,13,25,17.10.2024,4,458,527,69,276
644,2,19,06.10.2024,3,30,40,10,30
933,16,30,19.10.2024,13,164,223,59,767
397,15,30,01.05.2024,16,333,387,54,864
652,15,16,19.03.2024,15,294,425,131,1965
230,5,10,22.11.2024,6,218,327,109,654
904,6,12,11.01.2024,14,432,512,80,1120
44,15,14,29.12.2024,18,456,525,69,1242
412,5,27,16.11.2024,12,126,186,60,720
432,29,14,23.08.2024,15,247,365,118,1770
475,12,11,15.06.2024,13,88,121,33,429
211,8,7,30.12.2024,7,311,354,43,301
895,24,22,12.11.2024,12,480,604,124,1488
884,25,26,28.07.2024,12,349,415,66,792
403,5,16,25.02.2024,18,353,443,90,1620
927,27,25,15.11.2024,14,46,52,6,84
346,18,29,21.03.2024,13,499,640,141,1833
185,15,1,21.12.2024,7,217,283,66,462
177,9,24,14.12.2024,19,413,463,50,950
412,19,26,11.04.2024,5,230,274,44,220
252,28,24,07.03.2024,16,181,240,59,944
782,20,17,17.11.2024,2,366,400,34,68
67,3,1,05.01.2024,2,189,271,82,164
321,30,29,01.07.2024,7,400,447,47,329
219,10,27,03.02.2024,12,339,495,156,1872
598,29,27,16.08.2024,16,193,264,71,1136
297,10,4,14.10.2024,6,481,696,215,1290
168,14,4,29.09.2024,20,229,257,28,560
566,21,16,24.12.2024,9,373,534,161,1449
256,4,22,16.03.2024,15,69,96,27,405
139,29,13,30.08.2024,13,264,297,33,429
21,19,23,04.07.2024,15,319,417,98,1470
459,29,1,08.09.2024,19,196,284,88,1672
88,29,12,05.02.2024,6,89,118,29,174
694,13,30,17.03.2024,4,498,700,202,808
685,7,21,13.06.2024,10,384,540,156,1560
806,3,12,04.11.2024,16,28,37,9,144
605,14,6,05.07.2024,9,118,151,33,297
533,29,30,13.01.2024,16,183,267,84,1344
54,21,8,24.12.2024,10,154,193,39,390
444,11,2,19.05.2024,15,357,388,31,465
565,2,5,15.11.2024,1,396,518,122,122
310,13,7,28.08.2024,13,218,232,14,182
689,9,23,11.07.2024,11,207,292,85,935
875,26,14,27.07.2024,11,87,128,41,451
737,9,18,08.04.2024,16,164,192,28,448
936,15,30,09.12.2024,3,432,583,151,453
327,28,17,28.02.2024,1,435,482,47,47
781,4,8,08.02.2024,6,211,228,17,102
586,26,8,14.02.2024,3,24,33,9,27
755,26,11,12.11.2024,3,99,130,31,93
989,28,15,19.11.2024,11,422,569,147,1617
628,4,2,26.12.2024,5,122,178,56,280
949,3,6,16.02.2024,3,21,26,5,15
703,8,7,26.01.2024,3,218,260,42,126
543,7,16,11.04.2024,16,329,450,121,1936
481,10,24,12.12.2024,19,462,664,202,3838
454,6,17,04.01.2024,3,110,164,54,162
270,5,29,04.10.2024,19,116,158,42,798
720,25,3,06.04.2024,6,454,542,88,528
234,6,13,21.11.2024,19,171,226,55,1045
519,21,10,21.04.2024,14,148,210,62,868
754,8,17,04.01.2024,9,164,228,64,576
67,2,3,09.09.2024,12,482,665,183,2196
635,25,27,08.08.2024,3,365,509,144,432
734,15,1,11.12.2024,3,183,241,58,174
939,30,12,23.12.2024,20,367,544,177,3540
583,9,24,12.06.2024,15,203,281,78,1170
492,12,16,02.06.2024,16,180,233,53,848
763,7,8,27.10.2024,6,41,56,15,90
420,15,29,24.08.2024,11,492,693,201,2211
968,13,15,25.08.2024,15,98,109,11,165
769,13,14,13.01.2024,5,423,504,81,405
892,21,5,23.07.2024,12,27,34,7,84
838,22,29,29.03.2024,5,323,477,154,770
223,4,1,19.07.2024,16,96,113,17,272
203,1,16,19.07.2024,6,175,249,74,444
875,18,9,26.04.2024,7,269,356,87,609
512,14,14,22.03.2024,16,360,388,28,448
985,4,3,14.06.2024,16,331,391,60,960
241,17,16,20.04.2024,14,271,286,15,210
316,21,6,22.06.2024,10,370,491,121,1210
627,4,20,07.03.2024,17,164,197,33,561
383,26,23,06.03.2024,12,309,459,150,1800
65,1,15,08.07.2024,14,146,167,21,294
335,23,8,09.06.2024,16,422,496,74,1184
349,19,26,18.06.2024,7,481,533,52,364
330,26,21,20.10.2024,8,382,503,121,968
243,27,27,07.05.2024,16,308,389,81,1296
20,11,17,18.02.2024,13,404,451,47,611
330,3,17,08.09.2024,15,328,477,149,2235
970,24,9,04.02.2024,15,219,307,88,1320
811,25,9,30.12.2024,5,206,295,89,445
61,16,8,24.04.2024,1,187,226,39,39
636,16,18,15.03.2024,9,183,232,49,441
322,20,29,01.10.2024,7,441,624,183,1281
193,30,20,05.11.2024,4,171,236,65,260
754,29,7,25.09.2024,17,164,191,27,459
386,14,23,06.01.2024,10,153,175,22,220
304,1,1,29.11.2024,14,60,73,13,182
795,30,5,16.08.2024,13,304,341,37,481
455,25,11,25.02.2024,9,253,297,44,396
724,20,15,25.05.2024,6,320,355,35,210
980,1,4,27.01.2024,11,302,382,80,880
146,11,27,11.07.2024,18,33,44,11,198
662,11,13,01.04.2024,11,333,475,142,1562
36,21,10,14.06.2024,19,407,531,124,2356
905,17,2,31.12.2024,5,274,296,22,110
70,5,5,22.02.2024,17,103,152,49,833
241,3,25,03.07.2024,12,193,210,17,204
352,25,3,09.09.2024,13,299,322,23,299
427,21,26,21.07.2024,5,300,426,126,630
834,7,15,22.03.2024,4,410,599,189,756
268,8,8,29.01.2024,18,32,34,2,36
864,23,8,02.09.2024,2,41,47,6,12
239,5,28,11.03.2024,17,183,219,36,612
775,21,22,21.07.2024,1,281,392,111,111
505,1,22,31.12.2024,14,301,325,24,336
205,19,2,16.04.2024,8,318,404,86,688
358,23,3,24.10.2024,12,280,407,127,1524
169,13,7,18.03.2024,18,23,34,11,198
763,20,10,16.05.2024,18,211,270,59,1062
164,27,7,07.11.2024,9,191,217,26,234
920,9,13,02.03.2024,10,251,267,16,160
618,21,22,19.09.2024,13,124,141,17,221
43,13,26,24.02.2024,7,122,170,48,336
754,24,10,19.12.2024,7,473,623,150,1050
311,12,15,28.01.2024,8,310,450,140,1120
864,9,7,18.09.2024,1,178,188,10,10
850,6,28,19.06.2024,7,275,406,131,917
398,24,11,22.08.2024,13,328,456,128,1664
943,16,16,14.10.2024,20,166,234,68,1360
684,28,8,09.02.2024,20,74,107,33,660
874,1,20,26.01.2024,1,160,235,75,75
311,15,13,17.10.2024,6,69,74,5,30
221,21,7,04.08.2024,12,58,68,10,120
670,1,10,18.01.2024,4,174,194,20,80
468,30,30,14.04.2024,4,490,655,165,660
976,22,26,16.01.2024,16,109,115,6,96
89,24,8,21.08.2024,19,375,488,113,2147
277,1,23,15.10.2024,16,52,72,20,320
157,7,3,22.07.2024,13,35,37,2,26
443,27,15,30.07.2024,6,26,34,8,48
46,22,3,23.05.2024,10,388,491,103,1030
822,9,1,09.12.2024,9,466,529,63,567
707,15,26,01.01.2024,2,467,609,142,284
878,14,18,25.12.2024,16,425,491,66,1056
869,24,2,26.05.2024,12,65,86,21,252
468,27,16,05.10.2024,6,211,284,73,438
381,24,18,03.10.2024,5,184,254,70,350
356,14,6,24.10.2024,13,210,265,55,715
356,25,10,16.03.2024,16,365,472,107,1712
369,14,3,04.11.2024,9,473,526,53,477
947,12,21,26.08.2024,15,405,524,119,1785
697,6,29,22.01.2024,11,279,408,129,1419
641,5,20,23.06.2024,18,343,489,146,2628
164,28,26,20.10.2024,5,437,615,178,890
845,23,13,11.02.2024,14,470,517,47,658
514,18,2,23.09.2024,4,314,330,16,64
957,18,22,25.03.2024,8,370,507,137,1096
343,16,4,15.06.2024,12,300,441,141,1692
536,22,27,20.07.2024,8,315,381,66,528
418,23,25,24.02.2024,8,347,465,118,944
160,27,23,06.04.2024,1,477,671,194,194
517,26,4,10.09.2024,5,488,528,40,200
973,10,8,26.07.2024,10,442,506,64,640
654,4,27,07.04.2024,1,28,30,2,2
124,7,6,14.12.2024,3,54,63,9,27
974,4,14,02.07.2024,13,25,34,9,117
308,11,13,10.07.2024,7,175,217,42,294
604,30,16,21.11.2024,20,323,345,22,440
504,2,16,12.06.2024,12,35,41,6,72
485,28,26,15.07.2024,18,414,453,39,702
706,19,20,28.06.2024,16,33,40,7,112
986,16,25,14.02.2024,16,149,193,44,704
85,8,24,19.11.2024,4,252,308,56,224
346,8,20,28.08.2024,2,185,220,35,70
796,23,28,19.08.2024,7,334,412,78,546
11,22,5,30.10.2024,1,498,636,138,138
71,17,6,25.08.2024,9,376,490,114,1026
821,30,18,30.11.2024,2,149,196,47,94
715,17,16,30.03.2024,15,170,244,74,1110
41,10,20,18.06.2024,14,76,103,27,378
992,27,3,11.04.2024,16,268,311,43,688
397,25,24,30.11.2024,6,415,506,91,546
310,6,8,23.06.2024,19,452,575,123,2337
731,15,26,24.12.2024,4,71,80,9,36
136,24,20,15.10.2024,1,244,311,67,67
814,23,14,11.01.2024,17,479,653,174,2958
651,18,4,02.08.2024,16,37,43,6,96
571,23,14,04.02.2024,3,64,75,11,33
972,22,12,31.08.2024,13,279,408,129,1677
929,30,29,11.03.2024,4,32,36,4,16
585,6,22,10.04.2024,15,357,535,178,2670
383,18,9,01.09.2024,3,424,570,146,438
597,14,4,13.10.2024,2,138,157,19,38
308,5,24,25.12.2024,13,25,30,5,65
523,26,1,27.02.2024,17,360,421,61,1037
544,1,10,11.03.2024,11,491,569,78,858
492,26,7,06.04.2024,16,264,334,70,1120
102,6,13,10.10.2024,18,459,648,189,3402
150,22,5,18.09.2024,5,460,640,180,900
490,17,3,16.10.2024,6,146,194,48,288
424,27,21,04.07.2024,8,443,517,74,592
62,25,14,22.01.2024,11,419,514,95,1045
198,22,24,10.07.2024,13,250,331,81,1053
888,8,24,06.03.2024,16,334,493,159,2544
522,29,14,26.11.2024,6,143,189,46,276
295,16,25,08.02.2024,14,327,348,21,294
68,18,3,26.12.2024,5,415,556,141,705
379,9,13,23.05.2024,15,352,497,145,2175
940,11,10,01.10.2024,20,187,274,87,1740
876,16,17,06.09.2024,13,407,587,180,2340
705,19,23,13.10.2024,20,326,439,113,2260
588,5,16,21.06.2024,3,374,475,101,303
351,18,17,11.11.2024,3,148,197,49,147
957,9,28,27.05.2024,20,282,325,43,860
950,29,11,02.05.2024,19,117,141,24,456
314,7,27,20.06.2024,17,366,452,86,1462
271,20,14,08.12.2024,7,413,548,135,945
806,5,26,18.12.2024,10,117,159,42,420
371,23,18,10.10.2024,11,124,175,51,561
596,17,6,01.03.2024,10,346,402,56,560
613,26,21,21.06.2024,6,474,636,162,972
509,12,8,19.07.2024,16,387,453,66,1056
582,15,18,23.06.2024,5,150,198,48,240
259,4,13,08.10.2024,13,21,23,2,26
832,30,9,10.09.2024,15,498,745,247,3705
598,27,9,18.09.2024,19,235,268,33,627
53,14,21,07.09.2024,20,75,95,20,400
397,11,4,12.03.2024,6,82,99,17,102
821,2,2,05.02.2024,9,75,97,22,198
275,5,26,19.02.2024,14,124,132,8,112
677,19,2,06.01.2024,4,192,286,94,376
737,9,10,08.08.2024,8,138,159,21,168
619,19,25,16.05.2024,18,201,287,86,1548
156,1,18,26.10.2024,11,410,471,61,671
826,27,13,14.04.2024,18,335,354,19,342
165,3,19,10.11.2024,9,434,551,117,1053
98,8,28,27.07.2024,8,143,180,37,296
170,29,6,22.04.2024,9,74,78,4,36
688,10,14,23.10.2024,20,454,556,102,2040
219,8,4,11.02.2024,14,384,480,96,1344
154,24,29,15.07.2024,20,404,493,89,1780
555,25,9,15.04.2024,16,243,341,98,1568
537,11,11,11.01.2024,16,279,370,91,1456
859,15,20,15.04.2024,12,93,127,34,408
616,27,23,15.12.2024,13,106,149,43,559
213,7,11,29.06.2024,13,160,186,26,338
298,29,8,13.07.2024,20,469,592,123,2460
25,22,30,15.10.2024,8,350,477,127,1016
464,23,26,12.01.2024,13,312,376,64,832
391,1,16,11.08.2024,15,485,602,117,1755
448,9,12,27.04.2024,9,207,302,95,855
267,16,6,27.03.2024,8,457,600,143,1144
530,20,17,10.04.2024,2,215,261,46,92
779,8,3,28.12.2024,6,67,89,22,132
567,2,9,10.02.2024,17,497,579,82,1394
153,10,5,11.08.2024,9,465,680,215,1935
235,14,10,26.03.2024,17,54,62,8,136
95,20,2,20.10.2024,6,167,217,50,300
965,14,29,26.03.2024,8,28,40,12,96
201,20,23,09.02.2024,3,415,455,40,120
837,26,6,30.09.2024,4,418,526,108,432
780,12,24,01.04.2024,5,293,431,138,690
252,26,1,15.06.2024,6,412,483,71,426
833,1,17,15.09.2024,2,221,245,24,48
50,16,5,08.03.2024,8,461,610,149,1192
377,19,26,22.05.2024,15,145,182,37,555
728,4,23,07.05.2024,6,347,459,112,672
44,3,13,10.03.2024,1,167,210,43,43
819,16,22,21.07.2024,18,297,409,112,2016
911,17,15,27.11.2024,17,201,282,81,1377
592,23,27,26.07.2024,9,288,424,136,1224
171,17,28,12.09.2024,5,432,461,29,145
76,20,12,01.06.2024,4,329,479,150,600
392,13,10,10.07.2024,1,181,230,49,49
769,1,7,10.08.2024,5,250,360,110,550
810,25,24,12.03.2024,10,222,258,36,360
17,29,8,12.08.2024,9,269,331,62,558
730,15,12,14.04.2024,15,86,106,20,300
53,8,5,23.11.2024,4,171,208,37,148
359,15,30,16.07.2024,14,59,78,19,266
364,27,17,09.10.2024,16,40,59,19,304
890,28,16,04.02.2024,12,189,215,26,312
945,17,6,06.01.2024,4,94,130,36,144
576,9,2,13.01.2024,17,131,175,44,748
381,1,15,25.07.2024,11,428,567,139,1529
356,20,11,25.05.2024,12,46,65,19,228
600,4,29,12.08.2024,16,241,336,95,1520
38,22,25,07.10.2024,19,279,301,22,418
992,5,30,12.07.2024,11,358,491,133,1463
750,24,21,16.05.2024,5,92,128,36,180
202,3,20,15.07.2024,9,221,254,33,297
46,10,1,09.03.2024,7,234,306,72,504
428,26,27,18.03.2024,14,300,392,92,1288
939,7,1,03.02.2024,6,459,490,31,186
745,16,26,03.02.2024,8,259,379,120,960
170,30,22,09.09.2024,4,60,81,21,84
832,29,11,11.11.2024,12,455,574,119,1428
980,9,19,12.10.2024,18,475,691,216,3888
760,11,21,06.12.2024,11,289,324,35,385
699,27,23,28.10.2024,17,369,434,65,1105
609,25,29,05.05.2024,8,437,463,26,208
495,9,11,17.09.2024,10,275,409,134,1340
415,2,19,02.06.2024,9,74,105,31,279
569,8,28,22.04.2024,8,257,375,118,944
949,4,23,04.10.2024,17,205,253,48,816
410,14,19,18.06.2024,10,61,71,10,100
639,16,30,05.12.2024,3,416,496,80,240
911,2,14,26.07.2024,14,98,121,23,322
32,11,12,01.03.2024,10,140,178,38,380
504,30,13,28.10.2024,7,227,282,55,385
241,10,8,08.11.2024,6,192,215,23,138
335,19,13,12.02.2024,4,62,67,5,20
756,1,5,03.10.2024,14,272,395,123,1722
957,26,26,23.12.2024,5,46,48,2,10
182,2,5,29.05.2024,12,367,499,132,1584
847,23,12,07.12.2024,19,64,68,4,76
915,10,11,21.02.2024,2,318,346,28,56
41,20,1,08.04.2024,6,479,587,108,648
503,4,9,30.10.2024,10,335,478,143,1430
74,27,20,25.05.2024,5,53,67,14,70
873,9,6,25.11.2024,17,69,88,19,323
230,23,10,17.01.2024,13,456,548,92,1196
167,23,16,19.08.2024,12,280,333,53,636
670,23,27,24.07.2024,14,433,636,203,2842
814,28,10,07.12.2024,11,127,147,20,220
153,23,5,19.01.2024,3,50,66,16,48
121,5,4,17.08.2024,5,96,132,36,180
290,25,11,18.12.2024,11,316,366,50,550
494,14,14,03.03.2024,18,393,517,124,2232
960,23,7,30.08.2024,2,206,231,25,50
197,12,3,26.01.2024,2,450,645,195,390
259,13,6,11.09.2024,15,357,530,173,2595
803,23,28,14.06.2024,15,88,125,37,555
764,23,14,03.12.2024,11,488,677,189,2079
889,23,6,04.01.2024,6,148,183,35,210
499,29,11,16.03.2024,2,472,525,53,106
526,20,16,22.05.2024,7,389,440,51,357
40,25,1,19.11.2024,12,384,462,78,936
630,12,11,02.01.2024,4,267,373,106,424
993,17,7,18.04.2024,5,190,258,68,340
879,24,24,15.09.2024,9,291,357,66,594
542,19,20,09.11.2024,7,242,338,96,672
749,26,2,20.08.2024,19,300,354,54,1026
774,15,2,25.05.2024,11,29,36,7,77
643,26,3,30.08.2024,14,495,623,128,1792
906,20,19,28.04.2024,11,447,588,141,1551
461,9,10,29.11.2024,2,438,505,67,134
927,19,9,21.07.2024,9,22,28,6,54
42,8,27,18.08.2024,8,223,234,11,88
49,3,26,20.05.2024,18,436,634,198,3564
963,14,1,13.09.2024,10,413,545,132,1320
53,16,19,19.04.2024,18,358,465,107,1926
799,4,28,30.04.2024,13,307,423,116,1508
182,18,21,12.04.2024,1,370,460,90,90
337,21,8,02.09.2024,1,70,78,8,8
768,24,9,27.03.2024,10,363,423,60,600
166,29,14,14.04.2024,6,205,224,19,114
955,10,10,04.10.2024,18,347,375,28,504
160,28,4,02.01.2024,8,53,74,21,168
814,25,9,01.04.2024,4,411,515,104,416
125,17,25,30.09.2024,15,281,310,29,435
685,20,9,12.02.2024,12,423,462,39,468
181,13,26,06.04.2024,18,148,204,56,1008
933,30,20,14.02.2024,3,103,115,12,36
165,17,27,19.12.2024,18,119,151,32,576
947,25,21,28.06.2024,1,194,278,84,84
812,25,14,23.02.2024,17,417,590,173,2941
218,6,7,13.11.2024,16,416,547,131,2096
715,3,24,26.04.2024,16,305,426,121,1936
397,11,21,07.07.2024,7,480,513,33,231
464,7,1,19.10.2024,12,28,42,14,168
957,12,21,22.06.2024,14,403,575,172,2408
993,11,28,25.08.2024,3,88,126,38,114
609,17,18,29.02.2024,19,89,112,23,437
567,18,24,23.06.2024,4,339,480,141,564
806,27,21,11.06.2024,8,179,231,52,416
436,10,2,24.02.2024,2,500,593,93,186
988,5,23,12.05.2024,13,98,115,17,221
871,14,3,28.09.2024,12,58,74,16,192
757,10,14,12.01.2024,1,165,198,33,33
729,3,28,11.03.2024,17,328,433,105,1785
103,12,4,18.02.2024,9,413,496,83,747
910,4,6,22.10.2024,7,318,448,130,910
238,2,9,08.06.2024,18,406,525,119,2142
880,3,26,30.12.2024,18,498,652,154,2772
708,18,10,09.10.2024,10,71,103,32,320
771,30,2,08.06.2024,14,67,90,23,322
276,24,2,11.03.2024,3,68,100,32,96
603,1,4,01.09.2024,2,260,368,108,216
416,18,4,15.05.2024,6,322,474,152,912
917,26,8,11.02.2024,11,106,120,14,154
941,19,23,23.02.2024,1,260,299,39,39
726,5,6,15.12.2024,17,142,212,70,1190
6,22,17,19.05.2024,19,426,587,161,3059
863,7,16,07.10.2024,8,50,62,12,96
628,22,13,08.04.2024,17,169,204,35,595
415,19,14,23.10.2024,10,157,182,25,250
877,29,4,27.12.2024,14,150,201,51,714
510,1,4,26.07.2024,19,117,162,45,855
708,5,19,04.04.2024,19,81,120,39,741
255,5,23,21.01.2024,8,147,204,57,456
749,3,22,21.07.2024,5,131,154,23,115
116,19,1,29.11.2024,7,387,426,39,273
713,1,14,24.02.2024,11,125,156,31,341
151,24,21,04.03.2024,12,186,277,91,1092
388,22,17,14.12.2024,9,247,333,86,774
879,21,5,15.04.2024,13,200,227,27,351
682,28,22,04.05.2024,16,270,399,129,2064
448,2,9,02.01.2024,14,257,288,31,434
801,29,27,31.01.2024,15,288,340,52,780
424,4,29,27.05.2024,5,165,194,29,145
437,25,1,30.08.2024,17,53,70,17,289
357,10,21,24.04.2024,15,122,166,44,660
283,27,16,18.07.2024,9,102,129,27,243
449,29,5,09.01.2024,8,350,444,94,752
225,18,17,24.11.2024,5,76,89,13,65
380,17,9,19.12.2024,4,159,229,70,280
529,26,10,25.07.2024,1,52,68,16,16
907,4,8,24.05.2024,9,434,503,69,621
981,22,30,11.10.2024,20,314,443,129,2580
543,30,6,17.11.2024,16,290,305,15,240
982,1,11,19.12.2024,18,234,306,72,1296
2,16,7,05.04.2024,4,395,469,74,296
783,14,9,22.12.2024,9,320,365,45,405
412,22,27,04.11.2024,19,308,373,65,1235
390,16,20,10.04.2024,8,186,199,13,104
345,12,16,03.05.2024,18,190,242,52,936
442,18,1,19.12.2024,3,72,94,22,66
141,8,14,23.01.2024,7,259,320,61,427
757,3,4,14.12.2024,18,245,336,91,1638
227,24,7,21.04.2024,12,69,74,5,60
12,30,19,28.07.2024,4,163,218,55,220
912,15,29,17.04.2024,3,194,284,90,270
627,4,3,08.05.2024,20,294,407,113,2260
961,25,8,23.01.2024,16,372,437,65,1040
172,22,25,22.12.2024,1,494,706,212,212
837,7,26,29.07.2024,11,71,77,6,66
597,8,30,21.10.2024,9,20,25,5,45
358,30,12,19.08.2024,18,376,423,47,846
757,4,21,19.10.2024,1,361,424,63,63
177,27,6,29.04.2024,2,395,447,52,104
848,7,7,08.03.2024,10,255,275,20,200
461,8,20,09.03.2024,2,80,110,30,60
742,7,12,17.11.2024,10,447,607,160,1600
158,23,3,22.03.2024,16,213,224,11,176
384,2,18,30.03.2024,14,75,82,7,98
162,7,3,19.03.2024,14,75,93,18,252
717,27,6,16.05.2024,17,385,500,115,1955
694,17,29,29.10.2024,19,188,272,84,1596
162,27,20,29.09.2024,19,130,192,62,1178
436,6,20,15.08.2024,9,181,211,30,270
220,30,24,11.01.2024,7,227,269,42,294
792,18,15,16.02.2024,19,79,111,32,608
130,29,2,27.04.2024,18,458,504,46,828
491,13,30,28.11.2024,19,384,531,147,2793
139,2,17,02.04.2024,18,468,540,72,1296
130,8,30,26.01.2024,17,459,607,148,2516
906,3,8,02.10.2024,18,62,75,13,234
551,3,9,13.05.2024,11,301,334,33,363
183,2,14,08.09.2024,7,91,128,37,259
226,23,21,15.02.2024,17,95,126,31,527
74,14,24,20.11.2024,18,61,84,23,414
330,15,6,14.12.2024,9,453,544,91,819
34,25,1,14.01.2024,1,461,652,191,191
32,3,11,25.03.2024,19,61,66,5,95
195,16,26,20.02.2024,15,421,611,190,2850
664,12,2,18.11.2024,20,33,45,12,240
362,11,13,10.12.2024,4,426,623,197,788
662,10,25,29.05.2024,9,101,110,9,81
833,5,20,08.12.2024,19,296,374,78,1482
503,17,30,09.02.2024,5,109,155,46,230
296,17,20,22.01.2024,11,214,270,56,616
520,14,15,14.01.2024,2,326,349,23,46
678,9,29,05.05.2024,13,196,262,66,858
91,12,24,21.09.2024,9,291,325,34,306
387,19,4,30.04.2024,14,96,135,39,546
524,8,11,08.07.2024,2,207,246,39,78
175,26,19,11.07.2024,2,302,414,112,224
641,16,2,27.07.2024,7,143,177,34,238
877,20,18,23.08.2024,20,201,282,81,1620
18,25,20,21.11.2024,17,114,126,12,204
63,9,26,25.01.2024,4,463,568,105,420
855,17,4,11.10.2024,17,398,419,21,357
641,24,9,25.11.2024,6,300,443,143,858
511,29,30,07.05.2024,17,119,145,26,442
783,7,17,27.11.2024,3,224,262,38,114
159,22,3,13.03.2024,13,336,455,119,1547
744,6,17,19.10.2024,10,228,270,42,420
22,8,29,02.08.2024,5,208,286,78,390
866,17,14,19.04.2024,4,178,264,86,344
258,3,15,21.01.2024,13,169,249,80,1040
647,13,6,30.06.2024,12,407,481,74,888
895,2,6,25.07.2024,8,389,527,138,1104
349,18,22,05.04.2024,10,118,175,57,570
934,24,1,08.12.2024,3,260,317,57,171
422,26,9,28.05.2024,17,314,465,151,2567
544,17,30,12.01.2024,8,394,433,39,312
248,18,23,13.09.2024,17,111,158,47,799
283,11,24,09.03.2024,15,332,473,141,2115
64,22,23,23.06.2024,2,168,228,60,120
59,28,10,02.05.2024,7,489,561,72,504
994,25,27,30.06.2024,7,444,571,127,889
602,11,29,28.12.2024,4,222,306,84,336
827,5,26,22.02.2024,3,68,93,25,75
466,17,15,04.03.2024,18,44,58,14,252
204,8,19,16.02.2024,7,272,312,40,280
415,21,11,25.04.2024,2,471,581,110,220
36,24,3,12.02.2024,20,409,522,113,2260
777,11,13,18.02.2024,15,276,396,120,1800
798,18,24,25.09.2024,1,25,37,12,12
214,27,1,16.01.2024,19,74,89,15,285
425,4,18,06.03.2024,20,288,422,134,2680
251,23,13,19.06.2024,16,346,473,127,2032
271,24,10,01.11.2024,4,391,570,179,716
939,1,29,13.11.2024,7,220,267,47,329
812,12,5,30.01.2024,3,179,237,58,174
828,4,28,26.09.2024,19,166,182,16,304
300,8,8,22.07.2024,17,264,318,54,918
28,19,5,27.07.2024,7,107,152,45,315
162,7,20,04.11.2024,17,95,103,8,136
463,9,11,21.06.2024,14,59,64,5,70
957,2,23,30.05.2024,5,286,369,83,415
964,24,2,06.07.2024,1,418,588,170,170
244,16,30,21.07.2024,14,242,359,117,1638
762,2,17,21.12.2024,4,79,109,30,120
437,25,28,10.01.2024,2,118,170,52,104
57,17,29,14.04.2024,12,219,269,50,600
623,3,27,14.01.2024,13,98,133,35,455
75,11,24,18.04.2024,4,109,152,43,172
261,29,11,01.07.2024,2,438,545,107,214
564,6,14,19.10.2024,4,268,357,89,356
497,14,25,14.10.2024,5,338,387,49,245
538,27,9,28.05.2024,2,79,92,13,26
918,18,1,27.09.2024,15,419,477,58,870
306,8,16,07.12.2024,18,397,577,180,3240
140,14,2,18.04.2024,8,350,426,76,608
742,4,2,22.02.2024,12,251,342,91,1092
19,20,27,25.01.2024,17,208,311,103,1751
595,23,3,28.05.2024,10,313,354,41,410
17,23,15,10.05.2024,19,433,487,54,1026
775,20,23,20.10.2024,20,340,421,81,1620
640,19,26,11.07.2024,10,445,578,133,1330
620,25,20,12.12.2024,15,65,94,29,435
303,5,18,06.07.2024,19,216,289,73,1387
583,8,5,18.06.2024,19,72,85,13,247
791,17,29,07.06.2024,19,336,473,137,2603
878,7,6,07.04.2024,4,114,163,49,196
827,27,8,30.05.2024,5,417,620,203,1015
414,19,18,29.01.2024,14,338,461,123,1722
572,16,5,22.07.2024,4,254,354,100,400
996,29,1,24.11.2024,15,109,151,42,630
317,18,24,26.04.2024,17,330,379,49,833
687,22,20,04.07.2024,8,480,709,229,1832
142,22,29,14.10.2024,1,448,635,187,187
292,27,1,25.06.2024,14,474,639,165,2310
146,29,23,16.10.2024,20,242,291,49,980
563,26,28,16.03.2024,13,322,449,127,1651
558,22,5,10.08.2024,9,67,94,27,243
392,19,13,25.06.2024,14,342,370,28,392
850,7,1,14.10.2024,16,434,539,105,1680
689,27,22,15.03.2024,7,433,558,125,875
586,11,30,02.03.2024,9,451,513,62,558
274,13,18,17.03.2024,8,320,451,131,1048
319,28,17,19.05.2024,2,457,486,29,58
983,6,16,24.04.2024,1,23,31,8,8
527,14,20,19.07.2024,13,52,78,26,338
120,27,25,17.07.2024,17,123,133,10,170
685,7,27,09.11.2024,11,441,655,214,2354
875,1,2,03.02.2024,13,290,312,22,286
664,9,3,30.05.2024,20,57,82,25,500
330,2,15,27.07.2024,6,461,615,154,924
201,28,19,14.08.2024,14,341,380,39,546
748,12,8,22.11.2024,9,158,167,9,81
508,15,15,02.11.2024,10,220,247,27,270
732,15,29,12.03.2024,13,410,590,180,2340
688,5,20,11.03.2024,12,29,38,9,108
95,24,28,08.09.2024,16,492,602,110,1760
49,6,19,24.12.2024,20,54,75,21,420
270,1,13,25.09.2024,18,154,166,12,216
200,7,7,20.08.2024,8,65,96,31,248
978,30,11,02.07.2024,6,123,148,25,150
985,13,4,27.08.2024,18,494,536,42,756
11,7,28,25.03.2024,4,60,79,19,76
1,13,4,22.04.2024,14,141,200,59,826
686,11,5,27.08.2024,16,299,391,92,1472
354,13,4,07.04.2024,7,249,270,21,147
684,18,10,06.06.2024,9,323,346,23,207
985,6,28,23.10.2024,11,44,49,5,55
406,10,17,23.01.2024,4,240,282,42,168
55,8,15,14.04.2024,9,445,488,43,387
482,18,4,13.03.2024,15,399,561,162,2430
684,17,6,05.04.2024,3,27,38,11,33
655,3,29,08.09.2024,19,294,418,124,2356
105,21,7,13.05.2024,17,496,738,242,4114
176,19,18,23.06.2024,16,421,581,160,2560
622,15,8,06.08.2024,8,467,663,196,1568
249,29,4,20.09.2024,6,298,404,106,636
327,14,1,22.06.2024,8,313,434,121,968
983,24,1,09.09.2024,19,298,409,111,2109
439,13,22,01.03.2024,15,264,360,96,1440
413,28,16,30.04.2024,13,285,399,114,1482
151,28,26,08.01.2024,12,411,432,21,252
554,5,3,03.12.2024,6,112,129,17,102
358,11,22,22.03.2024,3,221,300,79,237
676,12,1,20.06.2024,18,249,366,117,2106
704,9,13,18.10.2024,5,395,428,33,165
667,25,30,30.03.2024,3,312,347,35,105
582,13,15,31.10.2024,2,305,401,96,192
792,22,9,30.04.2024,14,339,449,110,1540
296,26,18,09.01.2024,6,84,122,38,228
39,28,11,18.01.2024,20,374,515,141,2820
679,27,18,09.08.2024,20,386,525,139,2780
520,10,21,07.03.2024,10,471,623,152,1520
867,24,20,19.09.2024,18,342,369,27,486
87,10,12,19.08.2024,18,279,350,71,1278
830,25,30,19.01.2024,15,66,80,14,210
184,8,29,05.10.2024,13,249,305,56,728
201,18,25,02.12.2024,6,33,49,16,96
463,9,13,09.02.2024,20,52,71,19,380
680,15,16,08.11.2024,18,272,333,61,1098
154,28,20,21.10.2024,14,278,354,76,1064
866,5,27,07.03.2024,11,284,372,88,968
506,24,2,25.11.2024,18,182,247,65,1170
1,13,21,05.04.2024,8,208,223,15,120
276,29,1,05.12.2024,12,406,608,202,2424
391,24,20,18.06.2024,15,311,332,21,315
690,4,6,23.05.2024,18,110,154,44,792
351,28,12,17.05.2024,9,113,166,53,477
403,15,19,20.07.2024,7,91,110,19,133
835,20,10,05.04.2024,8,344,509,165,1320
700,18,24,21.10.2024,9,424,520,96,864
888,8,28,09.04.2024,18,481,705,224,4032
957,4,11,26.07.2024,6,153,166,13,78
697,30,11,05.04.2024,18,409,492,83,1494
955,16,6,24.06.2024,13,105,156,51,663
176,13,19,23.04.2024,8,195,251,56,448
801,22,12,22.02.2024,8,460,688,228,1824
517,4,18,29.12.2024,13,209,254,45,585
975,21,16,22.09.2024,9,217,321,104,936
573,11,1,08.11.2024,11,407,517,110,1210
697,10,27,13.05.2024,8,23,26,3,24
644,20,4,11.12.2024,17,442,579,137,2329
949,27,4,03.09.2024,20,267,300,33,660
204,17,27,26.12.2024,11,317,367,50,550
813,2,3,05.07.2024,7,221,263,42,294
334,10,15,25.02.2024,11,443,530,87,957
110,7,24,29.03.2024,12,337,488,151,1812
838,14,16,25.09.2024,4,141,199,58,232
459,28,11,24.01.2024,1,337,394,57,57
867,5,23,25.11.2024,4,165,244,79,316
812,3,2,30.06.2024,6,253,309,56,336
542,4,23,29.10.2024,17,262,341,79,1343
620,24,27,08.03.2024,16,23,27,4,64
133,8,28,20.09.2024,17,305,438,133,2261
357,13,6,11.03.2024,11,305,431,126,1386
829,25,14,01.08.2024,2,186,268,82,164
598,17,14,18.08.2024,18,246,289,43,774
884,6,5,09.09.2024,11,281,338,57,627
759,29,22,23.05.2024,18,343,413,70,1260
603,14,12,11.06.2024,20,167,189,22,440
132,10,20,01.03.2024,3,435,592,157,471
341,1,5,04.01.2024,2,41,46,5,10
315,12,21,27.04.2024,19,351,507,156,2964
75,8,5,25.11.2024,4,429,513,84,336
325,3,7,03.01.2024,11,194,246,52,572
535,7,21,20.11.2024,14,304,420,116,1624
699,4,10,04.06.2024,10,455,584,129,1290
632,13,13,27.10.2024,20,386,491,105,2100
512,28,23,23.04.2024,14,249,362,113,1582
808,15,24,29.05.2024,14,96,133,37,518
133,12,28,20.09.2024,6,490,596,106,636
215,3,17,21.04.2024,6,382,495,113,678
836,4,24,09.03.2024,7,448,483,35,245
205,20,5,26.11.2024,1,340,404,64,64
95,2,13,05.01.2024,3,286,332,46,138
269,16,6,14.04.2024,18,257,310,53,954
546,6,25,29.08.2024,13,285,390,105,1365
682,15,6,02.04.2024,12,265,334,69,828
267,24,12,14.10.2024,9,267,297,30,270
159,28,19,17.01.2024,11,92,122,30,330
524,27,25,08.12.2024,15,215,313,98,1470
568,8,24,22.02.2024,13,47,61,14,182
187,23,15,02.03.2024,16,109,118,9,144
704,7,7,14.08.2024,7,494,644,150,1050
597,6,27,15.01.2024,11,113,127,14,154
591,19,30,10.11.2024,7,399,493,94,658
176,4,24,06.08.2024,11,356,511,155,1705
78,21,10,30.04.2024,18,301,336,35,630
919,6,11,30.11.2024,12,379,562,183,2196
809,19,28,03.10.2024,7,183,238,55,385
316,9,14,03.03.2024,16,391,524,133,2128
755,24,29,09.09.2024,8,102,144,42,336
297,8,1,19.10.2024,11,153,220,67,737
592,26,25,12.09.2024,20,386,531,145,2900
185,29,15,05.11.2024,19,244,256,12,228
585,6,15,05.02.2024,6,48,58,10,60
683,29,20,27.08.2024,17,486,619,133,2261
116,7,16,28.12.2024,11,90,118,28,308
572,30,17,04.05.2024,5,96,102,6,30
692,25,4,09.03.2024,12,223,307,84,1008
744,28,2,07.10.2024,7,108,115,7,49
46,9,25,10.10.2024,16,330,467,137,2192
703,29,15,22.09.2024,17,279,401,122,2074
449,12,22,17.04.2024,12,361,463,102,1224
190,8,21,30.09.2024,13,493,531,38,494
858,30,25,21.01.2024,7,28,33,5,35
310,8,30,17.07.2024,3,437,571,134,402
814,19,11,26.02.2024,15,54,65,11,165
893,6,7,19.10.2024,3,31,43,12,36
659,19,6,27.10.2024,12,359,381,22,264
311,7,16,21.05.2024,17,118,127,9,153
844,7,30,03.01.2024,19,232,347,115,2185
85,7,22,30.10.2024,16,67,89,22,352
118,5,13,25.01.2024,5,394,441,47,235
213,6,4,17.12.2024,15,229,289,60,900
677,5,2,28.02.2024,20,414,574,160,3200
92,4,4,14.07.2024,13,73,81,8,104
186,2,4,12.11.2024,2,248,276,28,56
352,22,24,27.09.2024,15,497,577,80,1200
948,20,24,19.04.2024,2,170,222,52,104
442,13,11,16.04.2024,18,26,35,9,162
467,21,29,06.12.2024,10,417,536,119,1190
154,25,26,24.05.2024,6,71,77,6,36
24,26,18,15.12.2024,13,340,437,97,1261
945,11,28,05.01.2024,19,360,431,71,1349
138,5,20,26.05.2024,13,85,90,5,65
843,19,7,24.12.2024,12,199,274,75,900
860,26,3,01.12.2024,1,432,635,203,203
733,22,19,01.11.2024,12,85,119,34,408
598,16,27,09.01.2024,4,137,204,67,268
122,5,9,07.04.2024,14,498,603,105,1470
335,18,12,17.07.2024,10,410,601,191,1910
218,28,1,12.05.2024,3,474,656,182,546
160,1,5,03.09.2024,2,236,261,25,50
629,6,16,28.04.2024,18,273,321,48,864
171,20,20,01.02.2024,15,388,533,145,2175
88,14,14,29.10.2024,1,231,266,35,35
130,28,10,28.09.2024,4,195,233,38,152
976,28,6,16.12.2024,1,133,182,49,49
888,10,2,07.05.2024,2,83,88,5,10
372,30,29,26.07.2024,16,308,450,142,2272
656,15,12,04.08.2024,10,338,365,27,270
454,19,22,27.06.2024,12,165,205,40,480
177,8,9,02.09.2024,4,90,128,38,152
258,15,14,02.01.2024,4,42,55,13,52
788,4,26,20.09.2024,4,39,45,6,24
826,30,24,30.07.2024,18,137,150,13,234
409,9,25,16.02.2024,16,102,127,25,400
44,18,1,21.09.2024,4,435,599,164,656
376,15,4,16.03.2024,19,35,50,15,285
111,11,23,01.02.2024,15,63,72,9,135
44,14,15,22.02.2024,8,47,59,12,96
235,11,3,25.01.2024,10,204,303,99,990
977,9,16,02.06.2024,7,430,529,99,693
117,23,7,13.01.2024,1,309,385,76,76
358,18,28,27.09.2024,12,248,308,60,720
440,20,9,11.09.2024,1,124,137,13,13
6,11,7,09.12.2024,7,330,406,76,532
843,26,30,13.08.2024,9,449,560,111,999
404,14,27,17.03.2024,3,200,263,63,189
538,8,27,11.03.2024,16,29,31,2,32
273,13,14,05.08.2024,4,179,266,87,348
642,19,1,04.02.2024,4,45,56,11,44
498,22,15,04.03.2024,9,39,41,2,18
671,9,19,30.04.2024,18,413,609,196,3528
70,27,23,15.10.2024,9,313,329,16,144
256,22,23,03.02.2024,11,421,475,54,594
262,20,20,13.09.2024,2,433,570,137,274
663,27,20,11.09.2024,13,421,557,136,1768
505,21,8,27.11.2024,3,121,152,31,93
450,22,4,31.07.2024,13,328,427,99,1287
300,4,14,14.07.2024,4,96,110,14,56
294,2,16,02.09.2024,19,156,181,25,475
851,6,25,14.06.2024,14,113,129,16,224
706,17,22,29.10.2024,20,168,220,52,1040
934,4,20,16.08.2024,1,54,74,20,20
933,9,6,08.08.2024,5,33,38,5,25
53,17,15,03.10.2024,6,74,81,7,42
57,27,6,04.12.2024,1,342,483,141,141
643,9,4,06.10.2024,3,140,170,30,90
719,25,20,19.10.2024,17,324,414,90,1530
799,19,15,16.03.2024,4,62,92,30,120
986,1,24,02.10.2024,17,340,447,107,1819
297,30,22,17.09.2024,1,437,620,183,183
73,18,30,23.07.2024,9,175,226,51,459
165,25,4,19.08.2024,12,287,368,81,972
950,8,19,13.08.2024,17,211,263,52,884
12,18,6,01.02.2024,1,152,197,45,45
429,16,11,30.08.2024,3,444,635,191,573
863,7,13,15.10.2024,3,173,228,55,165
94,25,21,08.12.2024,3,498,558,60,180
913,16,22,29.10.2024,9,425,478,53,477
687,14,18,15.09.2024,5,257,354,97,485
402,19,22,01.09.2024,2,156,167,11,22
364,8,23,01.03.2024,9,483,679,196,1764
810,19,14,27.02.2024,12,238,255,17,204
922,18,21,07.05.2024,6,269,317,48,288
916,26,23,10.10.2024,18,134,161,27,486
387,12,4,23.08.2024,19,428,615,187,3553
675,22,21,22.07.2024,6,169,226,57,342
907,20,30,03.08.2024,10,447,592,145,1450
393,18,8,15.05.2024,20,239,254,15,300
464,17,10,18.03.2024,3,247,261,14,42
575,11,4,16.07.2024,5,101,151,50,250
365,19,25,04.05.2024,14,160,207,47,658
129,1,17,20.10.2024,8,156,201,45,360
546,23,17,26.04.2024,20,41,59,18,360
141,9,13,02.09.2024,5,405,521,116,580
617,19,3,05.08.2024,1,339,483,144,144
92,10,3,19.04.2024,4,320,465,145,580
743,8,12,04.12.2024,20,347,492,145,2900
841,28,7,31.12.2024,14,75,87,12,168
487,24,14,01.01.2024,11,115,172,57,627
45,30,9,13.06.2024,18,281,307,26,468
341,25,27,24.12.2024,1,485,545,60,60
929,9,25,03.06.2024,16,94,110,16,256
632,4,14,11.06.2024,2,466,530,64,128
297,9,1,17.10.2024,14,225,322,97,1358
482,25,24,04.09.2024,3,415,532,117,351
717,9,20,02.10.2024,19,405,525,120,2280
43,18,18,02.01.2024,13,256,365,109,1417
149,4,9,10.02.2024,15,158,195,37,555
869,4,26,25.04.2024,11,338,383,45,495
404,21,13,15.05.2024,18,236,313,77,1386
552,20,26,07.05.2024,19,222,303,81,1539
563,15,10,16.09.2024,13,310,369,59,767
914,28,3,16.06.2024,11,321,375,54,594
322,26,22,26.01.2024,4,83,110,27,108
740,20,22,02.04.2024,2,452,614,162,324
490,12,8,22.12.2024,13,475,647,172,2236
360,4,3,30.08.2024,3,236,320,84,252
64,8,27,01.11.2024,18,405,566,161,2898
827,13,7,03.08.2024,11,147,182,35,385
727,21,5,21.02.2024,17,316,369,53,901
382,20,2,13.07.2024,16,23,25,2,32
609,21,21,20.10.2024,10,433,481,48,480
544,19,9,01.04.2024,2,170,249,79,158
385,22,28,20.05.2024,18,334,416,82,1476
510,14,2,16.06.2024,14,154,173,19,266
840,26,30,08.06.2024,11,236,340,104,1144
502,25,15,23.06.2024,18,476,506,30,540
462,26,10,12.06.2024,8,118,165,47,376
825,20,1,05.08.2024,5,144,207,63,315
379,9,26,26.07.2024,13,421,467,46,598
649,6,25,02.08.2024,11,378,446,68,748
112,13,21,20.06.2024,20,331,399,68,1360
948,2,1,21.12.2024,14,102,146,44,616
122,6,5,30.05.2024,6,410,578,168,1008
439,29,16,21.12.2024,16,179,220,41,656
783,11,20,04.02.2024,13,34,37,3,39
182,9,23,21.02.2024,3,210,307,97,291
873,17,27,08.05.2024,18,428,549,121,2178
398,2,1,01.10.2024,1,75,95,20,20
529,13,16,30.12.2024,16,306,339,33,528
896,3,6,22.10.2024,20,471,694,223,4460
455,30,26,07.01.2024,9,248,275,27,243
736,14,26,14.05.2024,6,346,490,144,864
78,5,24,26.02.2024,6,47,54,7,42
258,8,24,02.09.2024,11,136,169,33,363
714,19,24,16.07.2024,18,44,55,11,198
359,27,21,27.03.2024,12,155,229,74,888
180,10,5,04.03.2024,18,375,521,146,2628
516,11,29,09.05.2024,12,428,594,166,1992
973,9,2,17.01.2024,14,150,178,28,392
377,10,21,27.08.2024,11,398,444,46,506
202,28,29,09.02.2024,4,91,134,43,172
158,30,23,17.08.2024,10,414,535,121,1210
784,24,24,08.09.2024,20,395,560,165,3300
87,15,15,22.07.2024,7,144,194,50,350
661,21,22,26.03.2024,16,106,113,7,112
889,27,18,02.10.2024,13,370,417,47,611
75,29,16,30.06.2024,1,355,459,104,104
821,28,3,06.11.2024,13,146,208,62,806
262,11,23,21.11.2024,7,36,44,8,56
812,8,11,06.10.2024,17,444,495,51,867
640,29,8,18.06.2024,8,471,559,88,704
37,28,30,24.12.2024,4,283,306,23,92
894,13,15,30.08.2024,17,166,213,47,799
69,27,14,25.06.2024,6,162,189,27,162
939,22,12,13.05.2024,9,238,256,18,162
545,7,27,30.09.2024,12,372,402,30,360
618,20,7,18.08.2024,18,74,78,4,72
703,21,25,08.12.2024,11,143,192,49,539
127,5,18,21.08.2024,17,282,380,98,1666
896,18,24,16.07.2024,20,310,406,96,1920
601,17,17,20.03.2024,20,51,61,10,200
323,16,19,25.12.2024,5,448,567,119,595
281,27,15,14.12.2024,5,149,182,33,165
38,26,3,02.11.2024,18,402,596,194,3492
728,9,6,17.05.2024,5,483,551,68,340
571,21,8,30.10.2024,15,103,132,29,435
244,19,26,22.02.2024,5,77,115,38,190
676,18,16,16.01.2024,13,491,696,205,2665
967,29,19,17.04.2024,6,284,409,125,750
947,2,23,22.10.2024,18,493,565,72,1296
150,4,2,29.02.2024,1,114,131,17,17
911,1,1,02.02.2024,17,217,273,56,952
389,4,2,16.01.2024,17,450,600,150,2550
688,28,18,12.12.2024,16,386,472,86,1376
12,18,3,31.05.2024,7,210,257,47,329
96,10,2,30.04.2024,18,168,247,79,1422
666,8,21,13.02.2024,19,281,391,110,2090
806,16,9,03.08.2024,18,348,387,39,702
323,10,14,28.10.2024,11,446,604,158,1738
101,2,1,11.04.2024,1,254,362,108,108
414,30,6,02.01.2024,12,438,621,183,2196
967,11,24,28.10.2024,13,244,348,104,1352
340,1,29,18.12.2024,2,243,302,59,118
919,22,13,04.08.2024,9,67,73,6,54
927,21,13,08.07.2024,10,464,505,41,410
93,23,27,25.04.2024,10,20,28,8,80
555,11,4,23.07.2024,20,438,642,204,4080
606,9,25,12.11.2024,16,41,53,12,192
16,12,25,14.10.2024,7,240,297,57,399
208,10,18,13.03.2024,13,293,403,110,1430
579,20,13,22.03.2024,13,330,415,85,1105
16,17,8,03.10.2024,14,305,396,91,1274
920,21,19,01.03.2024,16,290,434,144,2304
677,21,16,10.11.2024,3,206,219,13,39
823,19,14,02.04.2024,12,252,360,108,1296
584,15,29,12.07.2024,1,374,493,119,119
130,1,3,08.03.2024,14,471,643,172,2408
368,15,28,19.11.2024,17,315,410,95,1615
894,6,13,08.01.2024,10,60,78,18,180
6,25,29,19.10.2024,12,498,554,56,672
75,26,15,03.07.2024,11,281,335,54,594
981,4,15,06.09.2024,15,168,230,62,930
688,24,5,06.09.2024,10,217,287,70,700
803,3,4,04.10.2024,18,94,111,17,306
624,23,19,25.07.2024,5,243,284,41,205
167,5,20,01.09.2024,11,282,371,89,979
461,2,26,28.12.2024,9,389,536,147,1323
273,30,5,23.02.2024,18,197,267,70,1260
382,16,27,24.01.2024,11,242,339,97,1067
130,1,28,22.10.2024,5,84,120,36,180
376,16,27,01.01.2024,19,29,43,14,266
51,3,21,23.07.2024,8,493,674,181,1448
351,14,9,28.01.2024,15,107,123,16,240
140,9,28,28.08.2024,6,277,311,34,204
574,20,11,23.05.2024,1,49,53,4,4
533,21,30,21.09.2024,6,102,139,37,222
735,15,8,16.02.2024,5,234,253,19,95
965,30,18,10.07.2024,1,266,287,21,21
806,12,18,24.11.2024,2,66,73,7,14
381,1,20,01.04.2024,15,473,668,195,2925
836,22,3,10.06.2024,6,238,259,21,126
902,2,24,04.07.2024,8,438,630,192,1536
452,2,27,18.10.2024,5,122,131,9,45
474,3,26,08.08.2024,19,180,244,64,1216
5,16,9,24.12.2024,3,469,599,130,390
805,10,18,30.12.2024,11,377,446,69,759
831,21,5,17.10.2024,17,259,320,61,1037
569,19,7,30.07.2024,12,87,115,28,336
286,16,25,29.02.2024,14,448,618,170,2380
983,20,26,20.09.2024,5,262,299,37,185
319,26,18,12.02.2024,7,481,672,191,1337
793,3,2,12.05.2024,11,43,48,5,55
794,18,22,08.11.2024,13,133,181,48,624
71,15,29,31.05.2024,7,471,661,190,1330
746,12,15,11.05.2024,17,411,595,184,3128
248,11,28,18.03.2024,14,291,313,22,308
883,9,18,10.08.2024,2,401,499,98,196
199,19,18,22.04.2024,9,476,564,88,792
555,17,7,07.10.2024,10,110,131,21,210
234,13,30,18.11.2024,10,227,332,105,1050
554,2,11,20.06.2024,2,248,351,103,206
950,9,23,26.01.2024,13,204,255,51,663
344,12,3,05.07.2024,13,101,115,14,182
188,24,27,05.01.2024,20,37,48,11,220
342,29,25,15.06.2024,4,41,52,11,44
717,10,24,15.01.2024,20,72,104,32,640
103,3,4,24.08.2024,17,218,238,20,340
704,1,5,17.06.2024,10,380,560,180,1800
699,13,2,17.12.2024,6,106,142,36,216
416,23,20,08.07.2024,8,181,257,76,608
955,9,23,12.02.2024,6,20,29,9,54
683,5,6,12.08.2024,11,421,592,171,1881
580,12,28,31.01.2024,1,100,144,44,44
778,26,23,26.01.2024,3,183,201,18,54
220,28,24,03.04.2024,12,428,575,147,1764
703,19,9,13.08.2024,20,193,205,12,240
290,2,27,09.09.2024,4,411,513,102,408
196,28,5,25.08.2024,20,301,323,22,440
363,23,24,29.10.2024,12,349,371,22,264
237,22,25,03.02.2024,2,24,36,12,24
295,22,20,20.04.2024,10,415,570,155,1550
209,23,29,23.10.2024,4,21,25,4,16
130,2,29,19.04.2024,14,43,55,12,168
716,25,10,02.02.2024,3,297,352,55,165
629,30,4,23.04.2024,11,470,624,154,1694
914,6,18,02.07.2024,12,409,567,158,1896
932,12,22,17.10.2024,11,95,102,7,77
398,3,2,31.01.2024,14,269,351,82,1148
592,1,21,10.01.2024,13,312,388,76,988
936,30,27,07.10.2024,2,57,74,17,34
735,15,16,14.05.2024,2,418,570,152,304
248,16,17,16.05.2024,5,386,560,174,870
224,22,7,18.10.2024,10,177,232,55,550
987,12,28,25.04.2024,1,21,26,5,5
470,13,25,21.03.2024,11,187,197,10,110
165,21,12,06.01.2024,3,272,312,40,120
389,11,9,07.03.2024,13,114,134,20,260
471,18,9,04.04.2024,19,51,68,17,323
678,19,23,17.03.2024,8,424,487,63,504
339,28,4,05.02.2024,1,397,558,161,161
586,2,21,03.08.2024,2,202,234,32,64
653,25,18,11.10.2024,14,281,327,46,644
15,5,29,29.02.2024,3,216,265,49,147
226,26,5,11.11.2024,1,164,238,74,74
343,30,30,21.08.2024,11,406,586,180,1980
577,18,26,05.10.2024,15,185,266,81,1215
882,6,3,28.03.2024,19,397,523,126,2394
434,10,6,21.07.2024,2,138,204,66,132
247,14,22,01.04.2024,1,472,643,171,171
469,12,12,23.09.2024,6,59,69,10,60
475,29,1,21.12.2024,20,84,88,4,80
456,4,3,25.06.2024,6,135,185,50,300
564,1,6,06.04.2024,14,378,560,182,2548
102,21,26,07.11.2024,6,54,65,11,66
933,17,26,04.03.2024,17,313,457,144,2448
741,1,22,06.07.2024,19,68,85,17,323
792,4,17,11.08.2024,7,294,358,64,448
564,18,3,28.10.2024,11,311,431,120,1320
707,16,6,26.12.2024,4,215,280,65,260
46,23,2,22.06.2024,8,265,342,77,616
828,23,20,20.04.2024,3,300,447,147,441
624,5,17,24.10.2024,16,480,541,61,976
522,9,11,08.06.2024,2,356,389,33,66
527,5,6,01.09.2024,6,20,21,1,6
565,7,20,30.05.2024,18,85,113,28,504
859,8,5,05.12.2024,5,50,58,8,40
285,9,16,22.05.2024,7,394,437,43,301
768,28,17,26.02.2024,3,235,350,115,345
980,12,19,04.11.2024,7,378,399,21,147
130,24,21,07.01.2024,5,38,51,13,65
52,9,30,31.12.2024,5,132,189,57,285
134,23,15,11.09.2024,12,455,668,213,2556
713,29,4,04.05.2024,12,387,440,53,636
921,25,25,07.03.2024,17,67,83,16,272
908,2,14,09.05.2024,13,120,126,6,78
845,2,12,31.10.2024,8,498,708,210,1680
468,15,12,22.07.2024,19,69,91,22,418
230,5,25,06.02.2024,1,353,396,43,43
613,3,14,15.12.2024,3,260,308,48,144
886,20,2,22.03.2024,19,403,596,193,3667
224,4,26,15.01.2024,9,146,209,63,567
760,18,27,21.05.2024,3,337,413,76,228
167,5,19,11.02.2024,7,500,552,52,364
499,1,17,29.01.2024,12,227,295,68,816
378,27,14,20.07.2024,15,405,585,180,2700
42,13,8,24.12.2024,13,496,555,59,767
585,17,26,20.07.2024,12,205,221,16,192
596,10,25,10.05.2024,10,355,379,24,240
989,14,13,10.04.2024,10,329,459,130,1300
735,8,19,01.08.2024,12,24,28,4,48
620,13,6,20.08.2024,7,86,123,37,259
395,5,14,01.03.2024,3,171,254,83,249
262,7,26,29.07.2024,5,490,697,207,1035
352,21,18,22.12.2024,11,156,211,55,605
104,22,17,19.09.2024,2,293,405,112,224
972,20,22,12.11.2024,4,398,529,131,524
418,5,21,02.05.2024,10,484,687,203,2030
87,22,20,19.10.2024,13,154,177,23,299
574,11,26,02.05.2024,5,388,576,188,940
289,15,6,06.07.2024,2,206,266,60,120
231,8,9,13.04.2024,2,434,590,156,312
80,3,23,06.07.2024,17,275,339,64,1088
383,24,9,08.07.2024,15,418,576,158,2370
939,23,19,11.12.2024,9,275,330,55,495
465,13,19,30.12.2024,9,389,544,155,1395
924,30,21,20.06.2024,7,204,303,99,693
448,12,19,29.08.2024,9,221,271,50,450
746,20,25,14.09.2024,13,433,467,34,442
214,29,9,05.03.2024,3,110,132,22,66
379,1,18,23.12.2024,1,313,375,62,62
859,30,20,05.06.2024,17,64,91,27,459
190,25,13,01.11.2024,5,185,260,75,375
381,19,13,22.07.2024,10,452,565,113,1130
116,28,30,02.05.2024,1,252,363,111,111
283,5,8,07.07.2024,19,80,94,14,266
395,4,30,26.05.2024,2,361,534,173,346
667,18,19,10.04.2024,8,425,618,193,1544
964,14,27,29.02.2024,10,417,497,80,800
317,7,23,29.01.2024,15,310,383,73,1095
674,25,15,25.04.2024,4,484,656,172,688
19,1,18,26.11.2024,4,273,402,129,516
842,12,30,26.03.2024,5,497,549,52,260
378,24,18,16.08.2024,3,489,719,230,690
288,11,6,17.04.2024,12,437,649,212,2544
287,24,29,31.03.2024,14,475,692,217,3038
817,15,9,16.05.2024,16,44,48,4,64
199,21,6,27.11.2024,1,374,482,108,108
816,11,29,16.03.2024,8,483,604,121,968
464,5,19,08.08.2024,13,369,441,72,936
193,7,15,02.01.2024,4,162,237,75,300
662,27,2,18.11.2024,12,437,489,52,624
450,30,18,02.02.2024,1,494,727,233,233
334,21,17,03.12.2024,2,38,40,2,4
156,16,28,15.12.2024,6,393,435,42,252
317,6,11,25.08.2024,7,81,101,20,140
619,10,8,20.10.2024,4,413,604,191,764
782,13,17,17.11.2024,3,273,409,136,408
931,2,7,03.03.2024,7,213,283,70,490
360,23,5,22.09.2024,13,110,160,50,650
28,20,21,05.04.2024,19,391,522,131,2489
497,26,8,25.06.2024,5,388,473,85,425
631,12,27,03.12.2024,7,485,560,75,525
174,5,21,20.12.2024,15,136,186,50,750
195,29,17,04.11.2024,20,109,115,6,120
373,28,16,19.12.2024,8,420,508,88,704
133,8,14,06.08.2024,3,279,337,58,174
36,16,13,16.02.2024,2,302,450,148,296
47,17,6,18.07.2024,20,274,385,111,2220
124,25,17,22.03.2024,7,215,229,14,98
15,16,4,20.03.2024,13,71,86,15,195
866,27,18,23.04.2024,18,367,478,111,1998
985,6,23,15.02.2024,16,361,508,147,2352
646,14,30,28.12.2024,9,293,421,128,1152
799,13,16,12.04.2024,11,246,342,96,1056
135,5,7,20.04.2024,5,92,136,44,220
942,23,17,09.01.2024,4,406,537,131,524
260,5,12,13.10.2024,19,98,135,37,703
681,22,21,04.04.2024,6,395,585,190,1140
415,2,13,03.04.2024,20,192,220,28,560
672,2,29,18.07.2024,8,446,648,202,1616
810,24,16,05.05.2024,3,457,613,156,468
545,2,9,22.07.2024,16,161,177,16,256
242,1,16,08.12.2024,11,137,197,60,660
973,10,25,03.03.2024,18,185,207,22,396
910,22,3,22.04.2024,13,109,134,25,325
59,17,26,26.05.2024,13,137,179,42,546
738,16,22,06.07.2024,13,52,62,10,130
284,26,16,24.01.2024,12,183,213,30,360
75,26,6,16.11.2024,3,208,226,18,54
738,9,3,09.02.2024,19,412,603,191,3629
351,11,14,19.05.2024,1,311,457,146,146
94,19,24,11.07.2024,19,128,168,40,760
462,18,16,02.07.2024,6,50,63,13,78
1,26,5,10.01.2024,9,106,132,26,234
163,22,1,06.02.2024,20,463,622,159,3180
99,5,24,04.12.2024,3,96,114,18,54
964,7,19,04.05.2024,14,483,713,230,3220
414,15,18,17.10.2024,15,227,242,15,225
978,17,16,20.04.2024,3,104,129,25,75
915,16,8,10.02.2024,20,414,469,55,1100
449,21,13,11.12.2024,1,255,378,123,123
713,19,17,30.09.2024,20,263,353,90,1800
431,12,8,22.11.2024,7,343,466,123,861
922,30,23,20.12.2024,10,123,136,13,130
94,21,25,14.07.2024,11,178,202,24,264
977,17,22,23.10.2024,11,113,131,18,198
149,2,6,02.03.2024,19,55,66,11,209
25,25,12,05.09.2024,13,159,238,79,1027
577,21,15,25.05.2024,16,23,32,9,144
2,5,14,14.10.2024,15,222,264,42,630
558,22,25,10.08.2024,16,225,266,41,656
459,19,15,07.06.2024,3,234,332,98,294
395,29,12,06.08.2024,2,151,217,66,132
34,1,14,05.05.2024,12,181,247,66,792
482,7,2,28.10.2024,13,159,207,48,624
632,6,15,13.08.2024,3,76,110,34,102
580,21,12,11.03.2024,19,376,459,83,1577
329,7,2,21.12.2024,12,323,407,84,1008
9,6,12,28.06.2024,4,102,131,29,116
474,14,22,15.04.2024,14,173,200,27,378
81,28,11,10.11.2024,10,489,629,140,1400
871,18,27,18.10.2024,11,333,409,76,836
945,10,14,02.12.2024,14,146,173,27,378
339,25,9,29.05.2024,8,177,242,65,520
805,3,26,05.06.2024,20,82,101,19,380
951,20,19,05.05.2024,20,144,205,61,1220
968,28,9,21.05.2024,19,250,295,45,855
589,29,9,28.07.2024,9,28,36,8,72
693,27,22,24.12.2024,18,107,119,12,216
49,19,11,13.09.2024,14,85,112,27,378
489,24,30,21.04.2024,19,362,513,151,2869
658,25,29,24.09.2024,19,459,675,216,4104
103,8,6,23.02.2024,1,477,664,187,187
457,5,2,19.12.2024,6,78,112,34,204
780,2,16,16.06.2024,10,480,688,208,2080
357,7,10,18.11.2024,14,209,251,42,588
820,19,5,05.03.2024,2,145,153,8,16
310,9,19,09.08.2024,10,215,316,101,1010
152,24,20,24.04.2024,19,47,67,20,380
145,29,24,01.07.2024,4,89,125,36,144
209,24,28,24.08.2024,11,459,563,104,1144
365,17,23,31.10.2024,13,117,140,23,299
346,21,22,29.08.2024,1,304,448,144,144
995,26,3,20.10.2024,20,131,193,62,1240
268,23,12,09.10.2024,10,116,135,19,190
336,13,13,23.04.2024,3,57,66,9,27
556,18,12,25.01.2024,7,171,248,77,539
196,27,14,21.03.2024,5,37,53,16,80
200,10,15,29.05.2024,6,155,191,36,216
672,4,1,03.06.2024,8,359,450,91,728
594,14,17,20.12.2024,13,420,596,176,2288
852,1,2,09.10.2024,11,383,524,141,1551
145,19,28,23.05.2024,13,405,531,126,1638
52,5,29,30.11.2024,3,351,473,122,366
499,15,29,26.05.2024,3,258,301,43,129
39,10,7,12.06.2024,2,99,114,15,30
813,26,27,06.07.2024,2,103,116,13,26
573,20,9,04.08.2024,13,193,218,25,325
770,11,24,22.03.2024,7,122,135,13,91
157,20,26,29.04.2024,1,89,94,5,5
339,13,19,25.02.2024,7,124,179,55,385
236,1,8,11.04.2024,9,229,289,60,540
70,24,23,03.03.2024,14,421,528,107,1498
956,27,1,12.08.2024,14,92,129,37,518
625,20,12,10.06.2024,8,480,666,186,1488
178,9,21,08.07.2024,7,48,52,4,28
926,6,30,28.04.2024,19,304,424,120,2280
836,16,6,30.04.2024,1,130,152,22,22
940,26,5,24.01.2024,5,296,350,54,270
70,26,19,09.01.2024,3,252,346,94,282
981,6,22,08.03.2024,10,46,67,21,210
60,15,27,30.07.2024,9,358,518,160,1440
474,24,25,22.02.2024,16,348,465,117,1872
508,11,27,13.05.2024,14,74,98,24,336
853,20,30,03.04.2024,9,45,55,10,90
656,18,8,01.10.2024,15,98,138,40,600
481,21,5,22.06.2024,17,466,685,219,3723
185,5,11,02.11.2024,2,430,636,206,412
801,23,11,16.07.2024,13,408,526,118,1534
730,9,30,16.09.2024,5,146,185,39,195
643,7,15,20.10.2024,3,426,483,57,171
134,3,3,25.01.2024,4,291,366,75,300
526,2,8,22.12.2024,12,372,483,111,1332
827,30,24,10.11.2024,2,362,529,167,334
1000,29,3,20.08.2024,2,461,655,194,388
299,23,2,18.11.2024,8,326,364,38,304
107,19,20,12.11.2024,9,375,454,79,711
613,11,24,26.02.2024,16,72,81,9,144
146,29,16,17.07.2024,9,147,169,22,198
466,6,6,11.01.2024,12,458,541,83,996
148,4,13,31.03.2024,13,367,438,71,923
831,9,19,26.11.2024,13,455,674,219,2847
931,7,24,01.01.2024,18,438,498,60,1080
1000,10,10,03.06.2024,15,469,683,214,3210
19,10,17,22.09.2024,16,280,370,90,1440
945,11,1,18.05.2024,15,30,42,12,180
11,28,12,10.11.2024,13,412,527,115,1495
358,3,20,09.06.2024,7,423,574,151,1057
509,9,20,25.12.2024,6,223,277,54,324
674,7,6,02.11.2024,11,232,268,36,396
190,15,30,11.09.2024,16,183,258,75,1200
164,30,12,17.10.2024,5,28,35,7,35
908,13,12,04.10.2024,3,92,130,38,114
138,1,21,07.07.2024,19,391,574,183,3477
155,19,10,29.02.2024,3,185,271,86,258
978,30,25,29.07.2024,7,41,46,5,35
326,11,25,06.12.2024,19,225,260,35,665
251,15,22,19.03.2024,14,108,154,46,644
741,10,22,02.04.2024,2,240,293,53,106
344,22,9,15.11.2024,17,33,44,11,187
565,11,4,09.04.2024,7,390,428,38,266
671,18,25,21.01.2024,2,159,208,49,98
873,28,8,26.12.2024,6,52,74,22,132
86,6,28,18.03.2024,4,444,501,57,228
79,12,24,31.05.2024,17,359,524,165,2805
116,23,12,02.10.2024,5,465,579,114,570
428,18,16,24.07.2024,10,477,503,26,260
782,19,4,28.09.2024,11,154,200,46,506
60,13,10,05.06.2024,5,448,639,191,955
1,2,26,17.07.2024,6,311,456,145,870
938,30,16,14.08.2024,17,265,307,42,714
322,17,11,17.07.2024,13,164,242,78,1014
409,24,10,01.03.2024,20,242,333,91,1820
223,10,22,02.04.2024,4,332,370,38,152
953,14,26,15.03.2024,6,58,66,8,48
18,10,23,02.02.2024,2,165,185,20,40
260,18,7,27.02.2024,10,395,501,106,1060
524,30,29,17.10.2024,4,66,83,17,68
630,15,5,27.07.2024,19,332,437,105,1995
628,9,19,19.12.2024,17,69,93,24,408
527,23,7,26.02.2024,18,30,32,2,36
897,14,14,28.07.2024,1,397,540,143,143
173,23,1,01.02.2024,1,198,291,93,93
766,6,18,21.06.2024,7,298,366,68,476
894,4,1,13.06.2024,2,187,264,77,154
277,8,29,28.09.2024,8,301,412,111,888
958,12,18,18.12.2024,6,493,610,117,702
830,20,6,03.12.2024,19,412,546,134,2546
62,15,13,30.09.2024,14,103,146,43,602
775,14,30,04.05.2024,8,110,157,47,376
911,7,29,13.09.2024,20,477,584,107,2140
809,29,7,19.04.2024,16,228,332,104,1664
86,17,11,21.11.2024,4,472,630,158,632
556,30,26,25.07.2024,6,223,280,57,342
254,14,18,05.06.2024,4,20,30,10,40
195,5,22,15.09.2024,6,122,178,56,336
735,20,5,20.02.2024,18,454,581,127,2286
995,8,12,05.04.2024,15,397,524,127,1905
877,3,17,01.09.2024,11,382,562,180,1980
754,23,1,26.07.2024,16,272,333,61,976
667,2,14,18.11.2024,12,442,580,138,1656
7,21,29,02.10.2024,17,71,102,31,527
833,9,8,08.02.2024,20,85,107,22,440
456,14,4,23.08.2024,17,375,412,37,629
994,19,14,23.10.2024,18,349,405,56,1008
710,10,12,04.12.2024,16,111,153,42,672
18,23,27,18.03.2024,13,212,258,46,598
977,27,13,30.09.2024,13,411,463,52,676
891,12,19,18.02.2024,5,185,232,47,235
316,20,17,30.10.2024,19,476,704,228,4332
352,11,8,04.11.2024,9,363,452,89,801
652,1,25,15.08.2024,10,473,526,53,530
883,20,1,15.08.2024,9,341,431,90,810
784,20,14,04.08.2024,19,175,189,14,266
449,19,20,21.07.2024,16,31,40,9,144
567,26,20,22.08.2024,10,371,503,132,1320
262,18,12,17.12.2024,20,455,595,140,2800
416,9,3,17.09.2024,7,430,569,139,973
517,28,10,27.02.2024,14,256,297,41,574
860,15,17,18.11.2024,11,125,154,29,319
596,18,26,30.09.2024,4,214,253,39,156
599,18,1,15.05.2024,10,181,191,10,100
620,6,22,23.11.2024,17,432,530,98,1666
11,11,6,01.03.2024,2,103,127,24,48
985,15,2,22.07.2024,13,168,218,50,650
924,2,1,05.10.2024,6,158,204,46,276
259,12,17,23.02.2024,8,20,26,6,48
553,19,18,07.04.2024,2,188,238,50,100
683,27,18,09.10.2024,8,336,443,107,856
486,9,27,24.02.2024,18,197,244,47,846
887,8,1,17.03.2024,15,423,515,92,1380
14,2,1,18.04.2024,2,367,442,75,150
400,25,22,25.07.2024,4,323,468,145,580
798,20,12,26.11.2024,7,28,41,13,91
974,12,13,29.05.2024,4,305,356,51,204
579,7,27,12.08.2024,18,360,515,155,2790
302,14,15,18.10.2024,2,277,386,109,218
936,24,30,10.01.2024,4,291,367,76,304
425,29,21,18.01.2024,1,77,103,26,26
209,14,12,18.12.2024,4,44,51,7,28
941,10,10,09.05.2024,5,327,431,104,520
45,13,16,20.05.2024,11,236,307,71,781
952,13,27,10.07.2024,6,174,256,82,492
387,5,26,05.03.2024,4,185,270,85,340
626,20,14,01.09.2024,5,181,266,85,425
787,6,6,02.04.2024,4,331,349,18,72
242,7,30,21.11.2024,10,245,345,100,1000
265,16,10,02.09.2024,13,175,226,51,663
702,26,11,09.07.2024,20,134,177,43,860
335,6,4,28.04.2024,18,135,161,26,468
501,27,3,11.03.2024,10,190,262,72,720
224,4,6,25.12.2024,20,48,50,2,40
256,13,5,03.12.2024,6,66,97,31,186
70,30,23,29.08.2024,8,492,689,197,1576
147,21,15,10.09.2024,6,237,331,94,564
549,21,18,06.05.2024,20,197,256,59,1180
730,22,11,10.10.2024,11,107,121,14,154
685,10,6,14.12.2024,12,91,125,34,408
321,4,13,29.02.2024,17,187,238,51,867
630,3,15,04.02.2024,2,192,281,89,178
542,28,21,25.01.2024,12,177,234,57,684
265,15,15,06.06.2024,9,261,301,40,360
375,21,7,01.07.2024,5,172,215,43,215
542,24,24,31.05.2024,4,446,627,181,724
473,4,12,24.10.2024,10,379,535,156,1560
585,15,7,13.05.2024,10,453,659,206,2060
209,2,11,28.04.2024,16,281,363,82,1312
228,7,4,28.09.2024,7,235,256,21,147
807,3,23,12.04.2024,8,442,592,150,1200
941,20,6,06.08.2024,2,282,356,74,148
548,29,6,12.10.2024,3,200,281,81,243
492,18,16,10.04.2024,1,166,236,70,70
446,6,11,16.12.2024,3,180,204,24,72
456,23,10,28.07.2024,11,445,600,155,1705
949,11,24,25.04.2024,16,435,614,179,2864
525,2,4,19.09.2024,19,462,507,45,855
436,22,16,06.04.2024,10,162,233,71,710
509,3,24,02.09.2024,15,400,488,88,1320
167,19,26,22.07.2024,19,497,536,39,741
318,8,7,21.07.2024,5,320,423,103,515
264,29,13,18.11.2024,14,154,229,75,1050
350,2,20,27.10.2024,19,319,448,129,2451
707,2,4,25.01.2024,18,324,421,97,1746
492,8,19,09.01.2024,18,483,558,75,1350
954,22,23,23.06.2024,6,68,93,25,150
554,20,14,05.12.2024,17,168,245,77,1309
175,21,10,18.07.2024,9,396,583,187,1683
796,17,10,13.11.2024,20,390,490,100,2000
380,15,6,14.10.2024,12,441,617,176,2112
503,11,21,29.12.2024,19,198,275,77,1463
130,17,24,26.02.2024,19,46,52,6,114
74,15,24,25.10.2024,15,394,509,115,1725
677,29,22,19.11.2024,3,439,488,49,147
542,18,7,23.11.2024,20,484,695,211,4220
921,3,15,08.01.2024,11,404,530,126,1386
307,30,9,17.06.2024,4,424,496,72,288
949,7,14,11.09.2024,6,287,430,143,858
536,4,3,03.04.2024,7,346,368,22,154
541,17,11,10.08.2024,18,78,109,31,558
592,8,20,08.09.2024,18,60,70,10,180
939,11,19,06.01.2024,1,397,559,162,162
673,30,28,20.10.2024,6,446,489,43,258
480,19,2,08.07.2024,11,95,124,29,319
436,30,14,26.10.2024,7,133,189,56,392
383,3,21,02.12.2024,11,401,512,111,1221
769,1,25,25.08.2024,1,413,589,176,176
327,7,5,10.12.2024,13,30,42,12,156
125,4,19,03.05.2024,19,60,63,3,57
982,28,18,05.03.2024,19,262,311,49,931
662,28,11,27.06.2024,4,144,198,54,216
44,19,2,19.12.2024,17,187,266,79,1343
817,4,28,14.09.2024,4,41,48,7,28
63,29,5,02.06.2024,7,385,484,99,693
411,3,29,24.06.2024,17,274,313,39,663
776,13,5,13.08.2024,3,131,178,47,141
522,24,20,24.07.2024,19,145,166,21,399
248,26,20,31.01.2024,1,340,408,68,68
330,28,25,08.08.2024,3,207,276,69,207
299,15,22,06.05.2024,3,353,424,71,213
396,27,13,02.05.2024,19,269,351,82,1558
366,12,26,29.02.2024,4,214,253,39,156
403,22,20,22.01.2024,5,449,574,125,625
246,16,16,03.04.2024,15,34,49,15,225
558,20,14,28.11.2024,13,229,241,12,156
937,8,10,31.03.2024,17,62,76,14,238
262,9,3,26.12.2024,14,59,63,4,56
108,20,23,24.08.2024,11,344,499,155,1705
343,18,28,21.11.2024,10,229,326,97,970
44,12,4,20.01.2024,7,362,471,109,763
2,5,16,19.04.2024,1,155,173,18,18
430,7,14,09.03.2024,17,466,511,45,765
649,9,22,18.05.2024,15,79,102,23,345
593,8,19,11.06.2024,7,494,524,30,210
422,19,26,23.01.2024,14,273,336,63,882
712,25,28,03.12.2024,20,340,505,165,3300
942,1,19,29.03.2024,6,278,359,81,486
879,9,20,17.09.2024,15,411,481,70,1050
328,25,12,27.02.2024,8,445,634,189,1512
337,18,24,20.08.2024,5,453,576,123,615
465,9,29,10.04.2024,1,348,517,169,169
826,18,18,02.03.2024,4,407,498,91,364
853,27,9,18.01.2024,7,176,260,84,588
605,17,25,24.09.2024,3,279,355,76,228
562,16,15,29.11.2024,12,282,324,42,504
240,7,13,25.05.2024,16,250,264,14,224
258,4,8,05.01.2024,20,26,35,9,180
116,12,7,19.09.2024,14,31,35,4,56
131,13,5,27.06.2024,9,423,476,53,477
41,30,9,04.02.2024,6,461,665,204,1224
916,3,20,18.01.2024,12,250,314,64,768
8,9,25,23.05.2024,3,30,32,2,6
707,16,23,29.10.2024,9,71,93,22,198
164,9,12,02.05.2024,18,349,378,29,522
637,16,23,11.11.2024,10,70,104,34,340
946,5,5,21.05.2024,18,258,274,16,288
748,24,18,31.08.2024,5,401,491,90,450
262,28,30,21.10.2024,14,124,140,16,224
383,3,16,01.06.2024,5,114,135,21,105
272,27,29,21.12.2024,7,108,134,26,182
111,18,27,14.11.2024,2,38,43,5,10
392,17,14,20.02.2024,13,130,139,9,117
13,5,18,23.07.2024,15,375,504,129,1935
58,30,30,18.03.2024,2,36,47,11,22
799,26,8,19.07.2024,14,389,432,43,602
585,12,7,28.07.2024,18,318,338,20,360
348,15,16,05.11.2024,11,35,38,3,33
507,8,5,19.06.2024,19,26,28,2,38
473,7,20,24.08.2024,3,117,162,45,135
36,21,15,28.03.2024,6,67,74,7,42
554,27,13,16.10.2024,2,400,512,112,224
906,3,21,18.07.2024,16,92,104,12,192
26,26,27,09.05.2024,11,465,681,216,2376
793,9,24,27.07.2024,4,273,300,27,108
172,18,26,05.02.2024,16,447,471,24,384
263,10,8,27.07.2024,2,94,134,40,80
778,10,10,08.03.2024,6,204,227,23,138
664,13,1,14.03.2024,11,112,128,16,176
602,9,25,12.02.2024,5,395,577,182,910
681,24,1,25.10.2024,9,176,244,68,612
457,26,27,30.08.2024,6,212,281,69,414
214,22,6,03.08.2024,12,181,198,17,204
946,5,16,28.07.2024,3,353,445,92,276
838,10,24,12.10.2024,1,366,406,40,40
971,12,27,20.12.2024,12,319,412,93,1116
115,13,2,08.03.2024,4,74,97,23,92
114,11,30,01.10.2024,19,492,703,211,4009
175,26,14,03.10.2024,13,407,556,149,1937
751,20,26,01.10.2024,14,150,190,40,560
439,26,29,20.09.2024,14,84,96,12,168
389,2,30,05.01.2024,17,289,338,49,833
468,9,1,18.09.2024,8,244,346,102,816
571,3,19,26.02.2024,19,36,46,10,190
635,28,19,07.03.2024,3,243,288,45,135
52,13,19,27.09.2024,7,221,293,72,504
748,21,5,11.04.2024,11,137,161,24,264
276,17,14,18.05.2024,15,40,51,11,165
121,8,19,27.09.2024,14,183,215,32,448
192,5,23,05.01.2024,6,53,79,26,156
205,24,24,08.09.2024,5,463,489,26,130
925,11,1,16.04.2024,7,21,23,2,14
19,18,17,11.07.2024,8,426,503,77,616
732,13,15,02.05.2024,19,76,101,25,475
4,17,17,19.10.2024,19,66,73,7,133
122,13,26,02.01.2024,1,316,468,152,152
871,3,13,17.10.2024,5,440,509,69,345
702,16,7,21.08.2024,19,364,469,105,1995
792,19,24,23.08.2024,20,42,51,9,180
555,26,24,21.06.2024,10,298,446,148,1480
974,3,28,07.10.2024,14,265,397,132,1848
398,8,2,26.01.2024,1,491,647,156,156
862,19,17,21.05.2024,8,147,183,36,288
912,4,24,05.05.2024,15,62,91,29,435
536,29,3,11.06.2024,3,359,475,116,348
662,12,23,12.05.2024,11,276,307,31,341
588,26,10,17.03.2024,1,116,155,39,39
825,28,22,07.01.2024,3,205,234,29,87
781,8,9,30.07.2024,14,35,44,9,126
385,19,20,01.11.2024,9,165,216,51,459
721,9,28,26.07.2024,14,246,275,29,406
55,4,2,08.10.2024,5,156,226,70,350
739,1,26,12.03.2024,18,486,530,44,792
520,5,30,11.03.2024,8,282,353,71,568
945,25,10,01.01.2024,5,476,584,108,540
35,17,12,13.09.2024,3,274,320,46,138
333,29,5,27.08.2024,8,424,619,195,1560
653,7,14,08.06.2024,6,496,570,74,444
466,1,1,30.05.2024,3,101,134,33,99
791,18,5,09.10.2024,11,74,96,22,242
704,14,3,17.11.2024,6,422,563,141,846
336,12,19,10.01.2024,10,360,518,158,1580
408,4,29,17.01.2024,2,257,339,82,164
225,2,9,06.08.2024,14,32,34,2,28
131,18,8,24.09.2024,5,254,277,23,115
92,24,29,30.03.2024,7,482,534,52,364
753,30,21,06.08.2024,3,199,217,18,54
31,21,29,15.05.2024,18,386,470,84,1512
510,24,14,10.08.2024,11,134,198,64,704
791,29,24,12.05.2024,10,215,296,81,810
994,29,10,01.12.2024,6,477,532,55,330
451,14,8,20.11.2024,10,216,307,91,910
26,4,20,15.02.2024,11,141,148,7,77
512,24,24,16.11.2024,7,394,469,75,525
866,5,9,30.04.2024,12,305,452,147,1764
86,16,14,30.09.2024,6,103,152,49,294
776,4,24,13.12.2024,5,442,555,113,565
976,6,13,19.08.2024,1,280,343,63,63
429,23,26,17.07.2024,12,497,678,181,2172
410,5,28,07.03.2024,9,59,87,28,252
637,29,15,28.07.2024,18,246,315,69,1242
865,9,26,15.11.2024,10,262,330,68,680
83,22,6,23.10.2024,2,347,397,50,100
16,2,14,25.02.2024,17,175,223,48,816
495,10,5,05.03.2024,8,180,259,79,632
832,7,10,28.01.2024,10,391,484,93,930
757,25,13,07.10.2024,5,76,85,9,45
345,26,21,09.08.2024,9,329,455,126,1134
365,6,12,11.05.2024,19,422,476,54,1026
994,13,22,19.12.2024,9,430,506,76,684
839,3,25,04.03.2024,4,363,497,134,536
505,25,7,06.10.2024,18,61,79,18,324
475,8,1,08.12.2024,14,139,165,26,364
346,22,19,27.05.2024,17,467,672,205,3485
826,6,24,03.02.2024,17,284,334,50,850
821,14,18,12.01.2024,13,227,265,38,494
793,1,12,20.02.2024,4,42,48,6,24
165,27,29,08.07.2024,10,120,161,41,410
286,3,26,05.04.2024,8,461,490,29,232
726,13,2,08.06.2024,20,400,591,191,3820
435,1,27,02.05.2024,16,92,101,9,144
748,21,28,15.09.2024,13,47,70,23,299
208,6,2,23.12.2024,7,73,96,23,161
564,27,19,14.11.2024,20,487,721,234,4680
83,3,26,21.05.2024,2,500,528,28,56
305,30,30,31.08.2024,4,143,157,14,56
707,16,24,20.02.2024,19,441,556,115,2185
668,18,14,24.01.2024,4,472,629,157,628
398,29,30,20.03.2024,12,370,508,138,1656
770,2,24,16.09.2024,9,70,92,22,198
292,28,21,26.08.2024,17,188,271,83,1411
944,1,21,02.03.2024,3,125,185,60,180
349,8,11,28.09.2024,6,381,421,40,240
484,30,6,12.10.2024,17,366,527,161,2737
455,17,24,02.01.2024,16,90,126,36,576
614,25,2,26.04.2024,15,77,114,37,555
109,14,1,09.10.2024,17,76,106,30,510
482,27,5,07.03.2024,7,366,482,116,812
777,19,21,15.07.2024,9,266,338,72,648
124,18,7,05.09.2024,11,448,516,68,748
459,29,14,13.10.2024,4,480,699,219,876
187,26,10,07.10.2024,1,364,501,137,137
563,12,26,29.06.2024,15,463,688,225,3375
33,1,6,29.11.2024,9,362,522,160,1440
199,26,25,10.03.2024,7,468,575,107,749
191,6,27,03.03.2024,13,319,340,21,273
394,20,22,14.07.2024,18,200,286,86,1548
266,13,22,29.08.2024,1,219,309,90,90
699,22,12,03.02.2024,14,337,459,122,1708
252,19,28,05.07.2024,5,65,78,13,65
754,4,27,27.07.2024,10,441,492,51,510
75,1,16,05.01.2024,7,121,147,26,182
964,27,21,24.09.2024,9,477,669,192,1728
289,28,7,25.12.2024,4,337,435,98,392
228,19,5,27.05.2024,18,457,540,83,1494
68,8,1,06.01.2024,10,487,535,48,480
436,20,26,08.02.2024,1,181,260,79,79
48,5,4,07.07.2024,3,213,269,56,168
374,25,26,31.12.2024,18,218,297,79,1422
414,23,26,05.05.2024,8,361,520,159,1272
630,28,11,29.04.2024,10,301,328,27,270
4,11,1,01.03.2024,9,486,619,133,1197
266,25,5,08.09.2024,17,439,621,182,3094
807,14,28,03.03.2024,11,261,303,42,462
346,11,24,26.02.2024,5,299,418,119,595
928,15,30,09.09.2024,11,433,474,41,451
240,19,12,15.10.2024,16,279,305,26,416
371,9,5,11.07.2024,2,410,554,144,288
613,15,6,26.04.2024,13,29,32,3,39
806,10,14,08.07.2024,9,236,330,94,846
480,5,2,02.07.2024,3,246,270,24,72
472,7,2,13.09.2024,15,82,99,17,255
825,9,25,29.11.2024,16,292,437,145,2320
771,8,16,06.12.2024,2,130,142,12,24
326,10,8,28.09.2024,1,417,473,56,56
453,10,27,07.02.2024,10,277,396,119,1190
723,15,22,02.04.2024,13,45,51,6,78
177,11,9,20.07.2024,17,226,337,111,1887
915,15,6,11.10.2024,17,446,529,83,1411
47,15,14,07.08.2024,9,89,94,5,45
669,29,13,15.12.2024,7,93,118,25,175
70,28,27,27.12.2024,7,193,221,28,196
562,30,13,31.08.2024,14,374,416,42,588
619,5,7,27.09.2024,14,389,497,108,1512
487,20,2,27.07.2024,1,428,500,72,72
941,30,17,20.07.2024,19,367,424,57,1083
59,23,11,08.07.2024,8,152,160,8,64
808,1,22,25.09.2024,20,415,463,48,960
205,19,14,12.02.2024,11,325,466,141,1551
440,9,25,05.01.2024,11,118,160,42,462
756,11,14,18.08.2024,2,397,501,104,208
610,29,15,12.09.2024,11,196,228,32,352
447,28,3,27.10.2024,1,143,204,61,61
540,9,5,02.04.2024,16,127,183,56,896
768,27,5,21.08.2024,7,112,121,9,63
181,6,21,16.03.2024,16,72,79,7,112
77,27,15,08.07.2024,16,238,315,77,1232
992,16,4,04.08.2024,6,49,69,20,120
162,20,29,05.10.2024,12,78,92,14,168
858,18,13,22.10.2024,18,139,148,9,162
180,4,27,05.08.2024,19,24,27,3,57
878,26,6,05.04.2024,1,480,543,63,63
424,19,26,08.10.2024,1,68,102,34,34
912,9,6,13.12.2024,13,157,200,43,559
80,2,14,06.10.2024,1,464,502,38,38
476,29,29,10.01.2024,7,432,648,216,1512
410,30,7,16.08.2024,2,474,571,97,194
12,2,10,25.10.2024,7,126,143,17,119
856,15,6,09.05.2024,9,212,278,66,594
874,4,28,13.08.2024,6,308,362,54,324
455,14,8,11.10.2024,1,296,340,44,44
577,2,24,22.07.2024,11,153,165,12,132
903,12,20,09.11.2024,18,186,204,18,324
619,8,24,05.11.2024,8,85,107,22,176
162,25,16,02.04.2024,18,460,501,41,738
917,19,4,17.07.2024,8,198,266,68,544
306,25,19,07.08.2024,2,84,120,36,72
736,14,15,21.07.2024,11,441,497,56,616
884,6,18,25.11.2024,10,202,301,99,990
603,16,9,15.11.2024,19,211,224,13,247
741,1,17,06.10.2024,14,174,247,73,1022
429,24,16,05.07.2024,14,453,653,200,2800
174,2,18,06.01.2024,4,309,458,149,596
865,6,20,24.01.2024,6,115,161,46,276
926,12,25,02.06.2024,8,337,359,22,176
266,18,19,18.01.2024,19,135,152,17,323
161,12,7,06.05.2024,7,108,114,6,42
172,8,12,04.02.2024,2,98,139,41,82
928,21,26,18.06.2024,12,456,679,223,2676
117,20,29,25.04.2024,11,165,198,33,363
736,22,29,18.01.2024,8,457,563,106,848
517,27,18,13.10.2024,10,375,526,151,1510
639,7,25,05.05.2024,7,468,526,58,406
871,8,13,24.03.2024,19,238,264,26,494
832,18,1,26.06.2024,19,402,556,154,2926
661,8,4,05.03.2024,9,405,474,69,621
166,29,19,30.01.2024,15,419,503,84,1260
613,13,11,09.11.2024,20,334,371,37,740
58,4,5,04.05.2024,16,225,256,31,496
493,15,10,28.10.2024,12,162,182,20,240
929,1,13,03.04.2024,20,416,599,183,3660
657,3,19,14.04.2024,15,195,259,64,960
816,4,19,08.03.2024,6,222,278,56,336
720,8,4,03.09.2024,12,138,190,52,624
132,14,28,20.05.2024,16,183,205,22,352
874,17,21,23.07.2024,9,216,237,21,189
928,5,23,14.01.2024,20,237,262,25,500
829,25,8,14.01.2024,1,312,411,99,99
676,24,29,29.09.2024,9,181,261,80,720
277,2,7,26.03.2024,4,52,63,11,44
236,28,11,30.06.2024,1,182,199,17,17
215,24,25,12.03.2024,4,317,424,107,428
307,8,22,26.01.2024,17,455,568,113,1921
940,19,15,22.11.2024,5,153,193,40,200
998,5,12,20.12.2024,9,460,510,50,450
995,3,17,06.10.2024,8,382,542,160,1280
644,26,22,13.06.2024,18,425,467,42,756
185,24,30,04.01.2024,10,415,537,122,1220
505,2,14,09.09.2024,13,444,581,137,1781
985,7,29,30.04.2024,6,321,422,101,606
572,14,12,18.02.2024,12,466,619,153,1836
59,6,11,27.08.2024,18,360,425,65,1170
444,9,2,23.09.2024,11,345,440,95,1045
804,12,24,26.09.2024,17,118,168,50,850
555,6,25,13.06.2024,14,383,539,156,2184
139,13,26,29.03.2024,1,398,509,111,111
408,16,5,03.12.2024,19,418,471,53,1007
313,30,7,22.11.2024,11,397,484,87,957
805,19,13,27.03.2024,18,101,114,13,234
891,12,1,24.02.2024,18,113,137,24,432
815,22,30,21.11.2024,13,106,147,41,533
308,15,6,09.10.2024,14,116,153,37,518
258,29,6,26.11.2024,1,66,95,29,29
174,26,6,05.05.2024,9,64,75,11,99
588,6,20,06.01.2024,1,330,451,121,121
428,13,6,21.12.2024,15,40,44,4,60
409,1,9,24.06.2024,2,317,384,67,134
199,6,3,01.09.2024,10,351,375,24,240
735,8,20,08.02.2024,2,397,553,156,312
589,8,8,08.07.2024,7,295,392,97,679
138,6,10,25.08.2024,3,64,95,31,93
228,13,28,03.01.2024,2,234,347,113,226
955,17,5,24.08.2024,16,357,381,24,384
410,9,13,26.02.2024,14,445,636,191,2674
486,14,28,07.03.2024,13,164,188,24,312
539,23,12,06.01.2024,1,313,375,62,62
475,6,7,18.05.2024,14,66,83,17,238
436,22,5,24.04.2024,4,125,187,62,248
908,7,26,29.07.2024,4,26,35,9,36
812,20,9,24.05.2024,3,242,287,45,135
962,7,23,20.02.2024,13,198,232,34,442
837,10,4,10.04.2024,15,111,140,29,435
675,29,13,24.09.2024,12,264,390,126,1512
916,30,25,17.01.2024,14,459,625,166,2324
810,9,20,29.05.2024,6,339,505,166,996
839,9,29,07.08.2024,3,262,314,52,156
349,4,17,08.10.2024,15,30,45,15,225
856,28,16,13.11.2024,20,309,351,42,840
307,23,6,22.01.2024,6,166,216,50,300
456,10,9,16.05.2024,3,413,526,113,339
225,9,12,07.08.2024,11,427,486,59,649
844,13,19,10.05.2024,15,311,433,122,1830
12,6,12,30.05.2024,18,209,290,81,1458
388,27,25,11.03.2024,14,306,399,93,1302
288,23,15,29.03.2024,7,284,354,70,490
724,9,3,30.11.2024,1,21,28,7,7
233,17,28,21.06.2024,11,266,368,102,1122
275,6,3,19.07.2024,9,140,167,27,243
605,20,1,17.01.2024,19,419,482,63,1197
547,3,9,10.12.2024,14,45,53,8,112
867,21,21,29.07.2024,4,170,195,25,100
518,30,17,14.05.2024,9,128,161,33,297
406,24,13,12.02.2024,18,405,508,103,1854
668,28,12,31.07.2024,9,478,591,113,1017
479,5,22,17.07.2024,8,226,294,68,544
829,29,26,04.02.2024,12,357,423,66,792
711,3,17,09.07.2024,17,402,532,130,2210
35,2,5,19.08.2024,16,493,672,179,2864
591,27,4,06.01.2024,17,177,212,35,595
715,15,21,14.10.2024,13,30,35,5,65
242,12,14,07.08.2024,2,192,279,87,174
234,23,8,15.08.2024,9,488,606,118,1062
522,8,7,14.01.2024,13,267,358,91,1183
682,7,1,26.07.2024,16,378,532,154,2464
927,4,18,10.03.2024,6,396,448,52,312
421,29,28,31.08.2024,19,348,409,61,1159
84,20,1,19.09.2024,15,280,376,96,1440
442,11,7,14.09.2024,11,366,483,117,1287
847,2,13,29.08.2024,7,313,387,74,518
312,22,27,27.03.2024,17,375,498,123,2091
869,17,25,03.09.2024,13,32,44,12,156
323,26,21,14.06.2024,1,452,611,159,159
310,19,5,12.03.2024,4,375,471,96,384
269,21,28,14.10.2024,14,411,561,150,2100
80,18,28,24.07.2024,15,35,43,8,120
211,6,27,01.02.2024,3,225,314,89,267
592,30,22,08.01.2024,16,118,174,56,896
595,19,6,17.09.2024,20,61,83,22,440
581,27,18,22.03.2024,16,81,106,25,400
429,23,11,14.04.2024,8,257,280,23,184
756,30,30,04.01.2024,18,236,335,99,1782
316,20,9,28.03.2024,13,320,378,58,754
31,7,23,22.12.2024,19,294,400,106,2014
681,8,29,14.02.2024,8,187,222,35,280
656,20,23,10.01.2024,4,164,199,35,140
580,20,14,18.08.2024,1,214,282,68,68
66,20,11,02.10.2024,15,117,123,6,90
265,20,17,24.03.2024,9,138,180,42,378
525,24,25,22.05.2024,8,435,467,32,256
151,26,28,21.12.2024,3,258,355,97,291
115,14,16,14.09.2024,1,217,290,73,73
977,21,9,05.12.2024,8,367,404,37,296
905,21,17,23.10.2024,2,72,88,16,32
872,9,29,24.10.2024,5,481,689,208,1040
524,3,11,01.01.2024,7,249,348,99,693
118,16,2,02.11.2024,5,231,308,77,385
44,15,29,25.01.2024,7,35,45,10,70
553,2,17,23.11.2024,3,252,283,31,93
154,17,6,03.11.2024,14,301,340,39,546
892,25,10,02.06.2024,17,187,260,73,1241
31,22,28,10.01.2024,15,95,122,27,405
676,19,11,16.10.2024,6,348,467,119,714
647,9,3,08.02.2024,14,296,311,15,210
960,19,22,27.02.2024,20,472,686,214,4280
880,4,6,29.08.2024,13,220,244,24,312
571,2,17,09.03.2024,1,142,189,47,47
468,2,21,30.03.2024,14,119,161,42,588
904,9,9,17.05.2024,7,186,263,77,539
391,21,21,04.04.2024,9,191,286,95,855
697,27,29,05.09.2024,1,61,69,8,8
754,24,10,04.12.2024,5,172,193,21,105
898,12,7,27.07.2024,20,29,38,9,180
962,30,5,24.04.2024,15,206,239,33,495
188,18,30,16.05.2024,19,251,309,58,1102
836,30,23,31.01.2024,8,332,405,73,584
780,15,1,08.03.2024,10,144,176,32,320
137,28,25,19.12.2024,10,41,50,9,90
228,23,25,05.08.2024,9,276,383,107,963
717,18,27,13.08.2024,12,418,616,198,2376
696,1,8,23.07.2024,9,450,650,200,1800
523,18,5,01.03.2024,12,467,641,174,2088
463,16,8,22.09.2024,12,161,237,76,912
410,14,5,11.04.2024,5,138,171,33,165
391,13,26,25.08.2024,20,417,555,138,2760
542,14,10,26.10.2024,3,86,105,19,57
318,19,27,05.09.2024,6,89,123,34,204
975,9,6,05.11.2024,17,218,247,29,493
985,14,19,13.11.2024,5,25,31,6,30
408,3,15,18.10.2024,19,228,258,30,570
914,12,13,08.11.2024,19,485,703,218,4142
616,22,27,20.03.2024,19,488,674,186,3534
811,24,18,06.05.2024,7,184,255,71,497
753,16,28,23.07.2024,18,283,356,73,1314
508,15,20,05.04.2024,12,489,685,196,2352
13,10,4,06.05.2024,9,288,325,37,333
536,28,26,08.05.2024,20,436,506,70,1400
336,7,20,27.09.2024,7,411,542,131,917
159,5,13,06.01.2024,1,22,32,10,10
297,10,2,30.11.2024,15,496,610,114,1710
861,20,24,04.02.2024,10,399,536,137,1370
233,28,2,25.05.2024,19,56,64,8,152
122,1,7,21.09.2024,19,273,326,53,1007
923,21,27,05.10.2024,16,87,93,6,96
628,18,14,25.11.2024,11,446,603,157,1727
305,6,24,07.12.2024,5,171,249,78,390
338,20,23,28.11.2024,5,48,62,14,70
240,11,27,28.04.2024,1,311,457,146,146
437,14,20,22.02.2024,20,153,199,46,920
636,13,5,18.10.2024,18,491,730,239,4302
837,2,21,08.07.2024,13,293,325,32,416
5,3,16,03.12.2024,12,145,193,48,576
3,15,20,28.07.2024,14,71,104,33,462
441,19,11,02.09.2024,5,407,567,160,800
938,24,21,28.05.2024,1,178,207,29,29
962,10,16,11.05.2024,4,383,430,47,188
231,3,22,09.04.2024,16,358,476,118,1888
871,13,4,07.01.2024,2,274,348,74,148
202,21,6,07.02.2024,16,199,215,16,256
430,3,25,21.10.2024,6,43,48,5,30
342,27,20,25.10.2024,20,389,421,32,640
204,17,16,09.04.2024,7,255,272,17,119
306,24,6,30.05.2024,10,160,229,69,690
294,18,20,01.01.2024,9,272,338,66,594
455,24,18,31.07.2024,5,416,479,63,315
68,30,29,03.01.2024,16,231,276,45,720
797,25,20,06.02.2024,16,342,364,22,352
941,23,18,01.07.2024,3,267,364,97,291
985,22,6,02.10.2024,19,197,214,17,323
361,13,7,10.05.2024,2,329,466,137,274
572,26,12,17.09.2024,1,196,236,40,40
760,3,24,18.02.2024,11,478,682,204,2244
267,9,23,13.11.2024,13,362,440,78,1014
617,22,4,22.07.2024,2,351,446,95,190
485,1,2,25.05.2024,1,320,371,51,51
849,26,1,08.06.2024,11,477,568,91,1001
553,9,1,07.05.2024,20,492,691,199,3980
560,5,6,11.02.2024,18,32,43,11,198
603,13,13,23.03.2024,2,142,182,40,80
938,27,18,10.10.2024,13,370,546,176,2288
644,23,24,11.01.2024,15,293,379,86,1290
156,13,11,21.03.2024,20,377,453,76,1520
995,29,13,24.05.2024,14,383,506,123,1722
888,7,24,01.05.2024,11,389,482,93,1023
205,2,30,07.04.2024,20,259,307,48,960
871,1,17,16.09.2024,2,410,572,162,324
443,16,2,15.09.2024,20,305,387,82,1640
993,2,20,27.03.2024,2,367,504,137,274
614,23,20,17.02.2024,18,449,618,169,3042
710,21,29,24.05.2024,8,60,65,5,40
698,28,30,15.03.2024,13,213,233,20,260
344,18,9,10.10.2024,11,307,329,22,242
167,26,13,03.05.2024,6,356,393,37,222
609,21,13,17.01.2024,10,252,355,103,1030
689,6,5,10.01.2024,11,135,178,43,473
482,22,1,31.08.2024,16,159,193,34,544
286,10,16,23.12.2024,2,462,596,134,268
914,22,25,11.03.2024,7,60,75,15,105
66,10,13,07.02.2024,20,313,376,63,1260
250,19,9,03.08.2024,16,431,528,97,1552
418,5,28,27.07.2024,6,147,176,29,174
778,19,13,02.01.2024,12,138,206,68,816
142,24,13,07.02.2024,18,174,184,10,180
383,16,27,11.10.2024,15,23,26,3,45
398,17,13,25.01.2024,11,495,701,206,2266
403,8,2,21.07.2024,13,142,177,35,455
9,12,2,07.03.2024,17,474,634,160,2720
663,21,14,16.05.2024,1,339,439,100,100
124,1,28,20.04.2024,19,42,55,13,247
169,2,26,01.05.2024,1,93,113,20,20
24,20,9,22.06.2024,6,372,424,52,312
966,15,25,08.07.2024,19,259,353,94,1786
376,8,28,27.02.2024,19,352,500,148,2812
993,13,2,26.01.2024,20,386,498,112,2240
45,5,28,25.08.2024,12,489,693,204,2448
505,30,10,04.12.2024,11,151,214,63,693
646,19,5,23.01.2024,11,166,230,64,704
986,20,10,21.12.2024,10,493,591,98,980
527,3,4,12.10.2024,1,342,445,103,103
736,18,20,18.07.2024,12,342,413,71,852
217,10,29,24.05.2024,11,223,333,110,1210
161,28,6,01.11.2024,12,96,106,10,120
632,16,2,10.06.2024,14,214,226,12,168
993,26,14,22.02.2024,14,450,501,51,714
555,14,1,17.08.2024,1,171,214,43,43
656,5,25,03.08.2024,13,28,31,3,39
362,26,3,06.07.2024,17,206,219,13,221
384,7,22,03.01.2024,3,245,283,38,114
744,21,3,04.08.2024,16,434,474,40,640
434,2,12,26.09.2024,15,312,336,24,360
133,6,9,03.06.2024,3,127,147,20,60
335,10,15,17.10.2024,9,48,66,18,162
992,9,24,06.07.2024,7,69,94,25,175
328,23,30,27.08.2024,19,47,56,9,171
472,4,19,10.02.2024,17,346,453,107,1819
408,14,24,02.06.2024,13,317,363,46,598
339,13,29,04.03.2024,18,140,159,19,342
331,23,20,10.09.2024,9,341,461,120,1080
472,13,18,04.01.2024,12,371,468,97,1164
791,6,8,21.12.2024,16,453,572,119,1904
749,3,18,15.05.2024,8,458,482,24,192
658,4,19,05.04.2024,6,33,44,11,66
443,16,8,21.04.2024,7,455,645,190,1330
707,23,20,23.12.2024,16,128,180,52,832
137,7,19,26.07.2024,10,152,162,10,100
890,18,30,09.03.2024,11,142,198,56,616
836,13,30,23.08.2024,13,336,483,147,1911
669,6,9,25.03.2024,15,262,383,121,1815
637,30,23,22.03.2024,8,389,502,113,904
347,21,5,24.01.2024,5,142,193,51,255
23,19,4,08.05.2024,1,53,66,13,13
194,8,25,30.03.2024,17,162,191,29,493
218,10,16,03.12.2024,3,329,433,104,312
153,29,20,05.01.2024,16,189,268,79,1264
883,3,11,17.05.2024,11,84,122,38,418
59,30,30,14.08.2024,11,243,317,74,814
624,20,3,13.04.2024,18,133,147,14,252
4,23,27,20.07.2024,10,145,166,21,210
159,6,25,09.08.2024,5,487,539,52,260
461,15,15,21.04.2024,7,500,542,42,294
908,24,17,24.12.2024,2,223,274,51,102
306,24,16,15.01.2024,15,21,24,3,45
371,2,8,12.07.2024,2,191,253,62,124
174,20,17,04.06.2024,5,342,403,61,305
746,27,2,23.11.2024,16,425,582,157,2512
746,2,5,10.09.2024,9,29,39,10,90
890,14,16,06.07.2024,17,105,130,25,425
431,5,12,18.10.2024,1,451,661,210,210
851,6,1,21.01.2024,8,381,469,88,704
825,17,22,01.07.2024,13,472,698,226,2938
269,14,24,06.02.2024,10,313,392,79,790
323,20,16,26.11.2024,19,126,138,12,228
948,7,19,23.12.2024,19,367,465,98,1862
589,27,18,28.12.2024,9,451,676,225,2025
809,3,9,02.11.2024,17,238,254,16,272
758,20,29,10.06.2024,11,27,39,12,132
612,23,26,04.12.2024,7,93,132,39,273
794,28,14,31.05.2024,7,85,94,9,63
228,19,9,14.07.2024,4,86,94,8,32
736,18,19,26.12.2024,18,432,580,148,2664
677,28,30,23.02.2024,11,335,395,60,660
956,11,8,08.05.2024,1,22,30,8,8
187,22,15,11.08.2024,6,90,131,41,246
837,19,17,26.12.2024,10,500,637,137,1370
177,27,29,22.11.2024,6,194,238,44,264
473,24,17,22.12.2024,16,52,74,22,352
793,17,17,13.03.2024,5,124,155,31,155
659,18,21,04.09.2024,2,188,253,65,130
996,28,10,04.02.2024,13,287,308,21,273
715,3,24,12.04.2024,9,314,420,106,954
411,10,15,21.10.2024,20,294,437,143,2860
992,9,13,13.01.2024,11,283,352,69,759
455,20,9,17.10.2024,13,118,171,53,689
555,8,1,13.11.2024,15,98,112,14,210
824,4,2,05.10.2024,2,313,453,140,280
428,3,13,24.07.2024,5,23,25,2,10
331,12,29,12.06.2024,15,370,473,103,1545
974,9,11,12.09.2024,17,224,268,44,748
770,25,12,09.09.2024,12,71,106,35,420
177,9,16,08.08.2024,9,22,23,1,9
396,17,15,21.06.2024,17,422,597,175,2975
828,17,28,08.03.2024,10,369,397,28,280
74,14,13,29.06.2024,9,186,204,18,162
180,29,9,03.06.2024,9,55,77,22,198
603,20,16,31.05.2024,1,93,131,38,38
854,7,7,27.09.2024,14,487,628,141,1974
437,1,17,29.04.2024,11,440,555,115,1265
43,24,3,19.08.2024,1,145,179,34,34
47,29,20,01.06.2024,9,98,143,45,405
525,21,14,01.02.2024,6,43,61,18,108
341,24,2,03.10.2024,20,396,511,115,2300
32,20,25,22.05.2024,3,128,150,22,66
593,1,19,09.08.2024,3,441,584,143,429
611,16,28,21.10.2024,16,89,127,38,608
345,5,18,17.05.2024,4,127,154,27,108
625,9,17,07.01.2024,10,182,266,84,840
476,7,12,12.07.2024,16,173,259,86,1376
998,1,19,13.06.2024,16,347,464,117,1872
229,19,9,12.12.2024,1,474,570,96,96
849,21,25,07.10.2024,2,91,122,31,62
443,1,6,11.11.2024,9,158,176,18,162
893,26,28,23.01.2024,8,66,80,14,112
544,20,25,12.03.2024,11,286,336,50,550
862,28,1,27.08.2024,7,452,538,86,602
42,8,4,15.10.2024,15,360,452,92,1380
293,18,14,23.08.2024,12,332,403,71,852
972,4,22,07.06.2024,3,282,410,128,384
756,9,30,17.12.2024,17,389,436,47,799
4,17,17,07.03.2024,20,183,257,74,1480
533,28,13,22.12.2024,17,432,636,204,3468
109,19,14,22.03.2024,8,351,490,139,1112
173,29,14,16.01.2024,12,389,504,115,1380
734,20,25,23.05.2024,6,255,316,61,366
493,10,30,21.09.2024,7,70,100,30,210
455,7,23,02.01.2024,13,226,256,30,390
605,7,22,24.11.2024,3,210,229,19,57
832,17,30,16.02.2024,15,296,377,81,1215
302,25,5,14.07.2024,12,440,529,89,1068
320,14,20,07.10.2024,19,448,475,27,513
431,30,5,30.04.2024,5,255,351,96,480
226,21,16,01.03.2024,15,339,433,94,1410
594,1,5,28.03.2024,8,261,354,93,744
587,2,2,28.12.2024,14,181,257,76,1064
894,26,23,04.10.2024,15,48,65,17,255
566,9,26,26.08.2024,15,317,379,62,930
266,3,21,15.08.2024,14,274,326,52,728
208,19,17,09.02.2024,18,296,394,98,1764
41,27,15,17.04.2024,15,283,306,23,345
598,3,11,09.09.2024,20,49,64,15,300
310,12,17,07.11.2024,13,105,129,24,312
564,7,17,14.05.2024,18,282,352,70,1260
211,17,1,20.03.2024,1,370,468,98,98
82,5,8,30.10.2024,13,368,404,36,468
118,30,21,07.12.2024,20,34,45,11,220
342,24,3,07.10.2024,18,71,79,8,144
581,21,26,03.10.2024,17,349,427,78,1326
672,26,25,20.02.2024,17,412,457,45,765
828,1,21,07.09.2024,1,488,601,113,113
733,25,28,01.11.2024,2,467,515,48,96
466,19,5,22.04.2024,16,419,468,49,784
569,5,13,10.10.2024,20,477,550,73,1460
282,29,23,18.09.2024,14,358,425,67,938
924,15,30,24.01.2024,8,385,459,74,592
431,16,11,23.08.2024,17,334,413,79,1343
532,26,24,25.04.2024,7,193,233,40,280
457,1,26,06.09.2024,15,140,194,54,810
785,6,27,02.12.2024,7,71,85,14,98
349,21,2,14.12.2024,11,245,332,87,957
34,12,5,25.11.2024,3,288,364,76,228
618,22,29,23.04.2024,17,160,219,59,1003
287,9,2,08.06.2024,12,280,362,82,984
108,3,10,02.02.2024,10,474,601,127,1270
53,21,30,25.12.2024,4,405,453,48,192
233,21,26,14.06.2024,2,121,149,28,56
455,4,11,17.11.2024,13,439,646,207,2691
547,20,3,20.01.2024,19,347,433,86,1634
894,15,20,16.08.2024,18,47,68,21,378
146,8,21,03.06.2024,9,202,251,49,441
299,9,14,30.08.2024,19,434,513,79,1501
937,25,8,04.08.2024,14,172,244,72,1008
68,14,7,09.03.2024,20,183,232,49,980
777,16,17,04.12.2024,7,464,512,48,336
597,16,12,19.08.2024,6,327,477,150,900
686,5,22,12.08.2024,8,73,93,20,160
985,18,25,16.04.2024,2,89,116,27,54
91,11,18,07.07.2024,10,348,391,43,430
842,8,8,30.03.2024,10,66,80,14,140
755,12,3,08.10.2024,12,340,470,130,1560
551,8,19,09.08.2024,13,32,47,15,195
933,7,10,29.05.2024,13,453,572,119,1547
261,13,6,03.03.2024,12,400,534,134,1608
366,18,10,28.11.2024,3,491,654,163,489
275,24,30,08.11.2024,4,237,256,19,76
4,11,1,23.03.2024,6,59,76,17,102
97,13,19,09.10.2024,3,350,499,149,447
294,29,4,26.04.2024,10,448,526,78,780
492,13,23,30.01.2024,19,150,213,63,1197
209,23,16,18.08.2024,10,33,46,13,130
132,19,26,05.03.2024,18,227,268,41,738
653,8,7,15.01.2024,5,237,351,114,570
650,12,30,16.01.2024,19,391,524,133,2527
394,23,27,05.04.2024,4,305,442,137,548
426,13,15,23.08.2024,4,327,453,126,504
426,14,14,09.02.2024,1,91,136,45,45
765,13,30,03.05.2024,9,109,154,45,405
944,2,5,06.03.2024,5,368,502,134,670
226,9,20,28.10.2024,18,40,43,3,54
214,24,15,04.08.2024,18,133,193,60,1080
500,12,20,09.01.2024,4,262,377,115,460
630,3,11,17.03.2024,10,161,228,67,670
124,9,10,14.01.2024,20,104,119,15,300
796,28,12,02.02.2024,15,175,251,76,1140
930,12,14,06.06.2024,5,464,656,192,960
834,2,4,08.10.2024,13,146,185,39,507
132,13,7,04.02.2024,19,319,447,128,2432
366,24,29,25.11.2024,13,477,632,155,2015
343,12,19,21.03.2024,6,268,364,96,576
385,28,29,14.05.2024,3,172,228,56,168
27,7,30,07.10.2024,11,21,31,10,110
761,26,11,24.06.2024,3,393,540,147,441
214,27,30,18.05.2024,10,493,669,176,1760
897,18,13,03.09.2024,5,112,144,32,160
549,8,19,01.01.2024,10,260,361,101,1010
980,8,3,09.05.2024,12,161,196,35,420
757,23,3,10.07.2024,16,169,222,53,848
203,5,12,17.02.2024,4,153,209,56,224
603,15,17,21.09.2024,15,321,456,135,2025
219,3,5,18.12.2024,1,168,177,9,9
330,10,8,13.08.2024,16,353,440,87,1392
98,17,7,27.01.2024,17,431,525,94,1598
53,2,4,22.12.2024,18,265,393,128,2304
88,10,7,25.10.2024,3,186,203,17,51
67,9,8,09.08.2024,16,293,362,69,1104
647,4,26,08.01.2024,16,428,555,127,2032
562,15,4,24.01.2024,20,363,447,84,1680
538,11,14,03.06.2024,5,189,263,74,370
860,2,14,24.11.2024,18,353,504,151,2718
147,28,14,23.10.2024,7,145,213,68,476
739,3,12,14.05.2024,6,381,527,146,876
13,13,2,28.01.2024,6,119,128,9,54
982,17,14,20.06.2024,11,485,661,176,1936
692,11,30,11.03.2024,6,167,231,64,384
99,10,26,19.03.2024,1,226,279,53,53
38,4,11,08.02.2024,9,183,253,70,630
580,5,1,18.02.2024,13,237,344,107,1391
211,28,24,22.09.2024,5,85,94,9,45
140,9,2,17.01.2024,11,138,199,61,671
602,5,6,06.12.2024,6,44,54,10,60
144,21,1,18.02.2024,20,407,436,29,580
78,4,25,16.04.2024,9,293,348,55,495
229,19,4,08.04.2024,8,348,393,45,360
186,17,13,29.02.2024,7,101,117,16,112
613,9,11,29.07.2024,10,190,210,20,200
312,6,17,23.07.2024,10,415,586,171,1710
625,15,14,03.01.2024,6,155,203,48,288
441,14,7,17.05.2024,6,401,431,30,180
830,19,12,06.05.2024,14,404,507,103,1442
687,16,21,04.05.2024,9,358,468,110,990
653,21,12,31.03.2024,20,261,372,111,2220
365,13,27,17.02.2024,11,372,420,48,528
393,13,12,19.06.2024,19,453,489,36,684
500,25,29,18.07.2024,6,209,294,85,510
894,21,17,01.02.2024,20,489,605,116,2320
308,4,9,30.08.2024,12,132,153,21,252
870,19,23,08.07.2024,6,167,241,74,444
797,9,30,20.07.2024,14,388,463,75,1050
239,11,7,14.10.2024,19,377,513,136,2584
949,14,5,20.11.2024,19,302,438,136,2584
766,8,5,28.05.2024,7,469,685,216,1512
774,13,16,30.10.2024,5,172,189,17,85
487,3,6,24.11.2024,15,462,619,157,2355
957,14,7,16.11.2024,18,496,571,75,1350
278,7,22,26.05.2024,14,300,359,59,826
768,14,8,08.12.2024,19,33,41,8,152
104,13,24,02.10.2024,5,171,223,52,260
605,21,8,11.11.2024,20,405,587,182,3640
560,26,22,09.02.2024,14,69,83,14,196
230,22,17,12.02.2024,4,221,321,100,400
528,21,7,21.12.2024,15,65,69,4,60
24,16,26,16.04.2024,16,86,105,19,304
483,23,6,03.01.2024,4,160,207,47,188
434,27,16,10.10.2024,1,304,442,138,138
396,24,9,20.10.2024,7,80,89,9,63
126,10,13,10.04.2024,19,413,489,76,1444
792,15,13,04.04.2024,11,348,409,61,671
148,24,19,20.11.2024,6,218,312,94,564
304,12,25,26.07.2024,7,489,693,204,1428
613,4,15,12.03.2024,19,460,650,190,3610
646,29,10,06.01.2024,7,222,315,93,651
269,17,28,06.12.2024,3,361,397,36,108
658,14,23,15.07.2024,10,310,390,80,800
636,14,15,10.12.2024,1,230,312,82,82
564,8,7,17.06.2024,8,327,360,33,264
108,13,4,27.03.2024,12,422,590,168,2016
29,4,13,06.05.2024,19,328,385,57,1083
600,2,25,11.02.2024,7,135,156,21,147
996,9,7,31.08.2024,14,446,565,119,1666
820,7,22,20.05.2024,18,426,467,41,738
47,27,19,06.10.2024,9,65,90,25,225
978,3,28,10.08.2024,16,327,375,48,768
76,9,30,05.10.2024,3,73,90,17,51
999,10,19,01.12.2024,19,359,483,124,2356
791,1,2,08.06.2024,6,477,697,220,1320
155,17,18,01.08.2024,14,494,545,51,714
938,18,2,07.02.2024,20,328,350,22,440
299,5,4,12.04.2024,9,276,401,125,1125
957,11,10,10.10.2024,9,474,531,57,513
62,7,11,11.04.2024,3,237,255,18,54
490,19,22,19.02.2024,16,448,660,212,3392
606,4,7,05.10.2024,13,50,54,4,52
807,16,4,25.12.2024,3,424,540,116,348
209,29,5,27.12.2024,4,318,431,113,452
949,28,27,09.01.2024,5,175,255,80,400
686,28,1,23.03.2024,17,304,429,125,2125
91,10,3,02.03.2024,5,450,581,131,655
872,21,10,11.06.2024,5,485,615,130,650
714,3,25,07.11.2024,7,243,307,64,448
523,12,16,13.07.2024,10,460,572,112,1120
620,3,8,10.10.2024,3,39,57,18,54
512,10,20,26.02.2024,13,82,115,33,429
294,6,8,24.11.2024,5,80,97,17,85
899,2,3,29.12.2024,8,62,91,29,232
224,11,2,29.07.2024,20,359,447,88,1760
678,6,13,04.02.2024,14,300,349,49,686
353,11,6,14.06.2024,6,407,547,140,840
758,10,29,08.02.2024,1,91,121,30,30
290,16,24,03.02.2024,15,318,412,94,1410
722,20,9,23.09.2024,17,488,712,224,3808
437,13,20,24.05.2024,17,311,464,153,2601
613,8,2,16.01.2024,12,74,97,23,276
644,23,24,23.06.2024,14,251,303,52,728
680,30,13,16.04.2024,12,206,288,82,984
304,29,5,04.04.2024,15,346,476,130,1950
467,5,13,25.07.2024,5,409,550,141,705
415,12,1,12.05.2024,13,467,492,25,325
24,22,2,12.02.2024,10,459,688,229,2290
944,9,4,23.04.2024,1,439,536,97,97
664,14,28,02.04.2024,9,40,56,16,144
525,15,25,22.02.2024,1,21,31,10,10
833,14,14,04.10.2024,20,50,68,18,360
996,26,25,21.02.2024,16,89,115,26,416
8,16,14,27.03.2024,7,276,379,103,721
125,12,28,03.12.2024,6,91,105,14,84
566,5,6,30.03.2024,18,99,117,18,324
549,9,16,16.06.2024,5,289,328,39,195
621,19,20,01.06.2024,2,20,23,3,6
40,24,25,10.10.2024,9,251,332,81,729
119,8,12,22.02.2024,4,499,579,80,320
684,1,27,09.06.2024,7,183,272,89,623
967,15,30,15.03.2024,6,412,552,140,840
607,5,30,04.01.2024,14,168,185,17,238
718,30,22,03.07.2024,16,304,453,149,2384
614,25,15,25.09.2024,8,34,38,4,32
554,1,28,07.02.2024,1,478,566,88,88
637,10,30,30.12.2024,11,144,171,27,297
628,11,28,05.03.2024,17,409,596,187,3179
953,21,9,27.05.2024,16,304,375,71,1136
466,10,24,17.11.2024,5,301,321,20,100
88,21,17,11.12.2024,18,494,654,160,2880
24,13,8,25.06.2024,16,487,634,147,2352
728,1,22,26.04.2024,15,305,401,96,1440
119,22,5,19.02.2024,8,441,594,153,1224
743,29,23,15.08.2024,9,496,726,230,2070
246,27,24,25.07.2024,20,314,332,18,360
834,11,18,14.06.2024,12,488,621,133,1596
382,19,19,05.06.2024,1,298,415,117,117
192,19,29,01.01.2024,14,328,487,159,2226
581,21,2,19.12.2024,10,203,295,92,920
533,20,26,05.10.2024,14,27,33,6,84
746,2,13,18.06.2024,14,255,295,40,560
464,25,9,09.07.2024,15,477,510,33,495
409,11,5,15.08.2024,14,67,98,31,434
429,22,18,05.02.2024,10,320,465,145,1450
60,5,12,22.04.2024,1,282,332,50,50
491,24,13,11.11.2024,20,102,136,34,680
870,13,10,17.05.2024,10,255,357,102,1020
511,28,30,02.04.2024,11,430,621,191,2101
10,18,10,11.12.2024,6,143,198,55,330
923,9,6,18.04.2024,10,282,297,15,150
33,9,3,20.08.2024,5,177,195,18,90
339,11,8,22.07.2024,20,75,90,15,300
347,11,15,24.05.2024,19,495,526,31,589
179,27,16,15.10.2024,13,27,30,3,39
169,12,15,01.02.2024,8,410,470,60,480
673,5,20,22.06.2024,20,169,205,36,720
954,8,28,12.02.2024,11,347,448,101,1111
830,5,17,17.07.2024,8,43,51,8,64
934,27,5,05.11.2024,14,220,249,29,406
903,23,20,03.11.2024,3,246,276,30,90
498,10,6,03.11.2024,5,444,492,48,240
310,3,14,25.08.2024,18,494,690,196,3528
927,4,12,16.12.2024,8,322,364,42,336
416,13,20,17.04.2024,16,459,687,228,3648
