ID_zbozi,ID_lekarna,ID_vedouci,datum,pocet_prodanych_ks,nakupni_cena_CZK,prodejni_cena_CZK,marze_CZK,trzba_CZK
655,4,1,2025-02-24,9,145,167,22,198
755,4,22,2025-02-24,18,64,84,20,360
33,1,3,2025-02-07,8,278,367,89,712
575,7,23,2025-02-21,18,234,269,35,630
604,9,26,2025-02-28,1,408,576,168,168
715,14,11,2025-02-09,5,130,192,62,310
345,4,3,2025-02-13,4,203,291,88,352
619,9,26,2025-02-02,15,294,325,31,465
945,13,3,2025-02-18,10,444,592,148,1480
907,28,12,2025-02-19,7,380,411,31,217
678,8,25,2025-02-10,3,457,528,71,213
104,13,9,2025-02-15,12,103,125,22,264
215,22,9,2025-02-23,3,331,442,111,333
547,24,8,2025-02-06,15,214,251,37,555
948,21,23,2025-02-18,8,370,442,72,576
787,25,2,2025-02-08,2,432,515,83,166
275,3,7,2025-02-19,11,128,172,44,484
406,29,30,2025-02-21,15,93,109,16,240
253,24,18,2025-02-18,9,402,528,126,1134
920,19,13,2025-02-12,8,90,115,25,200
94,25,2,2025-02-28,4,98,131,33,132
812,22,14,2025-02-20,3,217,265,48,144
480,17,9,2025-02-18,1,368,506,138,138
699,29,18,2025-02-25,9,413,553,140,1260
115,10,14,2025-02-06,15,21,31,10,150
897,24,9,2025-02-17,6,279,408,129,774
892,21,10,2025-02-27,17,331,377,46,782
383,25,6,2025-02-18,17,490,515,25,425
332,16,1,2025-02-04,12,469,700,231,2772
827,10,8,2025-02-02,8,469,612,143,1144
81,3,24,2025-02-16,3,409,527,118,354
129,5,22,2025-02-16,18,104,122,18,324
894,20,14,2025-02-07,18,406,560,154,2772
206,23,10,2025-02-13,12,244,355,111,1332
463,4,8,2025-02-08,3,193,204,11,33
568,8,19,2025-02-08,1,56,77,21,21
61,8,3,2025-02-02,11,56,72,16,176
286,22,16,2025-02-07,18,87,120,33,594
904,19,19,2025-02-16,8,421,532,111,888
417,7,4,2025-02-04,14,201,249,48,672
479,28,24,2025-02-02,4,51,63,12,48
348,26,28,2025-02-04,8,118,134,16,128
460,5,14,2025-02-06,9,256,298,42,378
946,3,15,2025-02-26,18,70,75,5,90
554,27,1,2025-02-03,8,105,129,24,192
493,7,28,2025-02-13,2,104,127,23,46
400,9,30,2025-02-26,15,166,206,40,600
981,24,26,2025-02-18,16,99,112,13,208
223,2,19,2025-02-24,18,51,71,20,360
59,2,19,2025-02-16,17,490,703,213,3621
162,2,17,2025-02-03,6,55,72,17,102
692,28,8,2025-02-13,4,475,621,146,584
593,20,2,2025-02-20,3,234,315,81,243
579,17,11,2025-02-09,7,362,497,135,945
245,9,13,2025-02-05,10,254,303,49,490
770,30,3,2025-02-01,15,338,507,169,2535
103,3,18,2025-02-07,17,155,172,17,289
358,29,3,2025-02-08,12,165,185,20,240
854,18,23,2025-02-10,20,433,582,149,2980
9,22,27,2025-02-18,10,497,670,173,1730
962,29,5,2025-02-09,4,475,522,47,188
567,5,9,2025-02-10,20,127,174,47,940
209,22,21,2025-02-28,9,278,353,75,675
928,30,28,2025-02-02,3,344,427,83,249
284,2,1,2025-02-11,5,346,516,170,850
166,24,15,2025-02-18,14,307,324,17,238
78,29,23,2025-02-05,18,38,54,16,288
597,18,5,2025-02-14,5,41,49,8,40
921,30,26,2025-02-28,2,480,581,101,202
699,8,22,2025-02-04,12,419,546,127,1524
896,14,20,2025-02-24,5,493,724,231,1155
886,6,26,2025-02-26,6,471,582,111,666
184,24,30,2025-02-11,14,430,581,151,2114
753,26,8,2025-02-09,6,423,578,155,930
392,28,2,2025-02-28,16,133,152,19,304
941,15,12,2025-02-10,8,134,142,8,64
198,13,11,2025-02-09,3,415,488,73,219
657,17,13,2025-02-22,18,189,278,89,1602
119,29,9,2025-02-06,19,155,165,10,190
611,14,12,2025-02-24,11,243,321,78,858
524,4,13,2025-02-19,7,150,160,10,70
447,1,17,2025-02-26,18,371,510,139,2502
760,24,22,2025-02-07,12,240,260,20,240
681,30,11,2025-02-20,11,359,514,155,1705
738,29,10,2025-02-17,10,361,445,84,840
413,23,10,2025-02-18,5,118,146,28,140
963,13,22,2025-02-24,6,335,438,103,618
416,18,27,2025-02-01,10,166,190,24,240
805,19,20,2025-02-21,11,258,322,64,704
692,7,17,2025-02-16,6,357,388,31,186
528,22,21,2025-02-20,11,67,95,28,308
770,8,22,2025-02-10,8,432,492,60,480
26,2,8,2025-02-16,20,455,635,180,3600
467,14,29,2025-02-21,19,119,163,44,836
394,16,13,2025-02-08,5,355,483,128,640
915,25,28,2025-02-25,4,418,519,101,404
181,26,23,2025-02-17,15,45,59,14,210
940,28,4,2025-02-15,5,430,541,111,555
544,18,20,2025-02-11,15,333,472,139,2085
914,17,14,2025-02-27,18,248,361,113,2034
762,28,16,2025-02-15,9,404,469,65,585
653,9,25,2025-02-25,17,268,357,89,1513
282,15,3,2025-02-23,10,140,164,24,240
328,29,18,2025-02-03,5,97,112,15,75
711,5,23,2025-02-07,3,232,286,54,162
556,15,14,2025-02-02,7,446,553,107,749
927,25,19,2025-02-23,1,458,662,204,204
590,13,16,2025-02-01,12,172,239,67,804
874,29,27,2025-02-14,18,402,555,153,2754
820,20,29,2025-02-08,16,132,155,23,368
498,1,13,2025-02-11,13,390,438,48,624
479,30,5,2025-02-20,18,33,48,15,270
607,19,22,2025-02-01,3,349,434,85,255
888,15,6,2025-02-02,9,214,256,42,378
466,11,11,2025-02-25,13,162,225,63,819
852,14,9,2025-02-27,3,260,275,15,45
553,2,12,2025-02-08,3,419,620,201,603
42,25,1,2025-02-08,7,449,476,27,189
157,8,5,2025-02-16,4,308,455,147,588
477,23,9,2025-02-25,12,105,139,34,408
987,24,23,2025-02-04,6,179,197,18,108
27,30,10,2025-02-19,13,223,329,106,1378
204,3,19,2025-02-23,8,72,98,26,208
309,28,22,2025-02-20,4,427,637,210,840
802,2,12,2025-02-18,14,358,436,78,1092
519,21,11,2025-02-01,14,441,560,119,1666
444,12,21,2025-02-27,15,382,427,45,675
181,24,17,2025-02-21,9,335,474,139,1251
552,25,16,2025-02-15,14,442,610,168,2352
275,11,28,2025-02-08,3,162,234,72,216
250,25,15,2025-02-19,20,362,442,80,1600
30,16,28,2025-02-11,6,269,308,39,234
817,9,11,2025-02-09,20,379,548,169,3380
570,1,17,2025-02-07,3,143,196,53,159
501,18,25,2025-02-08,16,350,480,130,2080
459,26,1,2025-02-03,10,133,164,31,310
250,10,22,2025-02-19,12,262,340,78,936
353,14,24,2025-02-18,11,200,273,73,803
278,10,9,2025-02-08,4,389,442,53,212
123,24,18,2025-02-25,6,118,135,17,102
496,9,24,2025-02-19,17,325,383,58,986
103,27,7,2025-02-10,8,204,231,27,216
15,23,18,2025-02-05,9,43,64,21,189
567,10,23,2025-02-05,16,72,104,32,512
588,10,16,2025-02-16,15,194,220,26,390
53,9,28,2025-02-16,4,440,475,35,140
504,3,19,2025-02-21,2,97,108,11,22
577,10,3,2025-02-08,4,305,425,120,480
621,20,26,2025-02-20,8,417,536,119,952
462,30,15,2025-02-10,19,239,284,45,855
636,2,20,2025-02-24,4,410,469,59,236
217,9,22,2025-02-03,6,142,160,18,108
77,6,1,2025-02-14,15,372,490,118,1770
299,2,8,2025-02-10,10,379,545,166,1660
73,22,8,2025-02-09,19,358,505,147,2793
203,14,4,2025-02-18,8,351,392,41,328
273,27,5,2025-02-03,2,104,146,42,84
610,24,27,2025-02-19,10,244,270,26,260
706,10,23,2025-02-13,9,276,357,81,729
449,3,20,2025-02-02,14,396,473,77,1078
257,1,3,2025-02-08,19,320,473,153,2907
784,22,27,2025-02-09,19,40,56,16,304
180,16,17,2025-02-21,15,489,575,86,1290
600,14,21,2025-02-27,16,66,83,17,272
419,11,11,2025-02-22,4,459,515,56,224
422,23,16,2025-02-10,13,436,607,171,2223
38,15,3,2025-02-11,9,185,204,19,171
792,13,28,2025-02-17,1,356,513,157,157
474,14,2,2025-02-07,17,205,273,68,1156
511,21,15,2025-02-25,2,124,145,21,42
135,30,10,2025-02-15,16,82,87,5,80
646,20,26,2025-02-08,6,179,232,53,318
566,14,3,2025-02-08,4,256,378,122,488
664,27,5,2025-02-16,10,280,383,103,1030
426,27,16,2025-02-16,8,253,328,75,600
393,7,30,2025-02-20,17,402,581,179,3043
885,3,9,2025-02-25,14,194,285,91,1274
520,9,27,2025-02-01,10,391,463,72,720
602,19,22,2025-02-16,5,248,321,73,365
354,11,18,2025-02-25,18,213,267,54,972
330,28,7,2025-02-23,8,312,381,69,552
877,25,14,2025-02-02,11,401,506,105,1155
936,26,13,2025-02-13,5,273,405,132,660
130,17,19,2025-02-11,4,467,668,201,804
103,17,30,2025-02-15,1,389,434,45,45
892,21,5,2025-02-03,16,420,624,204,3264
347,20,23,2025-02-13,3,456,546,90,270
691,28,18,2025-02-13,11,340,467,127,1397
778,16,28,2025-02-18,2,336,363,27,54
647,22,30,2025-02-10,8,402,438,36,288
101,25,21,2025-02-23,4,247,278,31,124
307,29,1,2025-02-02,11,427,459,32,352
368,12,14,2025-02-05,8,291,360,69,552
699,26,6,2025-02-06,6,60,79,19,114
392,20,22,2025-02-08,16,487,639,152,2432
238,15,21,2025-02-09,15,150,203,53,795
921,26,15,2025-02-10,18,100,108,8,144
968,12,19,2025-02-10,14,373,434,61,854
866,10,7,2025-02-13,16,74,86,12,192
586,12,19,2025-02-10,10,31,46,15,150
675,13,9,2025-02-01,19,462,628,166,3154
763,2,30,2025-02-20,16,446,650,204,3264
294,25,26,2025-02-08,20,430,520,90,1800
652,7,20,2025-02-09,5,341,373,32,160
643,21,2,2025-02-10,15,37,48,11,165
750,5,3,2025-02-10,11,402,497,95,1045
206,5,26,2025-02-18,12,291,371,80,960
280,27,6,2025-02-09,16,432,511,79,1264
892,11,26,2025-02-04,15,58,65,7,105
990,8,28,2025-02-22,13,453,640,187,2431
375,3,26,2025-02-13,1,155,200,45,45
466,12,22,2025-02-24,9,319,390,71,639
654,12,4,2025-02-22,8,261,277,16,128
906,18,11,2025-02-20,8,351,379,28,224
844,15,30,2025-02-23,10,352,434,82,820
144,2,2,2025-02-10,16,79,86,7,112
909,18,5,2025-02-13,15,209,283,74,1110
761,23,18,2025-02-14,19,400,551,151,2869
907,14,21,2025-02-04,16,335,413,78,1248
975,9,2,2025-02-23,12,131,164,33,396
974,8,28,2025-02-12,4,371,451,80,320
924,21,12,2025-02-02,13,161,183,22,286
126,28,27,2025-02-15,3,359,411,52,156
655,20,1,2025-02-02,11,144,215,71,781
806,19,7,2025-02-03,18,126,166,40,720
833,28,8,2025-02-11,5,423,616,193,965
3,9,28,2025-02-05,5,296,344,48,240
179,4,22,2025-02-28,1,87,92,5,5
809,26,8,2025-02-19,11,28,32,4,44
54,5,24,2025-02-14,17,78,108,30,510
488,15,25,2025-02-12,17,323,355,32,544
516,8,20,2025-02-02,17,174,219,45,765
988,1,2,2025-02-16,13,238,323,85,1105
503,23,30,2025-02-15,3,480,521,41,123
623,5,3,2025-02-05,9,339,453,114,1026
562,23,11,2025-02-13,20,291,344,53,1060
518,20,14,2025-02-04,4,456,613,157,628
899,25,18,2025-02-24,7,240,301,61,427
234,14,11,2025-02-27,15,224,277,53,795
98,11,14,2025-02-11,9,211,312,101,909
704,30,16,2025-02-03,3,445,484,39,117
443,4,24,2025-02-24,12,435,482,47,564
62,19,18,2025-02-18,11,363,401,38,418
363,28,22,2025-02-25,14,464,678,214,2996
53,10,20,2025-02-10,12,73,96,23,276
218,5,22,2025-02-16,8,453,498,45,360
866,18,12,2025-02-04,9,313,361,48,432
440,28,18,2025-02-25,20,334,452,118,2360
571,1,20,2025-02-22,9,34,38,4,36
720,25,10,2025-02-11,12,23,26,3,36
147,19,22,2025-02-13,3,92,127,35,105
996,1,3,2025-02-24,17,130,159,29,493
465,11,6,2025-02-12,10,389,465,76,760
965,19,20,2025-02-03,2,99,111,12,24
633,2,22,2025-02-03,9,246,332,86,774
498,20,15,2025-02-14,9,130,181,51,459
117,12,14,2025-02-04,10,367,497,130,1300
499,17,22,2025-02-10,2,132,162,30,60
614,2,1,2025-02-07,10,128,179,51,510
783,9,10,2025-02-11,4,23,29,6,24
441,6,5,2025-02-13,18,380,438,58,1044
573,27,22,2025-02-26,12,56,69,13,156
760,2,14,2025-02-01,15,491,533,42,630
321,19,14,2025-02-19,13,383,512,129,1677
297,4,13,2025-02-01,11,107,151,44,484
633,15,27,2025-02-23,12,65,81,16,192
109,8,14,2025-02-19,13,288,313,25,325
892,10,24,2025-02-11,8,190,266,76,608
79,17,21,2025-02-04,17,281,320,39,663
795,12,12,2025-02-24,5,140,153,13,65
263,7,6,2025-02-20,5,409,569,160,800
78,6,25,2025-02-21,16,257,357,100,1600
779,19,15,2025-02-22,19,349,466,117,2223
640,11,28,2025-02-21,11,97,121,24,264
481,15,21,2025-02-10,9,322,346,24,216
520,3,10,2025-02-15,15,39,42,3,45
852,10,3,2025-02-21,3,334,440,106,318
394,15,19,2025-02-18,2,250,365,115,230
586,21,7,2025-02-11,20,263,335,72,1440
981,2,15,2025-02-04,11,385,419,34,374
662,6,2,2025-02-08,15,244,314,70,1050
625,6,12,2025-02-12,10,218,269,51,510
347,22,20,2025-02-02,11,53,64,11,121
572,22,13,2025-02-10,9,390,559,169,1521
988,30,20,2025-02-28,5,190,206,16,80
680,5,30,2025-02-12,10,355,484,129,1290
402,5,20,2025-02-23,3,178,232,54,162
659,26,11,2025-02-27,5,363,496,133,665
970,24,22,2025-02-17,3,350,473,123,369
521,12,1,2025-02-12,10,112,166,54,540
350,25,16,2025-02-07,8,90,101,11,88
303,28,26,2025-02-04,17,414,535,121,2057
757,29,17,2025-02-02,11,468,653,185,2035
135,20,13,2025-02-05,6,112,159,47,282
790,20,26,2025-02-06,15,42,52,10,150
693,24,8,2025-02-15,20,165,229,64,1280
803,15,8,2025-02-18,8,178,264,86,688
804,16,29,2025-02-27,7,208,282,74,518
585,15,15,2025-02-25,10,418,511,93,930
541,14,6,2025-02-27,7,430,569,139,973
894,9,2,2025-02-21,16,467,568,101,1616
957,4,23,2025-02-28,17,455,503,48,816
86,25,6,2025-02-09,15,483,619,136,2040
851,14,3,2025-02-08,15,472,570,98,1470
28,14,2,2025-02-13,17,211,244,33,561
84,12,8,2025-02-01,11,496,543,47,517
732,21,11,2025-02-26,5,90,96,6,30
940,27,16,2025-02-23,5,408,558,150,750
460,20,1,2025-02-03,1,151,173,22,22
154,18,24,2025-02-20,17,236,260,24,408
296,8,10,2025-02-04,2,142,176,34,68
813,20,15,2025-02-03,4,448,653,205,820
612,18,1,2025-02-21,17,314,364,50,850
148,10,14,2025-02-01,20,200,232,32,640
427,6,22,2025-02-22,3,288,429,141,423
70,17,18,2025-02-17,17,303,321,18,306
895,16,2,2025-02-21,13,211,246,35,455
17,12,26,2025-02-03,12,143,197,54,648
644,4,25,2025-02-19,11,88,94,6,66
560,11,27,2025-02-21,6,445,623,178,1068
476,23,16,2025-02-21,6,435,483,48,288
734,25,15,2025-02-02,10,123,132,9,90
205,29,2,2025-02-11,10,283,348,65,650
835,18,16,2025-02-09,2,405,543,138,276
293,12,28,2025-02-25,2,463,623,160,320
280,4,26,2025-02-12,14,475,584,109,1526
451,29,13,2025-02-11,6,274,373,99,594
377,30,26,2025-02-17,9,430,467,37,333
435,3,14,2025-02-20,6,299,353,54,324
106,3,11,2025-02-22,10,176,220,44,440
735,14,6,2025-02-23,15,199,249,50,750
745,28,30,2025-02-12,20,242,284,42,840
811,2,3,2025-02-22,13,206,264,58,754
768,22,6,2025-02-01,5,454,601,147,735
801,15,2,2025-02-05,3,140,196,56,168
376,12,13,2025-02-19,2,329,368,39,78
461,12,12,2025-02-15,3,313,348,35,105
376,13,11,2025-02-21,9,147,218,71,639
27,24,6,2025-02-16,17,218,319,101,1717
121,9,25,2025-02-09,15,129,193,64,960
293,23,30,2025-02-16,7,82,91,9,63
76,15,6,2025-02-23,15,64,91,27,405
991,28,11,2025-02-22,12,383,413,30,360
556,10,29,2025-02-10,6,384,526,142,852
718,21,6,2025-02-26,12,280,322,42,504
206,26,5,2025-02-08,16,33,40,7,112
587,12,15,2025-02-26,18,86,114,28,504
89,3,10,2025-02-13,16,289,357,68,1088
420,27,19,2025-02-03,5,182,244,62,310
461,15,22,2025-02-17,12,85,123,38,456
799,18,21,2025-02-19,6,413,613,200,1200
444,17,30,2025-02-28,2,445,492,47,94
157,10,6,2025-02-06,11,498,682,184,2024
355,17,29,2025-02-10,3,148,168,20,60
980,18,9,2025-02-05,10,334,431,97,970
515,21,6,2025-02-19,19,98,110,12,228
640,24,29,2025-02-20,11,451,661,210,2310
43,27,28,2025-02-01,3,43,64,21,63
790,19,9,2025-02-21,7,412,539,127,889
633,21,1,2025-02-16,18,168,225,57,1026
310,16,8,2025-02-26,13,172,216,44,572
706,2,6,2025-02-15,14,267,336,69,966
349,20,5,2025-02-11,11,395,590,195,2145
354,13,5,2025-02-25,12,283,369,86,1032
327,8,15,2025-02-04,9,250,290,40,360
100,2,10,2025-02-13,20,234,272,38,760
887,29,6,2025-02-27,11,498,652,154,1694
321,7,25,2025-02-06,16,283,357,74,1184
901,10,16,2025-02-01,3,221,282,61,183
990,8,7,2025-02-19,12,44,47,3,36
507,20,29,2025-02-27,16,166,214,48,768
868,4,14,2025-02-05,9,392,476,84,756
413,12,2,2025-02-13,2,311,405,94,188
372,18,10,2025-02-03,13,278,348,70,910
564,9,27,2025-02-20,20,80,89,9,180
100,13,12,2025-02-26,11,305,449,144,1584
774,5,7,2025-02-20,17,225,287,62,1054
47,2,5,2025-02-23,11,431,544,113,1243
468,5,20,2025-02-17,5,187,275,88,440
327,6,13,2025-02-20,10,323,388,65,650
849,17,18,2025-02-16,19,173,219,46,874
18,12,11,2025-02-22,4,233,306,73,292
816,29,24,2025-02-28,1,325,411,86,86
991,21,26,2025-02-25,19,315,363,48,912
53,19,16,2025-02-06,17,342,470,128,2176
794,27,13,2025-02-05,8,36,47,11,88
718,4,7,2025-02-01,15,180,223,43,645
423,23,7,2025-02-14,17,416,551,135,2295
483,28,28,2025-02-24,2,381,424,43,86
213,18,11,2025-02-22,16,289,352,63,1008
980,6,15,2025-02-18,11,299,362,63,693
791,28,24,2025-02-22,9,332,421,89,801
981,8,9,2025-02-18,10,135,199,64,640
305,25,10,2025-02-23,7,373,510,137,959
325,16,12,2025-02-18,9,167,185,18,162
693,18,13,2025-02-13,12,415,586,171,2052
298,2,10,2025-02-23,3,197,289,92,276
672,9,24,2025-02-16,7,123,175,52,364
278,30,18,2025-02-23,9,90,99,9,81
759,19,8,2025-02-08,2,362,528,166,332
232,21,8,2025-02-02,4,231,277,46,184
484,4,22,2025-02-25,5,22,33,11,55
952,6,14,2025-02-21,16,264,354,90,1440
775,10,11,2025-02-10,2,484,676,192,384
668,19,8,2025-02-18,2,487,713,226,452
428,29,27,2025-02-06,2,448,550,102,204
508,6,30,2025-02-24,10,468,499,31,310
306,19,20,2025-02-04,11,165,207,42,462
657,18,17,2025-02-16,5,455,581,126,630
280,7,26,2025-02-04,11,103,142,39,429
664,9,23,2025-02-06,1,397,477,80,80
303,19,22,2025-02-25,7,109,144,35,245
655,29,13,2025-02-27,14,283,339,56,784
411,22,4,2025-02-06,5,264,316,52,260
255,1,9,2025-02-13,8,248,345,97,776
977,11,10,2025-02-19,19,25,29,4,76
369,23,8,2025-02-02,4,258,307,49,196
416,22,17,2025-02-23,10,373,411,38,380
939,10,12,2025-02-20,8,132,195,63,504
490,5,15,2025-02-24,20,211,261,50,1000
563,30,16,2025-02-25,18,430,580,150,2700
224,25,8,2025-02-22,20,467,656,189,3780
539,15,17,2025-02-23,12,59,86,27,324
115,2,27,2025-02-18,17,123,161,38,646
154,6,11,2025-02-28,17,246,271,25,425
211,23,19,2025-02-16,3,480,614,134,402
829,2,15,2025-02-05,17,232,291,59,1003
60,18,15,2025-02-22,10,390,413,23,230
261,27,1,2025-02-24,7,316,342,26,182
434,12,23,2025-02-03,18,50,74,24,432
71,30,16,2025-02-02,10,229,259,30,300
139,25,21,2025-02-24,14,211,316,105,1470
392,15,28,2025-02-13,13,61,83,22,286
678,28,18,2025-02-05,12,80,90,10,120
551,13,17,2025-02-05,8,447,470,23,184
24,10,15,2025-02-22,18,237,306,69,1242
844,8,8,2025-02-15,12,99,116,17,204
960,29,24,2025-02-25,4,36,51,15,60
430,20,25,2025-02-01,8,125,135,10,80
609,2,15,2025-02-20,2,145,201,56,112
412,15,8,2025-02-18,7,406,584,178,1246
58,5,17,2025-02-10,8,437,639,202,1616
590,11,19,2025-02-20,11,141,167,26,286
147,22,17,2025-02-08,14,173,203,30,420
571,19,29,2025-02-24,6,340,461,121,726
570,16,2,2025-02-12,13,422,543,121,1573
714,14,14,2025-02-05,10,212,240,28,280
551,16,8,2025-02-28,8,173,248,75,600
148,26,15,2025-02-02,18,231,343,112,2016
571,17,5,2025-02-13,8,150,171,21,168
663,3,30,2025-02-15,12,67,86,19,228
850,7,2,2025-02-09,13,364,481,117,1521
41,28,3,2025-02-07,19,390,527,137,2603
223,16,7,2025-02-28,11,175,259,84,924
16,7,30,2025-02-07,4,402,603,201,804
491,30,8,2025-02-23,20,380,434,54,1080
938,8,18,2025-02-11,10,214,270,56,560
665,12,10,2025-02-09,12,282,408,126,1512
478,4,26,2025-02-24,16,409,584,175,2800
937,7,12,2025-02-11,14,43,56,13,182
227,24,5,2025-02-01,9,303,446,143,1287
594,24,14,2025-02-10,5,120,144,24,120
389,19,27,2025-02-08,16,301,405,104,1664
702,11,9,2025-02-25,16,390,522,132,2112
503,15,6,2025-02-24,12,106,118,12,144
560,16,6,2025-02-18,2,288,307,19,38
868,3,27,2025-02-22,2,411,433,22,44
141,27,21,2025-02-08,3,382,427,45,135
224,17,15,2025-02-12,2,336,449,113,226
957,20,30,2025-02-16,16,28,29,1,16
565,14,1,2025-02-01,17,389,457,68,1156
294,1,17,2025-02-27,14,432,636,204,2856
184,4,30,2025-02-04,17,96,111,15,255
635,17,9,2025-02-27,12,156,220,64,768
81,12,13,2025-02-15,19,144,215,71,1349
232,10,22,2025-02-27,3,354,530,176,528
666,25,2,2025-02-03,13,214,261,47,611
488,2,21,2025-02-01,6,62,79,17,102
445,21,26,2025-02-11,19,459,683,224,4256
917,17,30,2025-02-02,8,128,186,58,464
709,29,19,2025-02-16,9,43,63,20,180
701,30,9,2025-02-18,19,356,379,23,437
952,28,11,2025-02-01,7,320,357,37,259
841,23,27,2025-02-13,3,173,194,21,63
247,19,27,2025-02-28,13,366,532,166,2158
340,13,25,2025-02-24,5,424,634,210,1050
742,3,17,2025-02-24,12,47,51,4,48
238,27,3,2025-02-11,20,413,548,135,2700
610,13,25,2025-02-11,1,344,404,60,60
462,16,8,2025-02-12,18,212,264,52,936
697,19,22,2025-02-13,3,415,551,136,408
818,8,23,2025-02-03,3,157,176,19,57
729,26,21,2025-02-05,13,182,221,39,507
94,1,10,2025-02-15,12,409,479,70,840
136,3,6,2025-02-14,15,305,396,91,1365
418,4,1,2025-02-03,12,303,331,28,336
613,26,11,2025-02-28,13,26,31,5,65
398,25,3,2025-02-24,18,483,723,240,4320
249,19,17,2025-02-06,13,106,118,12,156
309,9,16,2025-02-05,3,105,131,26,78
432,10,16,2025-02-26,3,204,237,33,99
253,24,21,2025-02-16,20,335,381,46,920
110,5,10,2025-02-01,13,190,271,81,1053
390,26,28,2025-02-11,15,191,238,47,705
844,28,21,2025-02-20,5,173,207,34,170
971,23,7,2025-02-16,11,110,163,53,583
992,11,10,2025-02-24,16,314,440,126,2016
334,13,9,2025-02-27,13,206,227,21,273
578,7,19,2025-02-18,6,369,515,146,876
28,24,15,2025-02-23,7,244,344,100,700
852,23,3,2025-02-27,14,364,464,100,1400
649,10,8,2025-02-09,5,386,479,93,465
387,3,15,2025-02-20,16,318,391,73,1168
519,30,30,2025-02-28,14,298,318,20,280
992,12,23,2025-02-26,18,324,433,109,1962
88,4,25,2025-02-08,12,105,141,36,432
46,19,21,2025-02-22,13,405,486,81,1053
816,14,4,2025-02-01,4,152,175,23,92
765,17,18,2025-02-19,19,133,166,33,627
401,15,25,2025-02-22,19,373,476,103,1957
354,1,16,2025-02-04,10,232,340,108,1080
88,4,27,2025-02-24,5,198,236,38,190
467,26,7,2025-02-17,16,198,250,52,832
449,24,23,2025-02-15,11,54,64,10,110
830,23,4,2025-02-01,11,351,386,35,385
820,6,30,2025-02-24,8,284,320,36,288
164,11,18,2025-02-14,15,138,194,56,840
645,6,6,2025-02-21,14,222,236,14,196
629,29,7,2025-02-15,19,239,293,54,1026
722,7,7,2025-02-09,3,315,345,30,90
893,18,6,2025-02-12,11,120,151,31,341
269,22,28,2025-02-16,17,347,413,66,1122
398,20,13,2025-02-19,4,198,239,41,164
469,20,6,2025-02-27,10,490,650,160,1600
87,22,5,2025-02-11,4,142,169,27,108
188,12,23,2025-02-05,17,218,270,52,884
142,19,13,2025-02-14,6,269,359,90,540
711,30,21,2025-02-06,18,105,133,28,504
144,6,11,2025-02-27,15,337,362,25,375
368,1,16,2025-02-05,7,437,534,97,679
576,17,21,2025-02-16,14,370,470,100,1400
728,27,15,2025-02-16,6,62,81,19,114
815,25,8,2025-02-10,2,160,184,24,48
296,6,25,2025-02-15,19,400,559,159,3021
508,18,17,2025-02-04,19,78,91,13,247
557,27,12,2025-02-18,2,409,562,153,306
560,7,14,2025-02-04,8,172,248,76,608
34,15,9,2025-02-12,3,244,351,107,321
121,25,26,2025-02-08,7,435,601,166,1162
706,12,28,2025-02-23,20,343,426,83,1660
631,5,26,2025-02-07,7,432,465,33,231
360,18,9,2025-02-20,18,106,127,21,378
721,10,10,2025-02-19,9,459,588,129,1161
922,22,27,2025-02-04,5,404,567,163,815
941,2,9,2025-02-28,5,379,546,167,835
256,5,23,2025-02-11,8,409,585,176,1408
403,16,5,2025-02-19,9,341,422,81,729
463,3,21,2025-02-26,3,226,290,64,192
285,23,30,2025-02-12,15,269,322,53,795
3,28,25,2025-02-28,3,394,586,192,576
651,22,23,2025-02-12,3,427,551,124,372
224,14,27,2025-02-07,16,157,188,31,496
291,11,18,2025-02-19,5,309,443,134,670
808,11,29,2025-02-22,2,43,47,4,8
803,27,15,2025-02-01,4,495,711,216,864
452,15,1,2025-02-14,7,372,543,171,1197
904,21,10,2025-02-06,9,67,90,23,207
257,3,12,2025-02-22,6,46,57,11,66
313,24,23,2025-02-25,8,239,321,82,656
721,4,1,2025-02-07,16,59,65,6,96
232,17,22,2025-02-15,1,24,33,9,9
837,4,28,2025-02-14,5,264,286,22,110
393,3,24,2025-02-26,4,72,86,14,56
903,10,5,2025-02-13,5,348,521,173,865
147,3,17,2025-02-19,1,332,446,114,114
451,12,24,2025-02-07,5,490,605,115,575
704,15,28,2025-02-07,3,479,525,46,138
771,4,19,2025-02-24,13,199,295,96,1248
323,26,5,2025-02-08,9,350,381,31,279
567,20,20,2025-02-24,20,165,231,66,1320
708,1,28,2025-02-28,10,125,160,35,350
522,7,24,2025-02-13,10,350,376,26,260
920,26,8,2025-02-16,13,77,89,12,156
654,20,3,2025-02-17,1,204,300,96,96
136,13,28,2025-02-27,19,235,285,50,950
700,6,25,2025-02-16,3,28,37,9,27
15,9,7,2025-02-02,2,424,521,97,194
294,21,23,2025-02-17,14,236,322,86,1204
85,21,18,2025-02-18,20,98,115,17,340
318,3,17,2025-02-07,5,294,352,58,290
601,21,25,2025-02-27,3,178,243,65,195
748,28,8,2025-02-02,8,64,94,30,240
119,15,20,2025-02-20,2,178,240,62,124
674,24,6,2025-02-04,1,382,425,43,43
12,6,16,2025-02-12,17,284,398,114,1938
739,9,6,2025-02-12,5,403,565,162,810
276,24,29,2025-02-04,1,191,270,79,79
279,17,3,2025-02-09,19,341,370,29,551
467,17,12,2025-02-02,16,459,599,140,2240
377,6,9,2025-02-25,4,477,624,147,588
741,4,8,2025-02-24,17,21,22,1,17
884,1,8,2025-02-02,16,206,252,46,736
154,6,30,2025-02-28,2,303,428,125,250
732,24,21,2025-02-14,8,184,214,30,240
938,24,11,2025-02-09,3,312,380,68,204
515,22,29,2025-02-02,6,134,189,55,330
48,13,3,2025-02-15,10,416,595,179,1790
336,3,18,2025-02-15,1,208,237,29,29
578,26,10,2025-02-24,20,144,181,37,740
606,16,25,2025-02-25,7,395,575,180,1260
779,26,8,2025-02-05,1,497,614,117,117
239,18,12,2025-02-21,1,191,201,10,10
674,13,28,2025-02-24,10,73,83,10,100
244,14,16,2025-02-02,5,384,452,68,340
45,30,8,2025-02-28,17,231,315,84,1428
382,15,24,2025-02-03,19,68,87,19,361
653,27,13,2025-02-03,19,310,334,24,456
679,5,8,2025-02-10,9,455,542,87,783
821,13,23,2025-02-27,11,182,228,46,506
240,3,7,2025-02-05,19,75,84,9,171
169,15,15,2025-02-11,14,81,105,24,336
988,25,7,2025-02-15,10,257,300,43,430
123,3,6,2025-02-26,10,443,606,163,1630
618,2,7,2025-02-27,11,95,104,9,99
255,12,13,2025-02-17,2,366,434,68,136
840,6,1,2025-02-13,15,304,422,118,1770
256,4,15,2025-02-04,5,82,87,5,25
851,25,8,2025-02-05,7,441,543,102,714
703,21,21,2025-02-03,19,320,373,53,1007
833,3,1,2025-02-03,7,482,646,164,1148
829,5,3,2025-02-28,11,82,88,6,66
473,2,6,2025-02-19,14,440,605,165,2310
509,1,13,2025-02-22,14,108,131,23,322
931,6,9,2025-02-09,15,472,527,55,825
629,20,20,2025-02-08,10,275,340,65,650
564,16,2,2025-02-03,9,216,240,24,216
205,21,29,2025-02-26,17,147,196,49,833
822,18,26,2025-02-01,13,420,576,156,2028
492,18,26,2025-02-16,12,487,635,148,1776
330,13,9,2025-02-06,1,183,241,58,58
31,29,26,2025-02-25,9,49,69,20,180
484,17,12,2025-02-25,19,139,207,68,1292
103,8,22,2025-02-08,9,293,415,122,1098
940,24,2,2025-02-25,8,314,449,135,1080
817,13,12,2025-02-27,6,110,127,17,102
326,26,24,2025-02-23,12,487,641,154,1848
721,23,12,2025-02-19,19,92,120,28,532
193,27,26,2025-02-16,18,178,201,23,414
39,3,2,2025-02-08,20,132,140,8,160
490,1,11,2025-02-20,7,432,479,47,329
735,6,30,2025-02-26,11,50,53,3,33
601,23,30,2025-02-05,4,453,583,130,520
374,3,12,2025-02-23,13,320,351,31,403
310,11,5,2025-02-06,14,425,569,144,2016
499,21,11,2025-02-06,18,375,544,169,3042
629,26,12,2025-02-08,19,437,493,56,1064
315,24,23,2025-02-10,5,110,152,42,210
972,23,19,2025-02-13,19,36,41,5,95
326,30,26,2025-02-20,8,347,453,106,848
960,16,5,2025-02-11,3,141,170,29,87
328,6,21,2025-02-03,11,248,262,14,154
215,8,23,2025-02-03,12,151,212,61,732
738,1,2,2025-02-13,15,395,489,94,1410
171,29,14,2025-02-16,13,199,258,59,767
104,27,16,2025-02-26,19,353,491,138,2622
231,6,15,2025-02-03,2,170,180,10,20
268,4,3,2025-02-11,6,474,578,104,624
750,3,18,2025-02-03,11,324,484,160,1760
915,16,23,2025-02-01,14,354,398,44,616
912,14,6,2025-02-02,4,189,216,27,108
195,14,23,2025-02-18,18,155,209,54,972
305,8,4,2025-02-02,13,312,405,93,1209
503,5,2,2025-02-12,1,238,259,21,21
844,22,21,2025-02-20,16,122,133,11,176
212,6,21,2025-02-10,3,262,375,113,339
316,26,13,2025-02-16,16,478,644,166,2656
94,21,18,2025-02-13,6,209,303,94,564
379,6,15,2025-02-02,9,245,309,64,576
232,27,9,2025-02-19,2,97,135,38,76
684,4,3,2025-02-22,12,433,560,127,1524
995,25,19,2025-02-08,18,51,73,22,396
839,17,14,2025-02-18,16,313,453,140,2240
488,10,3,2025-02-13,2,277,362,85,170
530,26,19,2025-02-22,20,95,105,10,200
776,15,6,2025-02-06,7,433,492,59,413
44,14,3,2025-02-22,14,123,184,61,854
643,5,27,2025-02-20,9,183,267,84,756
937,26,3,2025-02-03,13,304,374,70,910
334,28,9,2025-02-17,15,489,706,217,3255
806,23,20,2025-02-19,17,420,520,100,1700
425,5,5,2025-02-19,19,318,442,124,2356
963,4,30,2025-02-04,19,419,459,40,760
293,28,18,2025-02-12,14,155,189,34,476
498,19,20,2025-02-16,2,108,127,19,38
148,20,20,2025-02-22,13,39,48,9,117
901,11,23,2025-02-08,2,401,507,106,212
276,29,12,2025-02-01,11,438,616,178,1958
319,9,27,2025-02-16,4,464,535,71,284
308,24,15,2025-02-25,11,157,216,59,649
620,21,3,2025-02-07,15,128,187,59,885
417,24,16,2025-02-25,17,464,565,101,1717
58,17,26,2025-02-06,3,179,245,66,198
414,5,25,2025-02-28,17,470,614,144,2448
178,7,29,2025-02-27,7,448,482,34,238
34,15,2,2025-02-12,7,160,195,35,245
476,17,13,2025-02-21,4,368,391,23,92
382,16,20,2025-02-15,6,465,588,123,738
565,12,12,2025-02-06,9,403,574,171,1539
93,10,1,2025-02-13,2,103,148,45,90
799,7,28,2025-02-08,8,366,418,52,416
668,14,17,2025-02-01,1,262,383,121,121
663,6,20,2025-02-26,1,134,156,22,22
825,10,23,2025-02-23,9,236,343,107,963
873,12,15,2025-02-09,7,258,306,48,336
534,27,20,2025-02-13,19,72,76,4,76
679,27,27,2025-02-12,18,351,462,111,1998
290,10,22,2025-02-04,16,52,62,10,160
284,21,11,2025-02-28,9,153,206,53,477
976,29,21,2025-02-10,7,96,123,27,189
247,29,2,2025-02-26,20,226,304,78,1560
698,5,24,2025-02-01,16,171,200,29,464
429,13,13,2025-02-24,2,318,435,117,234
586,27,7,2025-02-11,8,371,479,108,864
804,16,30,2025-02-22,12,279,331,52,624
175,27,22,2025-02-18,6,170,186,16,96
132,24,9,2025-02-24,18,410,599,189,3402
970,22,29,2025-02-11,3,133,161,28,84
763,28,10,2025-02-14,11,210,245,35,385
302,15,28,2025-02-04,16,47,68,21,336
598,19,20,2025-02-03,16,475,540,65,1040
123,28,22,2025-02-13,17,172,213,41,697
892,28,5,2025-02-05,7,195,241,46,322
584,29,30,2025-02-15,5,181,260,79,395
185,25,3,2025-02-16,11,343,512,169,1859
321,21,2,2025-02-01,15,160,183,23,345
793,6,19,2025-02-25,6,270,379,109,654
799,3,5,2025-02-20,14,344,428,84,1176
440,16,13,2025-02-01,2,293,334,41,82
383,1,29,2025-02-11,17,117,124,7,119
5,21,24,2025-02-08,8,375,542,167,1336
320,5,4,2025-02-13,17,321,381,60,1020
67,27,2,2025-02-10,10,253,349,96,960
611,17,11,2025-02-14,5,195,292,97,485
502,12,25,2025-02-07,6,484,708,224,1344
414,1,8,2025-02-08,5,128,177,49,245
604,17,6,2025-02-04,12,384,516,132,1584
39,13,29,2025-02-21,9,414,534,120,1080
50,20,2,2025-02-22,4,354,505,151,604
50,23,4,2025-02-14,15,214,237,23,345
259,16,23,2025-02-05,7,375,509,134,938
10,10,14,2025-02-22,4,359,461,102,408
638,20,23,2025-02-05,14,445,647,202,2828
524,24,20,2025-02-04,10,78,109,31,310
510,7,20,2025-02-07,9,445,572,127,1143
207,12,23,2025-02-14,10,102,109,7,70
509,30,7,2025-02-23,16,189,218,29,464
14,22,3,2025-02-04,19,362,461,99,1881
973,3,25,2025-02-17,3,390,536,146,438
927,9,21,2025-02-08,15,171,200,29,435
52,4,27,2025-02-06,2,456,538,82,164
821,22,11,2025-02-14,4,68,97,29,116
912,2,1,2025-02-28,5,359,482,123,615
337,12,29,2025-02-15,20,157,227,70,1400
96,12,27,2025-02-11,6,78,96,18,108
986,15,9,2025-02-27,13,373,534,161,2093
820,14,21,2025-02-26,6,77,85,8,48
744,2,28,2025-02-06,4,233,340,107,428
495,26,19,2025-02-22,15,112,148,36,540
798,12,20,2025-02-01,5,267,391,124,620
116,29,14,2025-02-15,2,52,61,9,18
322,1,23,2025-02-28,17,412,570,158,2686
742,19,8,2025-02-22,11,285,366,81,891
718,20,4,2025-02-14,8,266,321,55,440
693,21,13,2025-02-05,18,476,711,235,4230
56,1,21,2025-02-06,17,454,573,119,2023
508,28,6,2025-02-03,16,184,213,29,464
994,9,2,2025-02-17,8,301,403,102,816
413,27,8,2025-02-03,15,247,348,101,1515
459,3,28,2025-02-16,15,181,200,19,285
510,24,21,2025-02-01,4,226,279,53,212
571,18,1,2025-02-27,3,425,562,137,411
634,21,10,2025-02-17,18,125,168,43,774
468,11,12,2025-02-27,2,438,504,66,132
466,11,18,2025-02-25,20,327,413,86,1720
673,12,23,2025-02-15,4,69,96,27,108
228,1,11,2025-02-12,10,300,385,85,850
719,4,2,2025-02-06,16,91,129,38,608
761,24,14,2025-02-04,9,332,378,46,414
124,30,28,2025-02-13,7,254,361,107,749
196,23,11,2025-02-04,14,43,63,20,280
858,22,19,2025-02-04,15,254,342,88,1320
980,17,5,2025-02-16,1,291,402,111,111
567,30,14,2025-02-27,19,267,391,124,2356
800,30,30,2025-02-06,19,108,149,41,779
132,4,13,2025-02-22,20,330,478,148,2960
517,29,13,2025-02-14,20,488,664,176,3520
255,9,13,2025-02-11,10,251,354,103,1030
142,14,20,2025-02-23,17,173,247,74,1258
561,28,11,2025-02-23,18,343,394,51,918
215,20,23,2025-02-10,12,491,664,173,2076
728,21,6,2025-02-17,18,375,501,126,2268
728,4,25,2025-02-12,18,265,348,83,1494
966,22,23,2025-02-14,18,166,240,74,1332
433,26,1,2025-02-17,4,32,39,7,28
55,22,2,2025-02-07,9,404,567,163,1467
294,22,9,2025-02-05,2,373,523,150,300
209,25,18,2025-02-02,12,436,547,111,1332
631,28,22,2025-02-24,18,462,532,70,1260
663,18,13,2025-02-08,17,421,593,172,2924
713,10,23,2025-02-22,2,494,604,110,220
427,26,22,2025-02-11,18,47,50,3,54
258,7,20,2025-02-28,15,444,511,67,1005
649,23,23,2025-02-21,12,406,534,128,1536
757,20,7,2025-02-25,7,170,213,43,301
700,3,6,2025-02-06,17,81,99,18,306
439,9,18,2025-02-09,5,102,134,32,160
262,1,11,2025-02-15,5,40,45,5,25
331,20,2,2025-02-25,20,451,608,157,3140
503,26,19,2025-02-18,12,57,80,23,276
326,17,8,2025-02-06,17,54,76,22,374
164,14,18,2025-02-18,13,67,81,14,182
905,7,22,2025-02-11,11,204,241,37,407
974,25,20,2025-02-17,16,307,436,129,2064
665,1,4,2025-02-22,12,248,287,39,468
658,20,30,2025-02-20,8,40,54,14,112
329,13,30,2025-02-26,4,217,253,36,144
742,10,1,2025-02-17,12,283,399,116,1392
457,16,2,2025-02-10,7,184,236,52,364
971,4,6,2025-02-25,18,293,309,16,288
68,7,22,2025-02-21,7,462,628,166,1162
856,4,7,2025-02-18,14,351,498,147,2058
74,24,22,2025-02-05,1,255,350,95,95
39,3,3,2025-02-02,6,426,496,70,420
73,19,27,2025-02-08,9,228,279,51,459
646,13,14,2025-02-11,1,219,296,77,77
548,1,21,2025-02-24,20,52,72,20,400
600,2,23,2025-02-28,3,203,298,95,285
109,10,26,2025-02-22,10,330,359,29,290
784,30,15,2025-02-13,13,440,593,153,1989
486,6,18,2025-02-08,5,402,493,91,455
817,28,18,2025-02-10,5,172,233,61,305
937,26,28,2025-02-24,12,25,32,7,84
569,5,4,2025-02-02,1,313,413,100,100
551,18,3,2025-02-10,7,403,558,155,1085
744,12,7,2025-02-14,17,92,103,11,187
227,20,27,2025-02-09,7,78,88,10,70
819,19,28,2025-02-02,18,256,343,87,1566
75,10,22,2025-02-03,9,70,80,10,90
595,16,11,2025-02-12,5,363,488,125,625
103,10,20,2025-02-03,7,182,231,49,343
337,20,22,2025-02-10,19,98,128,30,570
374,26,11,2025-02-14,6,22,26,4,24
805,8,23,2025-02-24,14,161,230,69,966
138,22,24,2025-02-11,16,256,320,64,1024
794,10,16,2025-02-18,4,109,146,37,148
84,27,9,2025-02-28,5,476,615,139,695
270,24,29,2025-02-21,3,392,425,33,99
20,28,17,2025-02-21,1,436,572,136,136
415,25,19,2025-02-07,2,302,353,51,102
916,18,16,2025-02-21,5,207,254,47,235
913,25,19,2025-02-24,10,88,111,23,230
523,3,13,2025-02-12,17,25,34,9,153
869,26,20,2025-02-22,6,407,522,115,690
457,6,6,2025-02-19,19,357,515,158,3002
150,24,24,2025-02-16,12,40,46,6,72
500,8,3,2025-02-09,12,139,149,10,120
212,17,30,2025-02-26,12,218,275,57,684
466,29,2,2025-02-02,11,72,98,26,286
534,21,27,2025-02-09,9,316,409,93,837
179,13,21,2025-02-13,12,320,430,110,1320
856,3,17,2025-02-09,13,484,557,73,949
416,12,27,2025-02-28,12,269,378,109,1308
909,20,1,2025-02-17,5,245,276,31,155
79,17,21,2025-02-09,7,96,109,13,91
371,20,23,2025-02-27,4,358,413,55,220
831,11,24,2025-02-04,16,365,462,97,1552
216,19,6,2025-02-21,14,31,36,5,70
131,19,19,2025-02-06,5,342,438,96,480
913,19,5,2025-02-02,6,152,223,71,426
530,13,20,2025-02-19,1,469,644,175,175
678,27,10,2025-02-03,7,249,329,80,560
483,28,16,2025-02-06,8,445,550,105,840
147,26,19,2025-02-27,6,339,457,118,708
271,6,24,2025-02-22,11,492,617,125,1375
605,3,8,2025-02-13,13,87,96,9,117
208,17,28,2025-02-17,14,443,495,52,728
99,6,16,2025-02-20,20,39,56,17,340
545,17,25,2025-02-04,3,266,358,92,276
924,20,18,2025-02-27,1,479,705,226,226
695,21,14,2025-02-17,14,209,302,93,1302
715,17,14,2025-02-08,16,424,592,168,2688
359,19,26,2025-02-24,19,70,87,17,323
261,16,25,2025-02-08,3,165,218,53,159
557,14,9,2025-02-07,1,383,530,147,147
8,19,17,2025-02-04,17,23,28,5,85
211,23,26,2025-02-11,14,205,225,20,280
437,21,19,2025-02-09,9,457,590,133,1197
579,12,20,2025-02-09,13,406,464,58,754
566,26,18,2025-02-16,6,209,272,63,378
496,9,10,2025-02-19,12,416,569,153,1836
754,5,28,2025-02-28,4,402,464,62,248
802,23,6,2025-02-04,7,280,344,64,448
347,26,18,2025-02-20,2,102,125,23,46
652,1,26,2025-02-03,5,261,383,122,610
446,3,3,2025-02-09,8,209,227,18,144
39,24,13,2025-02-13,20,355,456,101,2020
729,20,2,2025-02-25,6,347,442,95,570
11,7,28,2025-02-22,17,166,189,23,391
803,20,17,2025-02-17,8,334,376,42,336
37,12,8,2025-02-21,1,100,109,9,9
283,25,13,2025-02-12,13,227,298,71,923
531,1,24,2025-02-23,3,490,534,44,132
292,24,27,2025-02-18,19,198,239,41,779
836,9,8,2025-02-20,7,252,370,118,826
589,1,9,2025-02-06,14,279,306,27,378
75,17,10,2025-02-11,4,431,552,121,484
264,29,18,2025-02-27,19,148,202,54,1026
990,13,19,2025-02-16,8,407,490,83,664
795,15,22,2025-02-15,19,461,490,29,551
120,9,3,2025-02-13,8,366,500,134,1072
820,11,14,2025-02-12,17,294,310,16,272
853,9,8,2025-02-10,3,224,303,79,237
841,11,3,2025-02-18,6,263,313,50,300
224,29,19,2025-02-09,6,402,546,144,864
932,7,16,2025-02-24,7,140,193,53,371
894,9,7,2025-02-08,7,447,520,73,511
634,12,5,2025-02-25,4,81,119,38,152
693,22,16,2025-02-20,1,411,590,179,179
981,2,28,2025-02-16,12,337,402,65,780
920,29,29,2025-02-19,9,271,307,36,324
783,30,17,2025-02-09,13,133,185,52,676
132,2,17,2025-02-26,14,264,389,125,1750
34,17,12,2025-02-13,6,254,378,124,744
716,17,15,2025-02-11,1,26,35,9,9
389,19,4,2025-02-11,12,333,479,146,1752
192,18,9,2025-02-08,9,261,387,126,1134
352,12,6,2025-02-16,14,127,157,30,420
771,12,12,2025-02-28,13,163,204,41,533
586,5,19,2025-02-22,8,436,477,41,328
277,26,8,2025-02-18,14,458,559,101,1414
150,26,24,2025-02-05,16,432,455,23,368
432,16,5,2025-02-28,17,293,403,110,1870
805,16,10,2025-02-09,18,459,599,140,2520
408,4,23,2025-02-06,2,130,184,54,108
488,27,21,2025-02-04,15,401,481,80,1200
370,12,18,2025-02-18,9,196,208,12,108
125,12,28,2025-02-22,20,121,158,37,740
666,21,18,2025-02-06,10,201,240,39,390
523,16,25,2025-02-24,15,475,516,41,615
629,10,15,2025-02-21,5,464,522,58,290
828,30,11,2025-02-14,20,312,384,72,1440
929,3,3,2025-02-06,11,136,162,26,286
669,10,23,2025-02-09,20,350,430,80,1600
909,15,25,2025-02-28,12,402,528,126,1512
989,15,14,2025-02-06,6,457,485,28,168
746,8,22,2025-02-09,3,127,143,16,48
106,4,3,2025-02-16,18,47,50,3,54
407,17,25,2025-02-03,4,154,205,51,204
87,21,30,2025-02-13,10,137,159,22,220
291,15,21,2025-02-05,5,289,412,123,615
30,2,22,2025-02-12,11,462,584,122,1342
999,28,18,2025-02-09,18,247,274,27,486
972,23,18,2025-02-06,19,325,408,83,1577
767,21,29,2025-02-19,14,288,385,97,1358
547,10,30,2025-02-12,16,296,341,45,720
92,15,10,2025-02-12,14,153,171,18,252
11,1,17,2025-02-27,5,196,231,35,175
548,1,23,2025-02-16,16,173,182,9,144
441,26,10,2025-02-20,8,427,450,23,184
383,7,14,2025-02-18,14,222,258,36,504
733,24,21,2025-02-13,13,132,154,22,286
433,21,8,2025-02-17,20,433,590,157,3140
279,10,21,2025-02-24,18,434,508,74,1332
193,28,3,2025-02-06,5,168,185,17,85
467,20,15,2025-02-09,20,271,307,36,720
20,5,2,2025-02-18,1,115,171,56,56
289,9,5,2025-02-23,15,392,413,21,315
93,5,1,2025-02-16,7,195,242,47,329
805,26,16,2025-02-12,15,376,529,153,2295
339,3,27,2025-02-25,5,48,56,8,40
402,3,18,2025-02-16,6,118,171,53,318
257,27,13,2025-02-27,1,82,122,40,40
732,8,13,2025-02-25,15,146,202,56,840
35,7,15,2025-02-24,4,286,386,100,400
214,16,13,2025-02-22,10,499,596,97,970
645,24,2,2025-02-24,18,286,316,30,540
493,21,10,2025-02-07,12,474,509,35,420
683,7,4,2025-02-08,14,186,197,11,154
814,9,19,2025-02-04,13,424,492,68,884
993,2,19,2025-02-26,16,372,490,118,1888
381,25,3,2025-02-08,6,275,300,25,150
634,11,30,2025-02-25,2,50,60,10,20
158,23,18,2025-02-26,4,84,107,23,92
325,18,26,2025-02-21,12,432,627,195,2340
751,7,1,2025-02-23,13,203,279,76,988
257,29,2,2025-02-16,15,306,362,56,840
714,16,7,2025-02-19,6,298,360,62,372
750,15,9,2025-02-28,20,488,701,213,4260
165,3,17,2025-02-05,15,171,243,72,1080
555,12,15,2025-02-01,17,214,295,81,1377
905,1,20,2025-02-28,12,417,554,137,1644
329,24,3,2025-02-22,18,439,537,98,1764
537,22,16,2025-02-25,18,98,130,32,576
331,14,21,2025-02-11,4,69,89,20,80
69,2,27,2025-02-05,6,467,497,30,180
110,16,7,2025-02-04,2,312,418,106,212
398,22,16,2025-02-17,20,379,499,120,2400
51,12,8,2025-02-20,3,26,38,12,36
214,21,16,2025-02-27,3,259,365,106,318
63,12,18,2025-02-24,14,440,535,95,1330
726,2,27,2025-02-20,9,290,310,20,180
73,27,10,2025-02-03,7,285,312,27,189
743,8,18,2025-02-13,7,118,152,34,238
255,19,21,2025-02-06,18,403,524,121,2178
765,4,25,2025-02-21,19,203,275,72,1368
720,22,14,2025-02-04,6,425,481,56,336
412,17,11,2025-02-22,6,293,439,146,876
454,30,12,2025-02-11,18,186,266,80,1440
423,25,21,2025-02-14,11,331,383,52,572
559,7,13,2025-02-25,18,494,684,190,3420
369,15,15,2025-02-13,1,391,417,26,26
292,20,1,2025-02-17,5,475,563,88,440
308,8,7,2025-02-28,11,31,43,12,132
966,23,27,2025-02-09,18,281,365,84,1512
949,19,5,2025-02-04,2,255,309,54,108
142,9,12,2025-02-19,8,139,162,23,184
308,3,19,2025-02-13,19,489,561,72,1368
80,24,11,2025-02-26,16,108,137,29,464
921,23,23,2025-02-19,4,324,434,110,440
39,24,26,2025-02-19,13,60,84,24,312
944,25,11,2025-02-12,14,233,342,109,1526
124,28,25,2025-02-08,20,495,522,27,540
797,21,13,2025-02-02,10,288,308,20,200
553,19,5,2025-02-11,17,377,433,56,952
52,22,24,2025-02-13,15,405,534,129,1935
517,3,8,2025-02-14,10,422,518,96,960
136,11,3,2025-02-16,19,401,430,29,551
409,9,3,2025-02-13,17,242,338,96,1632
134,25,5,2025-02-16,18,121,154,33,594
668,19,7,2025-02-18,20,396,509,113,2260
249,3,9,2025-02-25,14,185,251,66,924
590,3,4,2025-02-22,14,236,287,51,714
196,11,12,2025-02-20,1,414,491,77,77
359,20,27,2025-02-26,15,339,378,39,585
46,30,27,2025-02-08,7,370,451,81,567
776,24,28,2025-02-03,4,398,428,30,120
972,20,30,2025-02-05,10,27,33,6,60
824,4,10,2025-02-15,16,31,37,6,96
758,18,7,2025-02-07,18,287,398,111,1998
562,16,20,2025-02-24,5,375,512,137,685
19,13,19,2025-02-22,17,42,49,7,119
62,10,7,2025-02-26,20,158,170,12,240
671,1,3,2025-02-13,9,359,515,156,1404
676,12,28,2025-02-04,1,169,243,74,74
665,13,8,2025-02-13,17,383,419,36,612
324,16,28,2025-02-20,18,65,74,9,162
513,15,18,2025-02-23,1,40,46,6,6
543,10,11,2025-02-16,13,401,449,48,624
356,22,12,2025-02-12,10,140,210,70,700
514,9,26,2025-02-02,9,469,574,105,945
835,1,18,2025-02-09,8,97,117,20,160
403,22,5,2025-02-03,13,286,424,138,1794
628,28,21,2025-02-22,8,233,270,37,296
157,14,10,2025-02-20,11,249,322,73,803
212,21,5,2025-02-19,18,370,522,152,2736
884,5,10,2025-02-23,17,485,539,54,918
931,25,5,2025-02-21,19,489,548,59,1121
70,18,18,2025-02-24,4,114,136,22,88
901,5,24,2025-02-01,11,470,699,229,2519
985,14,10,2025-02-15,9,97,136,39,351
110,5,6,2025-02-01,20,335,392,57,1140
581,20,8,2025-02-20,8,138,188,50,400
368,3,23,2025-02-25,16,88,112,24,384
620,16,23,2025-02-21,12,114,163,49,588
504,16,5,2025-02-06,7,135,144,9,63
783,1,30,2025-02-09,14,133,184,51,714
208,25,7,2025-02-03,6,494,731,237,1422
450,28,20,2025-02-16,11,463,581,118,1298
253,14,13,2025-02-25,2,331,457,126,252
390,24,11,2025-02-13,20,500,692,192,3840
609,18,17,2025-02-21,2,286,314,28,56
468,27,29,2025-02-02,8,285,368,83,664
753,2,18,2025-02-13,17,411,548,137,2329
51,7,10,2025-02-15,13,472,560,88,1144
848,10,15,2025-02-06,14,170,225,55,770
56,23,17,2025-02-05,15,444,595,151,2265
93,24,17,2025-02-04,6,418,549,131,786
916,23,18,2025-02-05,13,231,276,45,585
26,6,15,2025-02-19,7,471,591,120,840
257,11,23,2025-02-21,6,387,534,147,882
94,4,23,2025-02-15,12,63,81,18,216
394,24,26,2025-02-17,20,101,123,22,440
390,2,25,2025-02-06,11,309,446,137,1507
884,5,6,2025-02-28,5,111,155,44,220
53,14,10,2025-02-10,15,167,222,55,825
121,29,5,2025-02-07,1,338,471,133,133
13,15,16,2025-02-28,16,298,421,123,1968
623,29,16,2025-02-08,7,321,432,111,777
465,14,15,2025-02-03,20,327,344,17,340
904,18,9,2025-02-20,18,439,624,185,3330
51,6,5,2025-02-02,12,38,42,4,48
34,22,19,2025-02-27,20,172,206,34,680
90,2,4,2025-02-14,6,102,138,36,216
626,22,23,2025-02-23,20,313,440,127,2540
182,15,24,2025-02-19,12,496,529,33,396
787,10,11,2025-02-12,13,439,474,35,455
438,27,18,2025-02-03,10,261,290,29,290
712,28,9,2025-02-11,17,231,297,66,1122
713,7,20,2025-02-02,4,312,430,118,472
645,17,3,2025-02-16,20,498,700,202,4040
724,10,14,2025-02-20,11,152,196,44,484
639,12,30,2025-02-05,20,308,392,84,1680
747,21,16,2025-02-16,6,472,625,153,918
726,10,7,2025-02-01,4,32,40,8,32
816,4,24,2025-02-28,7,429,569,140,980
425,14,2,2025-02-11,12,306,432,126,1512
218,1,21,2025-02-07,10,150,211,61,610
316,10,17,2025-02-18,11,412,434,22,242
703,11,11,2025-02-13,19,335,496,161,3059
853,6,7,2025-02-11,11,492,665,173,1903
939,16,26,2025-02-02,5,266,298,32,160
472,29,28,2025-02-18,11,256,359,103,1133
424,30,24,2025-02-02,17,173,226,53,901
695,11,18,2025-02-18,1,126,165,39,39
340,26,30,2025-02-26,12,53,79,26,312
288,27,1,2025-02-11,13,340,439,99,1287
170,19,20,2025-02-13,6,324,357,33,198
802,25,10,2025-02-23,11,383,408,25,275
424,3,16,2025-02-08,12,251,357,106,1272
310,7,17,2025-02-10,6,77,94,17,102
39,25,7,2025-02-03,15,279,296,17,255
495,29,17,2025-02-05,7,194,284,90,630
751,28,17,2025-02-10,11,93,130,37,407
101,27,17,2025-02-22,5,125,172,47,235
471,13,23,2025-02-28,17,79,83,4,68
955,2,22,2025-02-28,20,466,508,42,840
479,29,2,2025-02-04,17,412,555,143,2431
320,1,19,2025-02-25,10,347,504,157,1570
329,7,7,2025-02-10,9,292,349,57,513
452,22,4,2025-02-09,5,100,117,17,85
16,20,18,2025-02-17,4,125,162,37,148
563,11,9,2025-02-05,10,313,363,50,500
73,10,20,2025-02-11,18,247,265,18,324
30,16,29,2025-02-22,2,74,90,16,32
89,14,13,2025-02-06,20,476,627,151,3020
857,23,23,2025-02-15,20,202,241,39,780
838,7,23,2025-02-25,18,60,89,29,522
774,25,15,2025-02-19,5,67,95,28,140
942,23,15,2025-02-04,15,178,242,64,960
728,25,15,2025-02-16,8,134,149,15,120
918,20,9,2025-02-12,13,113,154,41,533
682,11,26,2025-02-28,11,252,320,68,748
67,16,4,2025-02-12,16,256,366,110,1760
290,25,12,2025-02-20,19,85,109,24,456
416,27,23,2025-02-26,4,186,242,56,224
73,26,10,2025-02-18,15,225,296,71,1065
245,20,8,2025-02-18,6,266,325,59,354
349,7,27,2025-02-23,19,240,337,97,1843
446,19,26,2025-02-11,18,375,434,59,1062
679,22,3,2025-02-24,19,448,569,121,2299
607,20,15,2025-02-11,18,69,98,29,522
181,10,13,2025-02-03,20,75,102,27,540
611,25,27,2025-02-13,11,273,366,93,1023
63,3,7,2025-02-27,5,474,622,148,740
774,21,26,2025-02-01,5,358,400,42,210
545,10,13,2025-02-20,19,248,282,34,646
698,29,11,2025-02-10,19,426,622,196,3724
312,30,30,2025-02-14,12,65,85,20,240
627,17,13,2025-02-28,5,456,539,83,415
379,29,18,2025-02-02,1,380,495,115,115
368,4,28,2025-02-10,1,140,174,34,34
605,13,21,2025-02-11,13,227,277,50,650
559,7,22,2025-02-06,16,91,103,12,192
394,27,30,2025-02-12,14,98,116,18,252
894,22,5,2025-02-05,1,56,75,19,19
148,24,29,2025-02-16,14,89,97,8,112
658,26,14,2025-02-28,15,477,670,193,2895
619,30,14,2025-02-20,6,252,322,70,420
566,27,15,2025-02-13,12,135,153,18,216
620,1,19,2025-02-16,8,384,490,106,848
421,30,18,2025-02-19,12,37,55,18,216
582,16,23,2025-02-12,4,317,402,85,340
708,3,5,2025-02-24,17,459,685,226,3842
798,9,15,2025-02-17,3,287,416,129,387
91,8,16,2025-02-21,3,370,494,124,372
818,19,10,2025-02-20,2,482,581,99,198
798,1,16,2025-02-15,17,483,609,126,2142
752,11,14,2025-02-12,10,168,189,21,210
712,30,20,2025-02-24,10,392,550,158,1580
267,2,21,2025-02-16,19,106,139,33,627
673,10,26,2025-02-24,20,33,39,6,120
85,5,17,2025-02-03,9,149,165,16,144
288,9,28,2025-02-09,1,399,439,40,40
179,30,19,2025-02-24,5,357,447,90,450
828,6,9,2025-02-26,8,268,303,35,280
541,28,2,2025-02-11,3,94,124,30,90
842,5,27,2025-02-16,14,414,506,92,1288
677,15,24,2025-02-21,6,127,166,39,234
863,12,2,2025-02-21,9,406,576,170,1530
54,6,15,2025-02-13,16,174,220,46,736
972,25,30,2025-02-18,8,214,291,77,616
400,16,9,2025-02-05,17,465,579,114,1938
296,30,26,2025-02-15,13,367,437,70,910
543,22,2,2025-02-04,18,346,418,72,1296
865,14,20,2025-02-21,9,191,224,33,297
822,4,9,2025-02-21,19,220,277,57,1083
692,24,8,2025-02-24,19,414,471,57,1083
346,22,23,2025-02-06,11,300,316,16,176
9,27,3,2025-02-01,14,70,90,20,280
702,15,12,2025-02-08,10,148,168,20,200
25,20,3,2025-02-02,20,356,517,161,3220
223,20,21,2025-02-04,4,64,92,28,112
134,13,22,2025-02-25,19,431,640,209,3971
918,4,23,2025-02-06,9,170,214,44,396
959,3,21,2025-02-15,9,413,513,100,900
926,22,25,2025-02-25,11,151,170,19,209
76,9,25,2025-02-02,13,218,262,44,572
62,9,27,2025-02-09,6,245,265,20,120
951,7,20,2025-02-13,6,350,445,95,570
148,18,25,2025-02-14,7,334,447,113,791
935,15,23,2025-02-09,4,37,40,3,12
586,24,9,2025-02-25,15,29,42,13,195
153,21,21,2025-02-01,2,360,441,81,162
156,23,11,2025-02-13,19,21,27,6,114
963,25,16,2025-02-16,14,226,323,97,1358
800,26,26,2025-02-03,18,135,142,7,126
978,23,27,2025-02-25,16,82,107,25,400
958,12,11,2025-02-22,10,225,242,17,170
982,21,3,2025-02-12,18,456,676,220,3960
83,27,15,2025-02-25,10,351,401,50,500
568,2,13,2025-02-22,7,173,236,63,441
918,4,21,2025-02-23,12,269,293,24,288
648,15,24,2025-02-07,5,38,43,5,25
738,19,8,2025-02-16,13,52,73,21,273
659,10,16,2025-02-18,15,28,30,2,30
58,11,26,2025-02-24,2,227,250,23,46
827,21,22,2025-02-17,15,367,529,162,2430
550,5,24,2025-02-19,8,493,534,41,328
754,5,16,2025-02-21,1,261,381,120,120
634,2,8,2025-02-23,5,27,30,3,15
52,29,10,2025-02-27,4,253,335,82,328
856,19,3,2025-02-27,4,78,99,21,84
819,20,8,2025-02-03,7,238,286,48,336
856,24,22,2025-02-13,11,81,121,40,440
590,18,5,2025-02-11,7,411,440,29,203
178,11,3,2025-02-04,9,92,128,36,324
173,23,12,2025-02-18,6,244,283,39,234
596,2,5,2025-02-04,20,212,297,85,1700
17,29,16,2025-02-03,1,23,26,3,3
92,23,21,2025-02-19,10,233,317,84,840
812,25,16,2025-02-23,5,125,139,14,70
278,17,15,2025-02-14,8,500,564,64,512
709,2,20,2025-02-06,16,333,492,159,2544
643,27,26,2025-02-10,12,234,246,12,144
242,7,4,2025-02-17,4,336,408,72,288
780,18,17,2025-02-08,15,414,551,137,2055
214,9,2,2025-02-07,4,427,477,50,200
865,30,16,2025-02-16,6,101,137,36,216
45,2,21,2025-02-12,10,127,158,31,310
343,20,26,2025-02-25,15,42,46,4,60
54,30,18,2025-02-06,6,422,449,27,162
528,4,3,2025-02-08,15,323,423,100,1500
430,7,24,2025-02-22,11,137,192,55,605
334,8,4,2025-02-08,14,465,530,65,910
913,8,3,2025-02-16,19,268,288,20,380
447,5,7,2025-02-20,15,111,136,25,375
140,15,24,2025-02-07,12,158,180,22,264
131,2,23,2025-02-19,2,163,181,18,36
873,15,15,2025-02-14,6,409,493,84,504
908,10,20,2025-02-06,20,483,544,61,1220
994,18,28,2025-02-08,3,230,330,100,300
501,28,7,2025-02-19,16,448,564,116,1856
15,24,14,2025-02-24,8,146,175,29,232
594,8,29,2025-02-19,5,487,637,150,750
6,14,2,2025-02-02,16,395,551,156,2496
35,14,17,2025-02-13,16,434,612,178,2848
842,4,15,2025-02-16,8,62,81,19,152
13,23,24,2025-02-14,7,87,105,18,126
245,21,3,2025-02-01,16,362,430,68,1088
721,15,28,2025-02-19,19,32,48,16,304
475,25,5,2025-02-28,13,114,160,46,598
380,21,15,2025-02-23,1,460,613,153,153
395,29,23,2025-02-11,17,36,43,7,119
771,9,23,2025-02-20,18,314,442,128,2304
807,22,3,2025-02-20,11,396,582,186,2046
528,30,22,2025-02-12,2,76,93,17,34
477,20,2,2025-02-12,12,109,146,37,444
722,3,18,2025-02-23,7,90,134,44,308
245,18,4,2025-02-21,16,397,585,188,3008
595,28,23,2025-02-07,8,184,222,38,304
274,17,22,2025-02-14,9,47,51,4,36
354,15,16,2025-02-17,17,444,491,47,799
727,18,22,2025-02-27,18,480,567,87,1566
636,12,26,2025-02-22,3,116,168,52,156
469,3,3,2025-02-13,6,167,247,80,480
79,4,6,2025-02-09,4,376,420,44,176
155,28,7,2025-02-17,1,170,210,40,40
699,18,30,2025-02-05,16,197,244,47,752
756,21,1,2025-02-10,7,52,55,3,21
822,8,27,2025-02-17,11,230,301,71,781
672,21,26,2025-02-11,16,323,436,113,1808
543,27,18,2025-02-15,15,175,228,53,795
920,26,10,2025-02-06,9,136,172,36,324
995,10,25,2025-02-28,2,95,115,20,40
467,6,20,2025-02-06,18,166,188,22,396
180,27,23,2025-02-23,5,102,118,16,80
43,11,19,2025-02-05,15,153,186,33,495
211,18,23,2025-02-02,11,196,219,23,253
460,18,6,2025-02-18,10,82,120,38,380
415,30,16,2025-02-25,5,254,373,119,595
160,1,24,2025-02-18,17,189,253,64,1088
303,16,29,2025-02-10,19,361,403,42,798
579,24,30,2025-02-15,11,372,409,37,407
491,29,2,2025-02-05,18,79,94,15,270
412,20,27,2025-02-08,15,202,221,19,285
57,20,21,2025-02-07,19,289,332,43,817
959,25,9,2025-02-07,1,62,80,18,18
457,22,22,2025-02-03,17,221,251,30,510
326,20,20,2025-02-17,2,485,655,170,340
408,5,23,2025-02-28,14,209,256,47,658
13,10,12,2025-02-12,10,248,358,110,1100
90,7,24,2025-02-15,14,431,538,107,1498
168,26,24,2025-02-14,14,91,130,39,546
613,3,5,2025-02-07,10,263,393,130,1300
538,11,3,2025-02-19,13,65,68,3,39
655,30,9,2025-02-14,6,304,382,78,468
582,25,30,2025-02-05,7,115,164,49,343
297,18,16,2025-02-02,10,447,587,140,1400
506,18,24,2025-02-15,8,33,46,13,104
158,9,10,2025-02-21,16,83,112,29,464
915,10,14,2025-02-06,16,484,658,174,2784
251,1,4,2025-02-25,9,272,407,135,1215
69,20,24,2025-02-12,19,266,347,81,1539
890,9,21,2025-02-22,16,375,532,157,2512
383,17,24,2025-02-19,1,452,527,75,75
596,2,5,2025-02-11,15,469,639,170,2550
366,6,2,2025-02-09,12,234,313,79,948
979,12,2,2025-02-10,10,291,389,98,980
79,17,7,2025-02-25,6,411,449,38,228
771,6,18,2025-02-11,11,443,634,191,2101
820,10,9,2025-02-22,12,69,89,20,240
361,27,5,2025-02-01,5,285,335,50,250
798,16,14,2025-02-11,6,72,83,11,66
516,8,27,2025-02-07,18,334,454,120,2160
976,17,28,2025-02-18,18,379,527,148,2664
117,14,15,2025-02-03,4,439,487,48,192
18,16,12,2025-02-10,12,91,129,38,456
912,20,17,2025-02-25,11,108,148,40,440
30,24,27,2025-02-04,8,85,122,37,296
146,23,8,2025-02-10,5,127,141,14,70
81,14,23,2025-02-25,4,59,62,3,12
496,25,14,2025-02-02,7,75,80,5,35
676,17,19,2025-02-02,16,80,117,37,592
45,3,10,2025-02-22,1,406,444,38,38
127,30,20,2025-02-07,19,481,548,67,1273
687,12,1,2025-02-03,5,453,628,175,875
285,19,12,2025-02-12,6,457,583,126,756
747,20,8,2025-02-17,19,54,59,5,95
593,25,1,2025-02-17,7,386,439,53,371
289,6,29,2025-02-25,18,22,33,11,198
102,30,7,2025-02-17,16,207,282,75,1200
190,15,22,2025-02-04,6,447,541,94,564
389,14,7,2025-02-17,8,228,251,23,184
322,4,15,2025-02-04,17,89,113,24,408
370,23,10,2025-02-18,2,62,74,12,24
119,13,10,2025-02-15,20,396,471,75,1500
1000,27,15,2025-02-08,18,228,269,41,738
876,14,7,2025-02-28,3,478,683,205,615
488,22,12,2025-02-06,1,365,464,99,99
108,13,15,2025-02-17,3,81,90,9,27
411,23,19,2025-02-04,6,53,64,11,66
204,11,7,2025-02-20,13,82,95,13,169
435,24,16,2025-02-09,19,323,379,56,1064
809,26,21,2025-02-13,12,263,355,92,1104
973,13,16,2025-02-17,9,95,133,38,342
111,4,9,2025-02-16,16,138,184,46,736
138,1,4,2025-02-24,2,445,481,36,72
695,1,6,2025-02-13,20,367,439,72,1440
311,20,20,2025-02-04,3,358,497,139,417
786,16,26,2025-02-15,7,170,229,59,413
503,17,9,2025-02-18,11,434,624,190,2090
560,1,25,2025-02-02,14,470,687,217,3038
393,15,11,2025-02-28,13,246,309,63,819
34,6,18,2025-02-22,10,472,646,174,1740
504,14,5,2025-02-10,13,269,375,106,1378
583,22,16,2025-02-22,18,370,478,108,1944
482,16,18,2025-02-28,6,279,300,21,126
270,16,19,2025-02-13,20,366,442,76,1520
292,11,2,2025-02-01,19,43,48,5,95
376,12,26,2025-02-24,19,33,46,13,247
641,11,13,2025-02-04,14,196,293,97,1358
422,12,2,2025-02-22,8,146,169,23,184
320,19,3,2025-02-23,3,464,551,87,261
346,6,1,2025-02-18,11,39,49,10,110
885,14,19,2025-02-17,14,156,165,9,126
481,19,1,2025-02-11,13,312,382,70,910
587,4,26,2025-02-16,4,373,505,132,528
345,16,17,2025-02-26,11,105,139,34,374
373,14,7,2025-02-16,3,450,645,195,585
220,10,9,2025-02-02,10,313,385,72,720
232,20,24,2025-02-03,19,68,90,22,418
280,3,19,2025-02-26,17,263,327,64,1088
356,26,3,2025-02-21,10,278,392,114,1140
444,22,18,2025-02-11,7,232,286,54,378
640,17,15,2025-02-22,18,112,162,50,900
643,23,17,2025-02-28,6,315,402,87,522
677,27,24,2025-02-15,9,499,667,168,1512
829,20,28,2025-02-25,14,498,650,152,2128
642,2,17,2025-02-07,12,256,286,30,360
155,24,22,2025-02-25,10,452,563,111,1110
327,28,27,2025-02-03,7,453,560,107,749
844,10,21,2025-02-06,9,371,490,119,1071
416,8,4,2025-02-05,7,34,39,5,35
848,10,15,2025-02-16,18,243,301,58,1044
928,2,7,2025-02-06,9,89,95,6,54
809,26,9,2025-02-22,18,110,147,37,666
44,24,16,2025-02-26,1,48,69,21,21
86,11,20,2025-02-10,3,481,712,231,693
919,12,22,2025-02-22,3,223,329,106,318
742,27,5,2025-02-08,4,312,431,119,476
956,4,17,2025-02-22,19,416,611,195,3705
258,16,29,2025-02-03,8,327,361,34,272
827,11,11,2025-02-27,19,397,487,90,1710
767,24,8,2025-02-14,7,93,102,9,63
220,9,15,2025-02-14,9,461,606,145,1305
503,18,12,2025-02-23,4,182,236,54,216
487,22,8,2025-02-09,5,205,259,54,270
377,27,10,2025-02-01,20,37,53,16,320
679,26,2,2025-02-23,8,149,194,45,360
317,21,23,2025-02-12,4,293,422,129,516
879,15,13,2025-02-01,13,494,736,242,3146
262,10,3,2025-02-27,8,172,197,25,200
912,6,30,2025-02-15,11,470,665,195,2145
660,14,26,2025-02-02,9,463,503,40,360
799,16,16,2025-02-24,14,494,706,212,2968
735,14,29,2025-02-27,4,442,496,54,216
268,17,3,2025-02-12,14,328,452,124,1736
561,24,11,2025-02-15,1,410,440,30,30
657,6,21,2025-02-15,5,21,26,5,25
644,10,11,2025-02-19,3,76,85,9,27
529,23,25,2025-02-27,5,453,597,144,720
421,26,11,2025-02-15,16,467,645,178,2848
267,6,22,2025-02-19,11,429,505,76,836
87,14,12,2025-02-06,13,468,571,103,1339
855,29,19,2025-02-08,1,31,45,14,14
663,20,21,2025-02-08,3,256,292,36,108
719,28,6,2025-02-02,13,336,418,82,1066
267,5,3,2025-02-12,6,310,342,32,192
736,17,14,2025-02-25,15,443,599,156,2340
122,8,23,2025-02-07,7,461,653,192,1344
273,10,24,2025-02-16,13,86,107,21,273
212,20,7,2025-02-27,10,392,531,139,1390
429,6,14,2025-02-26,5,34,40,6,30
269,8,20,2025-02-15,8,209,274,65,520
663,15,3,2025-02-01,16,88,127,39,624
998,23,13,2025-02-22,7,385,471,86,602
434,24,20,2025-02-09,3,68,88,20,60
54,11,30,2025-02-08,16,485,587,102,1632
621,22,26,2025-02-20,2,22,26,4,8
635,13,10,2025-02-13,12,87,129,42,504
573,2,19,2025-02-06,9,106,135,29,261
953,11,29,2025-02-15,5,65,78,13,65
544,14,5,2025-02-09,4,180,193,13,52
131,16,28,2025-02-27,9,402,487,85,765
441,10,29,2025-02-09,20,444,618,174,3480
271,17,11,2025-02-14,6,181,250,69,414
504,25,5,2025-02-18,15,47,53,6,90
56,8,6,2025-02-02,16,153,172,19,304
479,14,4,2025-02-16,2,246,298,52,104
727,18,16,2025-02-15,16,77,110,33,528
888,5,4,2025-02-12,3,124,179,55,165
185,27,6,2025-02-24,17,441,517,76,1292
913,22,19,2025-02-07,19,22,28,6,114
585,6,14,2025-02-03,8,413,526,113,904
97,29,11,2025-02-01,10,368,549,181,1810
125,13,12,2025-02-19,4,448,536,88,352
30,3,15,2025-02-27,16,252,336,84,1344
276,20,22,2025-02-01,11,42,57,15,165
974,15,11,2025-02-24,19,86,98,12,228
50,26,21,2025-02-10,11,428,460,32,352
73,18,20,2025-02-13,3,224,261,37,111
246,25,28,2025-02-13,3,30,43,13,39
167,13,25,2025-02-13,10,351,487,136,1360
670,5,4,2025-02-10,16,430,535,105,1680
826,30,10,2025-02-22,20,87,105,18,360
99,27,12,2025-02-17,7,270,338,68,476
398,16,9,2025-02-19,20,236,257,21,420
433,26,12,2025-02-20,6,242,323,81,486
96,2,17,2025-02-11,15,366,421,55,825
703,23,5,2025-02-16,17,342,459,117,1989
86,10,15,2025-02-14,3,484,683,199,597
308,5,5,2025-02-22,10,450,523,73,730
438,10,19,2025-02-02,18,59,86,27,486
526,4,17,2025-02-14,14,68,86,18,252
738,19,27,2025-02-09,12,150,197,47,564
788,17,1,2025-02-04,15,111,156,45,675
864,13,2,2025-02-03,14,468,640,172,2408
322,19,24,2025-02-15,15,339,479,140,2100
350,30,28,2025-02-26,6,128,145,17,102
765,20,9,2025-02-28,4,242,312,70,280
6,13,4,2025-02-01,6,355,449,94,564
709,13,28,2025-02-22,20,391,496,105,2100
634,27,20,2025-02-12,13,431,511,80,1040
129,5,1,2025-02-07,4,437,462,25,100
994,7,28,2025-02-01,7,266,357,91,637
666,8,14,2025-02-27,18,117,127,10,180
789,15,5,2025-02-16,14,31,34,3,42
925,5,24,2025-02-23,15,268,338,70,1050
881,15,19,2025-02-08,7,170,222,52,364
854,13,2,2025-02-11,1,72,96,24,24
731,14,14,2025-02-28,16,397,520,123,1968
749,18,10,2025-02-02,16,224,284,60,960
606,24,20,2025-02-22,16,138,189,51,816
541,1,14,2025-02-19,11,303,327,24,264
915,21,14,2025-02-16,4,273,363,90,360
662,12,15,2025-02-23,14,30,34,4,56
744,7,16,2025-02-12,15,138,176,38,570
602,30,22,2025-02-11,20,456,652,196,3920
673,15,5,2025-02-10,13,233,332,99,1287
690,21,24,2025-02-12,16,429,638,209,3344
166,20,7,2025-02-10,3,361,457,96,288
178,7,6,2025-02-20,16,71,100,29,464
966,16,10,2025-02-08,7,305,327,22,154
19,12,29,2025-02-09,12,366,410,44,528
848,28,29,2025-02-17,2,433,467,34,68
441,4,20,2025-02-08,4,307,353,46,184
265,11,26,2025-02-12,2,414,598,184,368
274,29,5,2025-02-28,17,329,445,116,1972
724,2,30,2025-02-15,15,450,626,176,2640
999,4,26,2025-02-20,20,420,603,183,3660
105,27,18,2025-02-02,17,73,82,9,153
121,28,7,2025-02-12,6,392,463,71,426
453,25,17,2025-02-16,4,98,131,33,132
343,27,5,2025-02-04,7,244,363,119,833
788,25,1,2025-02-08,16,194,229,35,560
176,3,9,2025-02-12,14,204,272,68,952
252,5,25,2025-02-25,17,235,330,95,1615
142,26,14,2025-02-14,14,479,602,123,1722
873,17,26,2025-02-22,12,35,44,9,108
789,1,23,2025-02-26,17,55,60,5,85
323,13,25,2025-02-06,14,51,63,12,168
38,22,30,2025-02-21,5,482,631,149,745
647,23,26,2025-02-22,17,171,212,41,697
908,22,23,2025-02-18,10,389,538,149,1490
932,12,1,2025-02-27,9,480,618,138,1242
943,5,23,2025-02-13,15,349,399,50,750
558,20,26,2025-02-20,15,377,454,77,1155
832,26,21,2025-02-13,7,471,558,87,609
38,18,11,2025-02-13,5,286,428,142,710
291,7,3,2025-02-17,18,179,230,51,918
776,21,6,2025-02-01,1,475,669,194,194
607,9,8,2025-02-27,10,391,485,94,940
518,4,24,2025-02-02,12,152,202,50,600
363,4,2,2025-02-25,4,249,295,46,184
755,1,15,2025-02-11,8,432,599,167,1336
596,19,23,2025-02-21,18,452,596,144,2592
359,10,10,2025-02-22,19,364,405,41,779
387,17,24,2025-02-08,4,187,240,53,212
198,27,25,2025-02-12,15,70,78,8,120
436,27,14,2025-02-03,3,51,63,12,36
134,16,7,2025-02-15,3,209,283,74,222
413,19,18,2025-02-17,13,466,545,79,1027
511,21,14,2025-02-15,16,394,586,192,3072
844,6,5,2025-02-17,5,268,367,99,495
133,23,17,2025-02-28,17,80,109,29,493
467,16,2,2025-02-24,6,306,372,66,396
975,4,20,2025-02-28,14,76,84,8,112
586,10,2,2025-02-17,5,80,97,17,85
384,10,10,2025-02-16,1,425,474,49,49
803,19,14,2025-02-02,10,475,559,84,840
188,27,24,2025-02-16,1,82,106,24,24
70,28,2,2025-02-14,16,313,372,59,944
464,29,11,2025-02-26,13,263,375,112,1456
854,20,5,2025-02-25,5,278,372,94,470
780,15,22,2025-02-15,5,463,638,175,875
92,26,20,2025-02-22,20,229,280,51,1020
922,13,11,2025-02-18,2,363,527,164,328
754,9,21,2025-02-03,6,382,405,23,138
646,26,25,2025-02-23,10,307,411,104,1040
660,18,3,2025-02-07,20,297,389,92,1840
55,19,17,2025-02-07,16,277,403,126,2016
124,22,30,2025-02-18,6,29,34,5,30
211,8,27,2025-02-23,19,247,269,22,418
547,20,11,2025-02-13,19,43,55,12,228
957,1,11,2025-02-14,6,232,246,14,84
541,11,13,2025-02-09,3,78,116,38,114
555,6,10,2025-02-05,6,150,209,59,354
158,10,14,2025-02-22,6,50,66,16,96
334,6,1,2025-02-23,2,172,211,39,78
328,5,14,2025-02-11,9,212,312,100,900
922,4,2,2025-02-07,8,405,534,129,1032
243,16,17,2025-02-25,17,217,321,104,1768
276,2,11,2025-02-15,18,228,246,18,324
30,14,21,2025-02-08,1,157,204,47,47
601,22,4,2025-02-08,18,353,495,142,2556
312,19,14,2025-02-15,3,453,605,152,456
209,26,5,2025-02-12,18,106,149,43,774
551,14,30,2025-02-18,15,41,43,2,30
476,27,20,2025-02-10,6,20,22,2,12
944,16,9,2025-02-20,9,449,609,160,1440
360,27,21,2025-02-07,19,450,576,126,2394
47,6,24,2025-02-18,19,55,65,10,190
405,23,4,2025-02-27,5,391,508,117,585
287,29,14,2025-02-07,20,278,412,134,2680
326,29,22,2025-02-11,9,405,554,149,1341
280,8,22,2025-02-11,11,127,160,33,363
614,11,1,2025-02-23,5,350,513,163,815
624,16,1,2025-02-01,6,231,300,69,414
714,23,16,2025-02-25,13,295,321,26,338
898,21,21,2025-02-03,18,35,51,16,288
836,22,15,2025-02-22,4,200,297,97,388
386,27,20,2025-02-12,13,110,157,47,611
832,23,1,2025-02-04,15,209,308,99,1485
456,1,8,2025-02-24,1,408,480,72,72
944,23,12,2025-02-07,3,437,579,142,426
311,26,23,2025-02-08,8,272,404,132,1056
38,9,16,2025-02-23,20,127,134,7,140
841,21,13,2025-02-04,9,311,397,86,774
175,18,7,2025-02-22,19,364,494,130,2470
579,6,3,2025-02-19,5,401,433,32,160
266,30,19,2025-02-28,8,471,605,134,1072
802,9,7,2025-02-28,1,374,507,133,133
630,9,22,2025-02-18,15,21,31,10,150
657,22,21,2025-02-02,11,241,345,104,1144
417,9,4,2025-02-22,17,258,328,70,1190
530,25,2,2025-02-24,8,44,52,8,64
431,18,15,2025-02-11,1,220,250,30,30
84,29,19,2025-02-26,1,397,457,60,60
707,14,3,2025-02-08,7,104,125,21,147
65,21,21,2025-02-04,1,265,330,65,65
25,19,26,2025-02-21,11,450,523,73,803
111,16,8,2025-02-11,2,440,528,88,176
814,8,3,2025-02-25,20,337,420,83,1660
98,21,15,2025-02-19,4,63,94,31,124
939,2,13,2025-02-11,3,420,465,45,135
942,26,15,2025-02-02,10,332,442,110,1100
68,4,22,2025-02-02,18,46,54,8,144
391,13,4,2025-02-20,14,139,200,61,854
807,22,20,2025-02-01,15,216,272,56,840
439,29,20,2025-02-20,4,193,259,66,264
692,26,1,2025-02-15,17,188,247,59,1003
111,4,1,2025-02-20,3,323,454,131,393
199,29,19,2025-02-05,17,151,183,32,544
493,24,20,2025-02-15,6,144,160,16,96
46,2,5,2025-02-10,19,243,311,68,1292
668,25,12,2025-02-10,19,473,612,139,2641
150,5,16,2025-02-10,20,195,230,35,700
994,1,17,2025-02-19,5,49,57,8,40
839,27,18,2025-02-28,2,236,284,48,96
1000,7,21,2025-02-07,3,194,220,26,78
488,23,23,2025-02-15,20,374,448,74,1480
593,19,11,2025-02-20,10,234,280,46,460
108,15,29,2025-02-26,2,273,314,41,82
4,21,8,2025-02-23,8,258,343,85,680
245,16,24,2025-02-25,11,433,599,166,1826
211,13,6,2025-02-27,1,205,216,11,11
367,1,18,2025-02-04,5,168,210,42,210
647,19,30,2025-02-25,12,42,63,21,252
204,7,10,2025-02-06,8,473,552,79,632
179,11,28,2025-02-18,8,111,126,15,120
181,27,9,2025-02-04,1,445,603,158,158
389,21,26,2025-02-04,11,499,571,72,792
468,8,12,2025-02-26,12,358,404,46,552
540,26,20,2025-02-14,3,80,89,9,27
947,5,26,2025-02-07,7,292,356,64,448
384,11,20,2025-02-14,8,491,526,35,280
631,19,7,2025-02-28,18,170,239,69,1242
336,8,2,2025-02-21,9,466,516,50,450
521,19,29,2025-02-16,7,392,426,34,238
482,26,22,2025-02-20,3,105,134,29,87
770,29,21,2025-02-25,17,211,269,58,986
476,6,11,2025-02-23,12,289,394,105,1260
733,16,16,2025-02-09,19,225,301,76,1444
810,19,21,2025-02-02,7,132,192,60,420
463,28,8,2025-02-13,7,176,218,42,294
387,19,6,2025-02-27,12,150,195,45,540
138,25,3,2025-02-10,15,285,344,59,885
598,2,15,2025-02-17,20,192,238,46,920
479,14,14,2025-02-12,16,182,213,31,496
26,6,15,2025-02-08,9,350,379,29,261
924,3,10,2025-02-27,17,282,365,83,1411
81,26,9,2025-02-08,4,80,87,7,28
40,18,7,2025-02-11,7,365,437,72,504
310,24,27,2025-02-25,9,117,160,43,387
142,28,25,2025-02-23,18,487,569,82,1476
789,10,10,2025-02-27,12,420,629,209,2508
969,13,27,2025-02-19,1,261,351,90,90
780,5,28,2025-02-13,8,136,187,51,408
215,16,8,2025-02-17,19,422,548,126,2394
480,24,27,2025-02-15,11,425,463,38,418
867,7,14,2025-02-25,14,127,158,31,434
874,18,1,2025-02-12,5,315,455,140,700
313,24,1,2025-02-16,12,193,222,29,348
436,22,25,2025-02-13,18,173,207,34,612
24,19,26,2025-02-02,5,98,146,48,240
339,19,21,2025-02-26,20,487,645,158,3160
888,13,13,2025-02-07,13,52,67,15,195
193,16,4,2025-02-11,19,251,336,85,1615
312,3,6,2025-02-04,18,110,117,7,126
706,20,16,2025-02-01,6,121,131,10,60
987,13,10,2025-02-07,8,169,228,59,472
72,15,2,2025-02-12,17,25,28,3,51
881,30,14,2025-02-13,6,76,84,8,48
429,16,24,2025-02-03,13,482,694,212,2756
134,28,7,2025-02-10,14,438,600,162,2268
487,6,20,2025-02-19,10,320,365,45,450
734,22,15,2025-02-09,7,23,34,11,77
457,3,27,2025-02-13,20,433,503,70,1400
337,30,19,2025-02-16,15,256,335,79,1185
755,3,10,2025-02-21,15,197,269,72,1080
729,26,10,2025-02-13,20,441,624,183,3660
180,14,8,2025-02-06,20,395,492,97,1940
394,30,22,2025-02-06,19,68,83,15,285
969,2,8,2025-02-28,6,160,232,72,432
551,10,22,2025-02-03,7,485,617,132,924
781,18,4,2025-02-12,3,406,446,40,120
785,25,11,2025-02-14,15,104,121,17,255
519,2,15,2025-02-01,3,347,473,126,378
768,15,13,2025-02-11,13,458,521,63,819
39,1,9,2025-02-04,5,187,253,66,330
476,16,15,2025-02-03,3,300,404,104,312
731,15,5,2025-02-16,9,450,505,55,495
859,1,20,2025-02-04,6,170,188,18,108
760,13,6,2025-02-03,1,366,429,63,63
452,12,6,2025-02-07,2,477,646,169,338
222,15,23,2025-02-02,17,348,469,121,2057
676,29,4,2025-02-13,10,247,265,18,180
5,2,25,2025-02-13,7,495,575,80,560
931,8,7,2025-02-03,1,235,250,15,15
15,11,27,2025-02-07,3,132,196,64,192
99,26,27,2025-02-27,6,390,439,49,294
426,17,4,2025-02-27,11,185,241,56,616
195,20,7,2025-02-18,13,500,621,121,1573
238,7,4,2025-02-12,11,108,114,6,66
670,11,1,2025-02-13,7,254,292,38,266
674,27,9,2025-02-21,20,208,223,15,300
907,7,14,2025-02-10,20,275,410,135,2700
105,23,18,2025-02-26,19,107,124,17,323
98,20,11,2025-02-21,13,367,538,171,2223
790,23,5,2025-02-11,6,345,481,136,816
705,11,28,2025-02-22,16,54,65,11,176
624,30,19,2025-02-15,13,281,376,95,1235
239,17,19,2025-02-23,1,139,147,8,8
778,29,4,2025-02-10,8,397,493,96,768
250,20,3,2025-02-02,5,211,269,58,290
207,5,13,2025-02-07,2,141,207,66,132
613,15,24,2025-02-11,5,162,193,31,155
806,25,2,2025-02-17,14,351,497,146,2044
769,1,8,2025-02-28,11,195,226,31,341
553,2,30,2025-02-22,8,430,585,155,1240
737,8,20,2025-02-28,13,286,342,56,728
453,21,1,2025-02-03,16,55,81,26,416
54,21,5,2025-02-07,5,66,74,8,40
563,27,26,2025-02-07,8,279,303,24,192
743,15,10,2025-02-06,7,145,180,35,245
621,8,10,2025-02-10,19,249,370,121,2299
207,9,28,2025-02-26,16,60,89,29,464
369,13,13,2025-02-06,16,245,304,59,944
625,24,14,2025-02-25,5,439,649,210,1050
494,1,25,2025-02-13,14,457,497,40,560
929,30,10,2025-02-20,18,98,127,29,522
180,9,13,2025-02-15,10,252,297,45,450
576,20,16,2025-02-03,11,89,122,33,363
201,5,30,2025-02-07,1,26,37,11,11
748,24,12,2025-02-16,13,493,610,117,1521
405,24,12,2025-02-13,16,177,237,60,960
603,3,14,2025-02-02,4,217,319,102,408
167,7,25,2025-02-14,9,414,605,191,1719
740,12,17,2025-02-23,16,345,469,124,1984
714,2,21,2025-02-13,14,396,460,64,896
490,2,30,2025-02-27,12,343,469,126,1512
29,23,22,2025-02-21,5,153,202,49,245
967,22,5,2025-02-09,8,328,430,102,816
679,27,6,2025-02-01,4,414,452,38,152
729,30,13,2025-02-13,19,481,522,41,779
932,7,29,2025-02-14,6,444,551,107,642
709,10,17,2025-02-18,13,320,380,60,780
422,25,29,2025-02-24,3,75,100,25,75
796,26,12,2025-02-27,5,157,218,61,305
953,24,13,2025-02-23,10,23,34,11,110
836,16,1,2025-02-04,3,416,567,151,453
538,14,21,2025-02-10,14,107,121,14,196
191,23,5,2025-02-07,16,113,144,31,496
113,15,19,2025-02-27,7,115,131,16,112
768,6,26,2025-02-25,7,152,227,75,525
893,14,15,2025-02-21,20,75,108,33,660
171,3,10,2025-02-03,13,83,97,14,182
351,1,19,2025-02-08,16,268,363,95,1520
104,1,2,2025-02-09,1,360,472,112,112
43,4,7,2025-02-17,1,212,280,68,68
986,25,9,2025-02-16,16,407,489,82,1312
440,11,12,2025-02-22,11,181,257,76,836
964,12,22,2025-02-13,13,332,357,25,325
365,28,11,2025-02-26,4,21,26,5,20
716,13,24,2025-02-27,5,33,44,11,55
890,17,9,2025-02-23,8,208,261,53,424
703,22,28,2025-02-16,17,231,311,80,1360
4,21,27,2025-02-11,1,344,417,73,73
47,26,24,2025-02-11,15,139,184,45,675
410,24,20,2025-02-26,3,198,246,48,144
954,30,16,2025-02-22,4,395,483,88,352
622,7,23,2025-02-05,17,468,612,144,2448
878,23,17,2025-02-02,5,274,386,112,560
309,27,22,2025-02-18,15,106,154,48,720
978,4,16,2025-02-22,18,143,166,23,414
175,25,22,2025-02-23,3,74,92,18,54
733,1,6,2025-02-11,13,412,485,73,949
737,9,22,2025-02-16,4,360,400,40,160
548,21,24,2025-02-16,3,427,581,154,462
893,8,30,2025-02-19,20,53,71,18,360
387,30,23,2025-02-24,13,354,474,120,1560
576,28,14,2025-02-26,8,134,156,22,176
298,3,4,2025-02-03,11,399,525,126,1386
193,24,4,2025-02-19,12,85,122,37,444
977,13,19,2025-02-24,1,179,193,14,14
549,7,28,2025-02-13,14,183,256,73,1022
817,22,30,2025-02-26,5,286,386,100,500
605,8,4,2025-02-13,1,295,423,128,128
324,5,27,2025-02-10,8,275,373,98,784
151,20,10,2025-02-05,2,326,389,63,126
515,23,4,2025-02-09,19,264,352,88,1672
221,16,10,2025-02-23,13,50,75,25,325
342,5,27,2025-02-23,7,454,626,172,1204
830,8,23,2025-02-24,2,492,708,216,432
184,28,16,2025-02-24,13,173,258,85,1105
676,30,28,2025-02-06,1,300,368,68,68
433,22,16,2025-02-12,13,220,238,18,234
745,10,10,2025-02-23,7,378,543,165,1155
404,4,5,2025-02-11,19,463,654,191,3629
871,30,23,2025-02-10,15,355,399,44,660
141,15,23,2025-02-16,10,479,534,55,550
224,26,24,2025-02-07,1,205,282,77,77
590,4,22,2025-02-26,5,212,313,101,505
438,22,27,2025-02-06,2,69,83,14,28
486,6,2,2025-02-04,17,352,423,71,1207
445,5,21,2025-02-24,13,145,154,9,117
247,13,16,2025-02-10,20,108,145,37,740
385,25,23,2025-02-26,3,418,526,108,324
838,21,13,2025-02-09,15,208,219,11,165
120,3,4,2025-02-16,17,135,143,8,136
587,19,16,2025-02-09,4,426,561,135,540
394,16,21,2025-02-23,14,172,225,53,742
102,11,3,2025-02-23,18,114,140,26,468
718,1,13,2025-02-18,18,421,596,175,3150
501,3,17,2025-02-27,19,295,405,110,2090
810,21,4,2025-02-25,7,357,519,162,1134
186,28,20,2025-02-23,6,22,29,7,42
820,11,4,2025-02-02,5,314,359,45,225
166,3,18,2025-02-09,2,63,94,31,62
519,10,12,2025-02-18,6,236,352,116,696
674,1,8,2025-02-10,2,285,415,130,260
301,22,18,2025-02-15,5,315,400,85,425
321,17,30,2025-02-12,20,295,378,83,1660
705,4,22,2025-02-27,2,141,150,9,18
146,10,28,2025-02-27,7,88,116,28,196
222,19,12,2025-02-09,5,393,523,130,650
77,18,9,2025-02-09,13,352,513,161,2093
410,15,3,2025-02-09,14,375,418,43,602
209,3,21,2025-02-24,9,344,469,125,1125
198,23,12,2025-02-19,17,329,370,41,697
842,5,11,2025-02-26,14,214,227,13,182
619,8,3,2025-02-09,4,292,321,29,116
562,14,3,2025-02-11,3,205,299,94,282
797,9,5,2025-02-28,8,160,169,9,72
387,8,13,2025-02-04,4,109,140,31,124
897,10,19,2025-02-27,16,68,88,20,320
718,19,28,2025-02-10,18,158,209,51,918
919,2,6,2025-02-11,13,112,135,23,299
760,22,26,2025-02-18,18,324,469,145,2610
413,16,19,2025-02-05,9,24,33,9,81
731,5,22,2025-02-05,5,213,278,65,325
274,2,30,2025-02-24,12,382,535,153,1836
695,20,14,2025-02-23,15,113,141,28,420
363,26,15,2025-02-17,10,161,238,77,770
534,23,29,2025-02-27,8,176,235,59,472
90,10,14,2025-02-25,11,452,493,41,451
82,3,24,2025-02-08,3,104,136,32,96
87,24,10,2025-02-18,16,433,625,192,3072
986,14,22,2025-02-17,5,265,338,73,365
702,22,29,2025-02-18,4,227,240,13,52
195,30,27,2025-02-24,1,385,478,93,93
548,24,12,2025-02-08,17,370,490,120,2040
622,15,6,2025-02-22,17,482,555,73,1241
77,12,27,2025-02-05,17,200,296,96,1632
433,16,13,2025-02-06,12,77,93,16,192
696,8,27,2025-02-18,4,168,199,31,124
301,9,7,2025-02-01,19,221,254,33,627
313,30,30,2025-02-21,17,442,642,200,3400
958,15,29,2025-02-20,16,49,59,10,160
631,15,11,2025-02-10,12,74,78,4,48
912,24,6,2025-02-13,12,24,26,2,24
504,7,3,2025-02-17,17,480,537,57,969
127,30,16,2025-02-01,5,413,556,143,715
232,16,13,2025-02-12,10,206,256,50,500
187,18,26,2025-02-09,4,244,328,84,336
450,6,5,2025-02-12,14,22,27,5,70
892,23,7,2025-02-04,7,165,176,11,77
405,14,24,2025-02-11,2,102,138,36,72
972,16,22,2025-02-09,4,235,298,63,252
508,26,22,2025-02-23,5,186,258,72,360
800,29,13,2025-02-17,13,87,96,9,117
111,26,1,2025-02-05,5,196,250,54,270
786,22,8,2025-02-02,11,239,356,117,1287
756,1,14,2025-02-16,10,164,208,44,440
780,14,8,2025-02-20,5,393,503,110,550
256,9,25,2025-02-04,9,378,439,61,549
841,14,7,2025-02-16,4,378,521,143,572
626,6,7,2025-02-28,19,342,457,115,2185
235,4,5,2025-02-13,2,160,239,79,158
952,5,14,2025-02-01,20,122,133,11,220
53,13,14,2025-02-17,10,378,505,127,1270
237,8,11,2025-02-14,16,51,65,14,224
660,2,10,2025-02-04,9,206,242,36,324
360,23,14,2025-02-08,11,478,512,34,374
42,1,2,2025-02-22,11,128,151,23,253
287,30,20,2025-02-04,14,114,133,19,266
504,12,11,2025-02-10,4,69,93,24,96
700,18,25,2025-02-28,5,189,229,40,200
830,12,24,2025-02-25,19,290,383,93,1767
244,21,9,2025-02-07,19,216,235,19,361
109,5,21,2025-02-24,20,81,87,6,120
992,30,29,2025-02-21,7,118,161,43,301
948,4,3,2025-02-18,20,195,231,36,720
486,25,7,2025-02-18,5,42,47,5,25
429,18,23,2025-02-09,18,197,286,89,1602
460,21,23,2025-02-04,14,54,68,14,196
537,30,17,2025-02-26,1,105,139,34,34
714,5,10,2025-02-02,19,51,72,21,399
711,7,24,2025-02-27,13,273,371,98,1274
892,17,3,2025-02-06,15,404,517,113,1695
576,25,13,2025-02-13,20,159,182,23,460
4,6,19,2025-02-07,19,376,396,20,380
951,26,17,2025-02-15,17,382,525,143,2431
266,10,28,2025-02-08,10,382,447,65,650
122,6,8,2025-02-02,18,141,167,26,468
655,5,29,2025-02-09,5,158,228,70,350
53,21,8,2025-02-27,7,293,323,30,210
665,12,21,2025-02-20,12,186,202,16,192
723,29,18,2025-02-09,5,229,333,104,520
302,11,2,2025-02-21,1,441,534,93,93
749,9,6,2025-02-09,1,295,397,102,102
889,25,25,2025-02-19,4,389,539,150,600
392,21,9,2025-02-28,20,302,345,43,860
453,8,11,2025-02-09,7,317,423,106,742
879,25,13,2025-02-05,15,138,190,52,780
445,12,5,2025-02-16,3,273,309,36,108
190,27,28,2025-02-06,7,311,395,84,588
747,6,21,2025-02-10,1,178,200,22,22
182,27,13,2025-02-22,20,116,125,9,180
74,14,8,2025-02-15,13,71,98,27,351
141,24,25,2025-02-26,1,328,359,31,31
394,1,4,2025-02-27,1,410,584,174,174
958,2,5,2025-02-08,3,157,175,18,54
643,20,1,2025-02-26,1,425,467,42,42
754,27,11,2025-02-28,3,123,137,14,42
778,19,29,2025-02-15,6,177,212,35,210
159,8,2,2025-02-18,9,341,441,100,900
22,27,2,2025-02-04,18,171,187,16,288
908,27,14,2025-02-05,1,487,561,74,74
233,14,13,2025-02-05,12,355,419,64,768
944,29,22,2025-02-13,4,271,305,34,136
113,8,4,2025-02-10,12,59,78,19,228
122,12,30,2025-02-03,2,329,368,39,78
439,17,11,2025-02-20,6,367,456,89,534
915,22,22,2025-02-10,20,438,516,78,1560
897,4,9,2025-02-16,12,497,581,84,1008
929,23,26,2025-02-03,1,461,678,217,217
153,25,21,2025-02-05,11,95,116,21,231
739,26,26,2025-02-16,3,77,101,24,72
983,24,9,2025-02-05,3,185,277,92,276
187,25,13,2025-02-12,11,273,339,66,726
711,14,20,2025-02-26,11,90,127,37,407
670,30,8,2025-02-13,14,301,383,82,1148
547,16,18,2025-02-18,8,216,235,19,152
733,14,17,2025-02-19,8,379,413,34,272
371,1,7,2025-02-28,1,205,267,62,62
981,5,30,2025-02-04,2,486,587,101,202
870,28,28,2025-02-25,5,170,214,44,220
856,28,18,2025-02-14,8,127,181,54,432
58,24,5,2025-02-04,5,213,294,81,405
713,14,12,2025-02-02,4,359,471,112,448
489,27,20,2025-02-28,6,35,39,4,24
145,3,8,2025-02-03,1,311,443,132,132
427,5,25,2025-02-06,16,400,445,45,720
541,23,10,2025-02-16,14,389,468,79,1106
801,21,23,2025-02-01,10,76,85,9,90
903,21,2,2025-02-20,6,277,311,34,204
406,27,14,2025-02-22,15,303,415,112,1680
265,30,19,2025-02-17,10,383,441,58,580
954,6,9,2025-02-03,17,213,317,104,1768
129,24,7,2025-02-13,20,48,55,7,140
189,27,24,2025-02-18,20,450,488,38,760
710,15,16,2025-02-11,13,443,541,98,1274
56,26,12,2025-02-21,14,119,139,20,280
107,3,12,2025-02-20,11,34,39,5,55
167,18,4,2025-02-03,7,325,343,18,126
932,10,7,2025-02-18,7,346,508,162,1134
247,9,3,2025-02-19,19,42,55,13,247
810,16,2,2025-02-02,11,67,99,32,352
9,12,25,2025-02-10,13,276,314,38,494
770,13,24,2025-02-12,5,379,513,134,670
340,14,29,2025-02-24,17,71,91,20,340
794,5,1,2025-02-19,13,264,347,83,1079
873,2,10,2025-02-06,5,369,464,95,475
907,21,3,2025-02-23,8,472,541,69,552
698,21,5,2025-02-25,6,276,354,78,468
747,20,21,2025-02-17,11,249,349,100,1100
348,10,12,2025-02-20,14,40,58,18,252
793,22,13,2025-02-08,7,332,439,107,749
982,5,19,2025-02-21,16,69,97,28,448
147,25,28,2025-02-10,18,464,690,226,4068
801,29,3,2025-02-16,4,252,300,48,192
957,10,6,2025-02-03,9,315,382,67,603
92,3,6,2025-02-23,15,152,227,75,1125
263,25,29,2025-02-15,5,83,123,40,200
500,2,12,2025-02-28,10,225,278,53,530
635,30,22,2025-02-05,15,207,265,58,870
640,11,12,2025-02-03,14,279,349,70,980
899,29,22,2025-02-02,20,349,375,26,520
810,8,23,2025-02-27,18,24,27,3,54
108,10,13,2025-02-06,19,224,321,97,1843
229,13,28,2025-02-15,3,198,249,51,153
658,18,29,2025-02-27,15,75,82,7,105
750,4,30,2025-02-13,14,122,150,28,392
67,11,11,2025-02-20,16,128,175,47,752
488,4,9,2025-02-15,2,299,335,36,72
482,5,21,2025-02-07,11,310,330,20,220
616,25,13,2025-02-02,12,424,527,103,1236
485,7,2,2025-02-07,1,408,554,146,146
277,9,21,2025-02-06,3,92,99,7,21
415,3,10,2025-02-28,15,466,577,111,1665
220,22,29,2025-02-09,6,445,478,33,198
917,29,14,2025-02-11,10,104,118,14,140
965,14,16,2025-02-16,18,372,522,150,2700
989,23,14,2025-02-12,19,219,311,92,1748
575,26,29,2025-02-20,7,59,81,22,154
593,20,5,2025-02-11,11,27,30,3,33
470,30,5,2025-02-16,11,78,110,32,352
691,14,9,2025-02-17,1,250,369,119,119
878,5,21,2025-02-15,19,69,74,5,95
764,7,14,2025-02-23,18,416,468,52,936
387,7,12,2025-02-07,7,367,481,114,798
15,12,27,2025-02-12,1,174,253,79,79
515,27,28,2025-02-04,16,352,528,176,2816
424,14,12,2025-02-12,18,238,306,68,1224
784,11,4,2025-02-06,15,239,291,52,780
567,20,6,2025-02-18,14,215,253,38,532
676,23,22,2025-02-14,10,379,504,125,1250
948,29,28,2025-02-04,3,432,616,184,552
92,21,1,2025-02-20,14,73,93,20,280
770,20,30,2025-02-18,4,344,430,86,344
596,26,2,2025-02-22,10,456,565,109,1090
229,25,15,2025-02-18,13,78,89,11,143
481,4,12,2025-02-26,15,231,337,106,1590
661,23,26,2025-02-24,13,23,34,11,143
801,8,17,2025-02-10,9,470,633,163,1467
315,27,29,2025-02-26,14,364,422,58,812
922,30,14,2025-02-02,1,33,37,4,4
384,27,27,2025-02-17,20,182,219,37,740
983,19,14,2025-02-08,18,220,250,30,540
660,13,27,2025-02-02,19,239,265,26,494
652,13,24,2025-02-06,13,482,575,93,1209
163,14,8,2025-02-04,5,278,307,29,145
591,26,13,2025-02-27,9,448,582,134,1206
972,11,7,2025-02-03,3,33,41,8,24
644,25,19,2025-02-05,1,336,460,124,124
943,3,19,2025-02-13,1,400,552,152,152
465,21,21,2025-02-25,12,115,133,18,216
920,8,10,2025-02-07,18,450,522,72,1296
799,26,26,2025-02-13,9,357,383,26,234
85,30,5,2025-02-21,1,346,517,171,171
888,4,4,2025-02-15,20,82,90,8,160
290,9,29,2025-02-06,3,59,75,16,48
371,30,27,2025-02-07,13,71,90,19,247
23,14,3,2025-02-16,3,127,173,46,138
385,29,11,2025-02-21,15,433,486,53,795
306,1,29,2025-02-06,19,343,454,111,2109
33,4,11,2025-02-12,16,334,441,107,1712
6,6,17,2025-02-24,9,494,546,52,468
621,1,18,2025-02-01,17,282,393,111,1887
222,28,12,2025-02-04,7,35,42,7,49
226,3,24,2025-02-23,5,157,184,27,135
205,3,12,2025-02-23,18,353,417,64,1152
764,26,16,2025-02-14,17,224,328,104,1768
257,6,7,2025-02-22,9,221,242,21,189
813,25,19,2025-02-10,6,426,487,61,366
740,16,14,2025-02-15,14,325,451,126,1764
836,11,20,2025-02-04,20,216,269,53,1060
581,12,12,2025-02-21,3,250,281,31,93
35,17,9,2025-02-19,14,170,225,55,770
899,21,17,2025-02-12,13,35,39,4,52
829,11,14,2025-02-26,6,203,236,33,198
221,22,12,2025-02-12,5,419,499,80,400
10,11,23,2025-02-01,11,129,162,33,363
815,11,29,2025-02-08,18,53,65,12,216
617,7,17,2025-02-07,4,307,361,54,216
623,29,26,2025-02-28,3,313,454,141,423
432,22,25,2025-02-14,11,436,521,85,935
202,2,26,2025-02-16,16,43,64,21,336
432,4,4,2025-02-15,6,327,391,64,384
393,8,19,2025-02-01,10,29,39,10,100
877,19,1,2025-02-15,10,87,124,37,370
413,2,29,2025-02-18,17,40,48,8,136
17,3,16,2025-02-04,14,390,462,72,1008
325,25,12,2025-02-13,3,304,425,121,363
506,20,2,2025-02-13,10,376,561,185,1850
506,28,21,2025-02-04,12,500,664,164,1968
30,8,2,2025-02-27,1,91,100,9,9
331,28,23,2025-02-24,14,135,152,17,238
196,24,29,2025-02-26,12,437,636,199,2388
6,30,23,2025-02-28,2,152,220,68,136
45,4,2,2025-02-10,3,155,186,31,93
628,26,26,2025-02-13,9,377,425,48,432
142,19,15,2025-02-04,5,183,263,80,400
772,19,29,2025-02-28,14,346,433,87,1218
126,17,17,2025-02-08,19,264,356,92,1748
1000,9,11,2025-02-25,16,135,147,12,192
785,10,23,2025-02-03,12,305,435,130,1560
249,22,21,2025-02-24,7,375,407,32,224
996,16,2,2025-02-07,1,363,416,53,53
839,13,7,2025-02-16,4,194,222,28,112
605,25,17,2025-02-17,11,409,603,194,2134
726,15,21,2025-02-05,17,74,108,34,578
225,30,12,2025-02-13,15,464,617,153,2295
208,25,13,2025-02-07,3,162,201,39,117
703,10,28,2025-02-19,4,95,119,24,96
110,24,4,2025-02-08,1,477,600,123,123
274,1,16,2025-02-22,17,251,303,52,884
122,30,18,2025-02-03,12,240,275,35,420
407,17,14,2025-02-17,11,47,59,12,132
379,4,2,2025-02-21,13,394,578,184,2392
199,10,7,2025-02-13,6,324,380,56,336
623,16,17,2025-02-14,4,368,395,27,108
255,4,8,2025-02-04,2,478,510,32,64
273,8,3,2025-02-18,4,161,185,24,96
636,23,23,2025-02-13,13,221,242,21,273
752,27,29,2025-02-23,9,273,312,39,351
805,7,12,2025-02-21,10,381,502,121,1210
752,1,4,2025-02-06,17,484,661,177,3009
489,24,10,2025-02-28,8,107,128,21,168
72,6,6,2025-02-11,15,92,136,44,660
683,16,14,2025-02-11,1,110,164,54,54
903,3,6,2025-02-22,1,324,392,68,68
486,19,1,2025-02-16,8,261,287,26,208
839,1,19,2025-02-22,10,447,515,68,680
516,6,25,2025-02-05,4,71,84,13,52
754,11,15,2025-02-16,12,299,349,50,600
499,9,12,2025-02-15,1,443,535,92,92
728,11,29,2025-02-17,20,267,294,27,540
703,17,24,2025-02-21,1,95,142,47,47
877,8,22,2025-02-05,12,274,292,18,216
592,24,23,2025-02-14,12,125,173,48,576
199,30,13,2025-02-21,4,160,231,71,284
696,18,29,2025-02-15,17,109,127,18,306
696,12,29,2025-02-11,13,321,397,76,988
283,10,7,2025-02-02,19,286,391,105,1995
855,20,4,2025-02-14,15,310,461,151,2265
812,12,10,2025-02-04,1,275,403,128,128
151,15,22,2025-02-05,17,168,224,56,952
681,6,10,2025-02-16,10,53,75,22,220
16,15,2,2025-02-07,10,442,582,140,1400
55,16,10,2025-02-01,14,200,269,69,966
1,2,9,2025-02-05,12,469,552,83,996
880,17,22,2025-02-25,18,99,146,47,846
731,9,5,2025-02-24,7,241,317,76,532
83,10,8,2025-02-02,16,497,601,104,1664
832,22,21,2025-02-13,14,224,333,109,1526
101,29,9,2025-02-10,20,179,202,23,460
447,22,29,2025-02-11,19,91,124,33,627
205,9,5,2025-02-14,18,122,145,23,414
88,10,19,2025-02-21,15,299,339,40,600
802,29,27,2025-02-14,4,90,116,26,104
711,11,17,2025-02-22,12,259,313,54,648
478,14,14,2025-02-15,1,487,634,147,147
981,25,14,2025-02-03,5,334,487,153,765
806,8,19,2025-02-17,12,85,113,28,336
922,19,29,2025-02-10,2,406,581,175,350
129,13,22,2025-02-01,15,433,603,170,2550
531,15,27,2025-02-02,3,48,56,8,24
666,4,11,2025-02-20,4,440,520,80,320
494,23,11,2025-02-28,2,82,113,31,62
691,17,24,2025-02-23,2,379,433,54,108
148,18,24,2025-02-16,5,134,195,61,305
656,28,5,2025-02-10,10,388,580,192,1920
7,26,16,2025-02-20,7,78,84,6,42
157,20,29,2025-02-04,17,69,80,11,187
107,16,1,2025-02-27,17,247,303,56,952
949,4,10,2025-02-13,16,114,162,48,768
862,28,18,2025-02-09,20,368,459,91,1820
674,20,4,2025-02-14,5,345,366,21,105
146,27,24,2025-02-22,8,107,137,30,240
717,18,7,2025-02-16,16,168,198,30,480
103,19,16,2025-02-12,9,220,269,49,441
820,4,15,2025-02-14,14,95,101,6,84
469,4,19,2025-02-13,1,317,376,59,59
661,21,29,2025-02-22,20,247,264,17,340
929,12,5,2025-02-15,15,161,170,9,135
163,12,17,2025-02-28,17,127,153,26,442
724,17,13,2025-02-17,3,109,147,38,114
361,21,24,2025-02-19,11,255,350,95,1045
806,5,9,2025-02-26,10,492,604,112,1120
939,27,21,2025-02-16,13,261,345,84,1092
185,19,23,2025-02-17,17,152,168,16,272
332,19,19,2025-02-12,19,336,478,142,2698
70,2,1,2025-02-28,6,138,151,13,78
109,16,30,2025-02-22,16,185,258,73,1168
791,26,30,2025-02-24,8,73,106,33,264
179,24,29,2025-02-13,14,492,531,39,546
627,9,4,2025-02-02,3,246,343,97,291
622,21,27,2025-02-01,6,184,202,18,108
461,13,5,2025-02-21,19,304,347,43,817
259,16,15,2025-02-22,10,135,154,19,190
166,14,27,2025-02-17,7,64,84,20,140
645,22,4,2025-02-07,2,434,483,49,98
6,12,25,2025-02-14,19,299,430,131,2489
349,6,22,2025-02-24,17,274,311,37,629
213,19,27,2025-02-16,17,200,242,42,714
922,18,28,2025-02-05,3,244,303,59,177
386,28,3,2025-02-19,3,85,119,34,102
306,4,4,2025-02-16,8,46,61,15,120
339,1,8,2025-02-27,10,492,700,208,2080
400,23,12,2025-02-03,6,167,181,14,84
590,8,28,2025-02-17,20,276,329,53,1060
634,2,18,2025-02-23,4,318,401,83,332
940,9,21,2025-02-01,2,193,239,46,92
206,11,29,2025-02-25,2,91,104,13,26
837,24,11,2025-02-25,2,140,178,38,76
825,19,29,2025-02-20,2,197,294,97,194
973,14,20,2025-02-24,20,495,538,43,860
565,16,5,2025-02-09,2,73,78,5,10
520,8,21,2025-02-12,14,264,313,49,686
871,29,8,2025-02-01,2,33,46,13,26
831,7,18,2025-02-20,13,369,501,132,1716
19,18,16,2025-02-02,13,412,503,91,1183
129,14,23,2025-02-14,18,90,99,9,162
121,29,20,2025-02-12,12,119,143,24,288
941,2,8,2025-02-08,3,321,339,18,54
423,24,25,2025-02-26,18,310,332,22,396
822,1,28,2025-02-24,8,436,469,33,264
59,5,15,2025-02-06,10,42,50,8,80
617,21,29,2025-02-08,10,86,114,28,280
491,22,4,2025-02-22,3,59,69,10,30
557,7,16,2025-02-23,12,479,700,221,2652
226,15,23,2025-02-10,12,419,544,125,1500
890,21,8,2025-02-17,9,183,250,67,603
516,4,2,2025-02-12,14,381,563,182,2548
498,9,3,2025-02-07,5,450,670,220,1100
237,10,24,2025-02-18,7,82,100,18,126
836,26,5,2025-02-02,8,377,471,94,752
783,15,4,2025-02-01,16,448,477,29,464
285,19,13,2025-02-10,3,50,59,9,27
625,13,16,2025-02-01,13,216,270,54,702
230,7,13,2025-02-06,14,292,313,21,294
313,2,18,2025-02-25,12,499,530,31,372
624,25,29,2025-02-11,9,434,603,169,1521
222,25,1,2025-02-11,20,242,348,106,2120
802,24,30,2025-02-24,2,433,476,43,86
398,24,30,2025-02-22,10,459,687,228,2280
548,15,14,2025-02-19,19,413,530,117,2223
167,13,15,2025-02-24,8,87,127,40,320
288,26,22,2025-02-09,3,147,205,58,174
303,11,19,2025-02-13,2,335,393,58,116
276,22,9,2025-02-26,20,26,29,3,60
583,22,11,2025-02-27,9,453,512,59,531
474,1,15,2025-02-01,15,38,56,18,270
492,21,28,2025-02-18,7,229,246,17,119
962,3,9,2025-02-20,18,180,266,86,1548
452,6,9,2025-02-25,9,152,219,67,603
131,8,21,2025-02-06,5,466,619,153,765
51,8,4,2025-02-21,2,114,155,41,82
882,15,19,2025-02-11,2,303,416,113,226
63,23,9,2025-02-09,1,367,525,158,158
870,12,18,2025-02-23,2,327,378,51,102
112,3,17,2025-02-15,4,281,305,24,96
209,11,19,2025-02-12,14,56,75,19,266
897,10,5,2025-02-01,11,330,464,134,1474
344,14,29,2025-02-21,12,260,383,123,1476
302,20,1,2025-02-06,12,42,50,8,96
154,30,19,2025-02-01,4,331,379,48,192
321,17,23,2025-02-25,17,421,552,131,2227
353,7,13,2025-02-27,19,36,48,12,228
154,13,25,2025-02-21,3,59,87,28,84
230,19,17,2025-02-19,18,395,489,94,1692
751,4,28,2025-02-17,2,330,417,87,174
538,17,15,2025-02-11,9,119,170,51,459
301,30,8,2025-02-11,8,429,599,170,1360
371,8,15,2025-02-11,4,374,433,59,236
751,29,14,2025-02-12,3,200,260,60,180
79,30,12,2025-02-21,16,329,380,51,816
806,14,8,2025-02-19,5,493,637,144,720
796,30,14,2025-02-22,19,360,400,40,760
267,26,10,2025-02-11,11,80,87,7,77
432,17,5,2025-02-19,16,343,496,153,2448
203,29,6,2025-02-15,1,105,116,11,11
270,25,18,2025-02-23,16,400,438,38,608
891,2,27,2025-02-14,1,373,420,47,47
75,5,17,2025-02-28,17,490,600,110,1870
433,12,5,2025-02-13,18,143,196,53,954
122,11,29,2025-02-27,11,322,426,104,1144
111,24,2,2025-02-03,12,249,363,114,1368
646,15,24,2025-02-27,14,168,234,66,924
717,5,24,2025-02-06,19,489,694,205,3895
522,3,5,2025-02-01,19,323,393,70,1330
665,15,13,2025-02-11,15,110,141,31,465
603,9,25,2025-02-04,8,172,219,47,376
50,19,17,2025-02-17,19,280,400,120,2280
437,10,11,2025-02-13,11,407,460,53,583
147,2,27,2025-02-24,7,240,308,68,476
589,29,20,2025-02-11,4,197,232,35,140
122,10,9,2025-02-16,15,134,194,60,900
296,30,9,2025-02-20,4,493,569,76,304
286,5,4,2025-02-07,18,449,574,125,2250
173,1,20,2025-02-02,18,295,416,121,2178
7,16,27,2025-02-27,1,209,239,30,30
965,19,14,2025-02-24,15,286,317,31,465
465,10,30,2025-02-04,4,247,358,111,444
506,9,3,2025-02-28,5,162,223,61,305
120,12,26,2025-02-03,8,392,425,33,264
161,17,11,2025-02-09,15,342,472,130,1950
689,25,3,2025-02-23,11,476,698,222,2442
444,4,30,2025-02-23,17,182,207,25,425
572,22,27,2025-02-21,2,344,458,114,228
252,5,19,2025-02-13,8,364,414,50,400
482,5,16,2025-02-27,6,395,503,108,648
135,7,21,2025-02-03,17,458,630,172,2924
220,1,14,2025-02-03,16,305,404,99,1584
728,6,2,2025-02-14,9,334,408,74,666
598,8,21,2025-02-12,16,291,392,101,1616
185,29,10,2025-02-27,8,468,553,85,680
497,16,26,2025-02-21,13,326,395,69,897
493,10,4,2025-02-08,4,471,685,214,856
783,10,14,2025-02-15,11,146,197,51,561
119,6,15,2025-02-11,4,197,269,72,288
722,5,25,2025-02-16,16,327,404,77,1232
241,1,10,2025-02-09,17,130,189,59,1003
802,14,2,2025-02-18,11,153,207,54,594
422,13,26,2025-02-15,14,224,261,37,518
56,9,16,2025-02-24,8,193,258,65,520
47,10,15,2025-02-14,8,313,452,139,1112
549,7,25,2025-02-21,4,334,442,108,432
133,20,18,2025-02-01,1,430,525,95,95
800,23,11,2025-02-12,18,52,70,18,324
532,7,12,2025-02-18,7,100,143,43,301
406,28,23,2025-02-08,10,430,483,53,530
383,11,14,2025-02-07,18,395,459,64,1152
14,2,28,2025-02-01,17,72,92,20,340
811,16,2,2025-02-06,10,174,185,11,110
647,25,23,2025-02-08,2,159,221,62,124
833,26,13,2025-02-21,13,87,123,36,468
898,9,28,2025-02-03,3,57,73,16,48
721,25,24,2025-02-14,1,27,37,10,10
555,20,30,2025-02-05,4,396,521,125,500
401,7,27,2025-02-20,10,421,503,82,820
525,24,1,2025-02-10,9,254,290,36,324
271,21,19,2025-02-16,13,169,210,41,533
228,14,18,2025-02-09,16,165,241,76,1216
547,17,8,2025-02-13,1,274,377,103,103
975,12,25,2025-02-18,4,251,289,38,152
999,1,13,2025-02-25,8,248,302,54,432
577,4,21,2025-02-10,11,93,132,39,429
1000,3,4,2025-02-18,6,126,181,55,330
502,19,8,2025-02-03,5,226,300,74,370
485,17,24,2025-02-27,19,409,472,63,1197
786,16,9,2025-02-14,10,399,480,81,810
155,2,11,2025-02-23,19,326,402,76,1444
6,9,23,2025-02-07,18,426,541,115,2070
512,11,21,2025-02-08,11,256,350,94,1034
527,18,28,2025-02-24,3,491,539,48,144
717,3,13,2025-02-05,1,102,131,29,29
125,6,7,2025-02-15,4,39,56,17,68
508,6,21,2025-02-26,17,269,299,30,510
896,18,14,2025-02-13,1,171,189,18,18
302,24,30,2025-02-22,9,287,343,56,504
911,12,19,2025-02-21,6,92,109,17,102
702,7,26,2025-02-20,12,285,377,92,1104
484,15,7,2025-02-11,5,104,134,30,150
850,16,1,2025-02-11,14,111,124,13,182
69,1,10,2025-02-23,7,122,166,44,308
551,15,11,2025-02-04,2,339,427,88,176
161,3,12,2025-02-21,18,472,544,72,1296
644,1,30,2025-02-07,9,165,234,69,621
889,14,19,2025-02-24,10,208,277,69,690
413,30,9,2025-02-18,18,348,469,121,2178
80,19,5,2025-02-04,7,163,184,21,147
578,4,5,2025-02-26,17,320,429,109,1853
393,11,19,2025-02-25,19,329,386,57,1083
827,24,28,2025-02-20,16,127,143,16,256
803,8,7,2025-02-03,20,95,106,11,220
487,28,1,2025-02-11,3,478,711,233,699
141,17,26,2025-02-15,14,360,454,94,1316
310,17,25,2025-02-04,8,306,375,69,552
793,13,23,2025-02-16,12,179,256,77,924
325,17,3,2025-02-20,7,105,155,50,350
854,9,23,2025-02-05,14,306,382,76,1064
712,26,9,2025-02-22,4,305,444,139,556
668,12,6,2025-02-01,12,457,576,119,1428
687,12,24,2025-02-14,7,335,436,101,707
943,7,13,2025-02-12,6,497,689,192,1152
11,7,15,2025-02-12,17,119,125,6,102
318,11,4,2025-02-12,9,277,406,129,1161
622,9,2,2025-02-21,9,348,440,92,828
45,23,23,2025-02-09,9,340,366,26,234
586,27,1,2025-02-28,16,331,442,111,1776
503,6,16,2025-02-24,18,433,475,42,756
379,1,20,2025-02-23,5,381,526,145,725
892,28,5,2025-02-03,14,447,639,192,2688
58,15,21,2025-02-23,2,180,197,17,34
558,9,28,2025-02-07,20,397,420,23,460
858,22,28,2025-02-11,6,483,722,239,1434
740,12,17,2025-02-01,13,233,332,99,1287
686,2,3,2025-02-07,17,95,131,36,612
86,6,15,2025-02-02,9,331,377,46,414
518,14,6,2025-02-21,1,179,210,31,31
360,4,11,2025-02-15,19,448,611,163,3097
580,30,15,2025-02-03,4,490,534,44,176
748,3,6,2025-02-11,19,340,505,165,3135
786,6,26,2025-02-01,7,346,422,76,532
84,29,24,2025-02-08,10,448,608,160,1600
966,29,28,2025-02-07,5,178,191,13,65
723,10,6,2025-02-09,5,309,368,59,295
232,27,7,2025-02-09,7,110,164,54,378
266,23,15,2025-02-09,3,270,327,57,171
373,12,25,2025-02-21,17,250,356,106,1802
704,27,6,2025-02-02,19,217,243,26,494
583,7,23,2025-02-14,12,350,495,145,1740
816,10,7,2025-02-11,17,302,430,128,2176
814,9,3,2025-02-17,7,152,175,23,161
268,2,30,2025-02-04,17,357,476,119,2023
487,5,15,2025-02-19,11,210,274,64,704
675,19,29,2025-02-02,11,379,416,37,407
368,28,29,2025-02-01,6,235,297,62,372
345,21,29,2025-02-04,6,487,590,103,618
167,15,18,2025-02-06,1,244,345,101,101
468,19,19,2025-02-23,14,394,485,91,1274
855,8,9,2025-02-24,12,327,393,66,792
695,13,10,2025-02-02,8,410,603,193,1544
950,17,4,2025-02-14,14,416,487,71,994
592,13,19,2025-02-01,6,282,317,35,210
308,29,20,2025-02-23,17,121,179,58,986
582,25,5,2025-02-05,11,423,627,204,2244
994,3,10,2025-02-26,5,430,518,88,440
406,6,15,2025-02-01,5,122,177,55,275
309,10,3,2025-02-06,8,459,524,65,520
93,24,8,2025-02-05,18,452,632,180,3240
6,16,6,2025-02-12,4,261,339,78,312
404,23,7,2025-02-16,13,445,560,115,1495
249,25,30,2025-02-04,13,85,101,16,208
958,5,13,2025-02-25,11,479,564,85,935
691,24,28,2025-02-14,20,221,285,64,1280
356,16,22,2025-02-24,19,33,38,5,95
624,6,25,2025-02-08,12,205,247,42,504
843,1,20,2025-02-20,13,488,529,41,533
236,5,16,2025-02-07,2,128,152,24,48
96,11,13,2025-02-21,6,237,265,28,168
319,13,22,2025-02-27,16,37,43,6,96
978,14,6,2025-02-06,13,369,473,104,1352
109,15,26,2025-02-03,12,371,512,141,1692
672,28,13,2025-02-26,1,102,122,20,20
589,17,13,2025-02-22,15,25,32,7,105
983,22,13,2025-02-14,2,175,217,42,84
760,21,4,2025-02-20,15,277,337,60,900
485,23,11,2025-02-28,18,206,227,21,378
184,14,18,2025-02-25,13,465,629,164,2132
154,1,11,2025-02-23,19,152,173,21,399
833,20,24,2025-02-28,15,242,259,17,255
289,2,4,2025-02-28,16,255,310,55,880
911,20,22,2025-02-12,9,237,285,48,432
304,25,27,2025-02-01,18,156,176,20,360
366,14,1,2025-02-15,11,172,230,58,638
611,4,12,2025-02-24,2,292,404,112,224
255,6,3,2025-02-18,4,84,116,32,128
649,16,14,2025-02-09,12,254,345,91,1092
250,30,27,2025-02-27,17,311,391,80,1360
79,11,12,2025-02-02,5,331,493,162,810
654,26,29,2025-02-04,13,282,420,138,1794
81,11,30,2025-02-21,10,236,290,54,540
189,24,9,2025-02-24,3,448,654,206,618
989,4,26,2025-02-07,19,153,229,76,1444
631,17,18,2025-02-28,8,375,529,154,1232
384,19,16,2025-02-07,14,160,222,62,868
797,6,9,2025-02-17,2,329,404,75,150
186,22,10,2025-02-09,1,228,261,33,33
801,14,22,2025-02-05,9,156,196,40,360
810,21,11,2025-02-04,8,135,143,8,64
333,8,3,2025-02-20,10,392,537,145,1450
847,15,19,2025-02-14,20,188,243,55,1100
488,30,18,2025-02-01,11,194,232,38,418
843,15,5,2025-02-15,16,127,164,37,592
175,22,13,2025-02-09,13,36,49,13,169
586,3,21,2025-02-16,18,196,213,17,306
766,17,12,2025-02-10,10,404,482,78,780
691,15,1,2025-02-05,20,319,359,40,800
361,19,14,2025-02-14,1,404,601,197,197
570,24,16,2025-02-08,13,491,634,143,1859
388,20,28,2025-02-04,4,222,255,33,132
114,19,10,2025-02-06,6,412,577,165,990
753,13,18,2025-02-14,12,404,464,60,720
923,20,9,2025-02-11,12,342,375,33,396
906,22,21,2025-02-25,11,277,358,81,891
402,8,28,2025-02-13,16,407,512,105,1680
846,30,15,2025-02-06,6,224,264,40,240
546,27,11,2025-02-25,15,355,400,45,675
930,4,13,2025-02-19,14,234,289,55,770
652,1,20,2025-02-08,5,332,441,109,545
83,20,19,2025-02-24,14,31,37,6,84
256,6,19,2025-02-21,16,370,404,34,544
380,1,24,2025-02-20,13,302,387,85,1105
198,28,30,2025-02-06,15,208,286,78,1170
246,6,16,2025-02-23,7,185,205,20,140
67,29,1,2025-02-07,19,256,322,66,1254
701,20,15,2025-02-08,6,256,326,70,420
114,26,20,2025-02-27,11,466,682,216,2376
164,8,15,2025-02-24,3,23,32,9,27
699,22,14,2025-02-28,17,260,374,114,1938
73,26,14,2025-02-09,18,81,111,30,540
622,21,18,2025-02-23,1,244,309,65,65
744,2,10,2025-02-26,13,444,630,186,2418
788,2,12,2025-02-13,17,342,459,117,1989
439,26,4,2025-02-04,5,453,529,76,380
846,19,25,2025-02-26,4,389,438,49,196
423,22,11,2025-02-05,8,427,541,114,912
271,4,11,2025-02-21,3,254,369,115,345
504,25,8,2025-02-25,9,195,231,36,324
456,11,26,2025-02-15,9,310,364,54,486
37,25,5,2025-02-05,17,167,177,10,170
902,12,19,2025-02-12,10,177,261,84,840
163,19,21,2025-02-10,16,385,480,95,1520
302,5,24,2025-02-26,5,95,126,31,155
880,13,9,2025-02-21,8,34,49,15,120
598,10,5,2025-02-19,1,152,185,33,33
521,24,28,2025-02-17,13,264,351,87,1131
175,12,21,2025-02-05,19,456,582,126,2394
536,12,13,2025-02-28,16,351,395,44,704
538,16,6,2025-02-16,13,27,36,9,117
67,11,8,2025-02-10,7,134,150,16,112
624,25,24,2025-02-26,4,352,401,49,196
511,15,19,2025-02-21,1,450,624,174,174
839,26,26,2025-02-17,8,399,455,56,448
681,2,13,2025-02-21,4,188,240,52,208
278,18,18,2025-02-28,18,466,506,40,720
818,2,15,2025-02-19,17,146,169,23,391
817,24,6,2025-02-23,8,136,185,49,392
468,6,2,2025-02-20,9,302,355,53,477
761,7,24,2025-02-27,3,483,703,220,660
536,10,2,2025-02-07,8,144,189,45,360
596,16,15,2025-02-04,18,471,660,189,3402
327,26,21,2025-02-03,7,264,291,27,189
86,16,7,2025-02-04,18,321,368,47,846
499,10,19,2025-02-01,19,240,345,105,1995
115,24,29,2025-02-15,7,321,453,132,924
630,25,15,2025-02-01,9,406,501,95,855
278,16,21,2025-02-06,11,279,354,75,825
291,21,10,2025-02-09,18,147,177,30,540
695,18,17,2025-02-10,15,77,115,38,570
969,6,16,2025-02-01,11,477,710,233,2563
482,16,6,2025-02-06,3,409,509,100,300
312,4,30,2025-02-28,15,195,261,66,990
552,27,6,2025-02-07,4,410,473,63,252
315,17,10,2025-02-11,17,261,286,25,425
308,30,20,2025-02-07,19,364,408,44,836
161,7,25,2025-02-13,6,456,511,55,330
679,6,11,2025-02-17,16,354,467,113,1808
427,25,24,2025-02-09,8,497,581,84,672
957,28,27,2025-02-10,12,94,112,18,216
745,12,27,2025-02-24,11,250,297,47,517
577,13,25,2025-02-14,1,410,604,194,194
57,14,12,2025-02-21,5,253,353,100,500
20,27,23,2025-02-07,7,358,491,133,931
302,27,12,2025-02-01,11,238,335,97,1067
334,18,18,2025-02-24,7,428,491,63,441
516,15,28,2025-02-09,4,58,67,9,36
334,24,16,2025-02-24,19,260,384,124,2356
970,2,25,2025-02-22,13,372,551,179,2327
724,16,8,2025-02-09,20,320,390,70,1400
104,2,21,2025-02-11,9,295,359,64,576
946,10,4,2025-02-16,5,470,652,182,910
333,25,24,2025-02-14,5,467,522,55,275
307,19,7,2025-02-18,3,244,283,39,117
587,18,25,2025-02-22,9,305,393,88,792
299,23,1,2025-02-05,3,465,653,188,564
729,24,11,2025-02-28,12,483,675,192,2304
766,29,7,2025-02-06,11,259,298,39,429
371,11,7,2025-02-22,9,150,198,48,432
956,1,5,2025-02-04,14,238,292,54,756
499,26,2,2025-02-27,17,50,73,23,391
525,12,1,2025-02-19,14,36,53,17,238
895,26,11,2025-02-26,18,271,319,48,864
342,21,3,2025-02-24,3,309,337,28,84
572,25,4,2025-02-18,6,428,548,120,720
872,3,19,2025-02-15,20,352,527,175,3500
770,3,25,2025-02-22,14,438,514,76,1064
463,29,29,2025-02-24,5,353,423,70,350
187,21,19,2025-02-11,15,290,406,116,1740
758,27,14,2025-02-01,13,314,371,57,741
639,27,13,2025-02-01,1,135,161,26,26
155,9,28,2025-02-08,19,365,509,144,2736
546,15,21,2025-02-22,7,414,588,174,1218
948,12,29,2025-02-23,19,98,111,13,247
152,7,10,2025-02-06,4,33,43,10,40
968,28,2,2025-02-25,5,296,357,61,305
71,11,28,2025-02-11,8,356,407,51,408
311,6,14,2025-02-09,8,499,731,232,1856
791,12,1,2025-02-05,15,83,118,35,525
385,1,15,2025-02-28,7,214,229,15,105
450,13,7,2025-02-07,13,322,456,134,1742
96,6,17,2025-02-19,17,82,92,10,170
215,4,16,2025-02-24,20,203,282,79,1580
325,14,7,2025-02-07,3,429,548,119,357
490,9,17,2025-02-04,15,28,29,1,15
823,14,13,2025-02-28,4,201,244,43,172
318,27,3,2025-02-14,10,137,205,68,680
87,21,21,2025-02-26,13,468,591,123,1599
975,9,24,2025-02-21,11,43,48,5,55
255,6,19,2025-02-01,5,285,319,34,170
712,16,25,2025-02-02,2,325,459,134,268
888,24,22,2025-02-10,12,336,416,80,960
162,14,6,2025-02-06,17,97,134,37,629
830,22,6,2025-02-12,4,422,474,52,208
510,7,10,2025-02-13,12,485,693,208,2496
637,11,1,2025-02-26,1,189,201,12,12
482,2,24,2025-02-28,5,487,601,114,570
553,13,25,2025-02-20,17,106,119,13,221
16,12,29,2025-02-08,3,234,350,116,348
116,16,15,2025-02-14,18,245,272,27,486
618,26,21,2025-02-01,10,263,332,69,690
925,9,5,2025-02-11,18,207,306,99,1782
685,23,4,2025-02-16,16,403,574,171,2736
585,7,5,2025-02-08,17,86,121,35,595
147,8,22,2025-02-03,4,387,477,90,360
909,20,4,2025-02-08,8,148,168,20,160
676,10,11,2025-02-23,15,362,476,114,1710
530,19,29,2025-02-09,5,187,232,45,225
678,5,19,2025-02-24,2,402,586,184,368
395,21,2,2025-02-26,7,113,119,6,42
650,2,27,2025-02-26,8,102,125,23,184
12,19,16,2025-02-16,12,116,155,39,468
837,19,13,2025-02-15,7,252,335,83,581
559,15,4,2025-02-24,9,355,496,141,1269
947,11,11,2025-02-06,9,194,274,80,720
500,25,18,2025-02-15,4,362,520,158,632
782,17,9,2025-02-03,12,238,319,81,972
988,18,5,2025-02-04,8,254,362,108,864
124,18,23,2025-02-10,5,467,563,96,480
464,14,18,2025-02-03,17,113,139,26,442
964,29,17,2025-02-07,5,450,610,160,800
795,1,7,2025-02-24,12,289,382,93,1116
156,19,28,2025-02-17,17,44,62,18,306
372,18,8,2025-02-23,17,105,128,23,391
103,22,6,2025-02-21,20,135,193,58,1160
770,23,5,2025-02-18,20,237,340,103,2060
286,2,13,2025-02-10,13,481,618,137,1781
432,29,16,2025-02-15,11,89,122,33,363
308,1,3,2025-02-09,18,362,431,69,1242
946,24,20,2025-02-20,3,50,69,19,57
144,5,16,2025-02-27,6,411,611,200,1200
1000,8,13,2025-02-26,6,350,433,83,498
606,7,8,2025-02-27,12,56,65,9,108
972,9,5,2025-02-13,4,391,541,150,600
968,22,5,2025-02-07,15,92,124,32,480
779,11,1,2025-02-21,4,286,340,54,216
106,25,21,2025-02-20,16,138,186,48,768
306,27,4,2025-02-18,20,252,282,30,600
902,25,30,2025-02-24,11,468,549,81,891
42,13,27,2025-02-09,4,340,428,88,352
600,6,29,2025-02-23,16,408,482,74,1184
536,4,3,2025-02-24,20,326,469,143,2860
248,28,28,2025-02-22,16,448,612,164,2624
443,14,2,2025-02-21,4,462,645,183,732
863,24,24,2025-02-09,9,347,444,97,873
430,22,27,2025-02-09,12,62,65,3,36
731,26,16,2025-02-08,19,273,314,41,779
445,22,9,2025-02-04,16,307,406,99,1584
580,13,20,2025-02-17,13,41,54,13,169
605,27,26,2025-02-21,4,314,343,29,116
990,25,8,2025-02-12,19,364,498,134,2546
619,14,27,2025-02-13,2,197,264,67,134
451,28,15,2025-02-19,17,39,57,18,306
833,26,21,2025-02-24,14,362,528,166,2324
222,19,6,2025-02-01,11,70,83,13,143
423,26,1,2025-02-24,15,454,659,205,3075
368,27,22,2025-02-12,12,147,173,26,312
803,2,11,2025-02-15,9,413,581,168,1512
215,18,25,2025-02-28,18,351,419,68,1224
411,25,12,2025-02-25,6,452,576,124,744
92,11,12,2025-02-20,18,398,562,164,2952
990,8,11,2025-02-27,10,71,104,33,330
93,21,13,2025-02-11,20,274,367,93,1860
775,13,7,2025-02-09,16,199,239,40,640
449,29,12,2025-02-25,6,106,127,21,126
115,7,19,2025-02-10,17,378,506,128,2176
304,25,18,2025-02-18,6,223,296,73,438
78,7,3,2025-02-03,20,488,705,217,4340
415,28,9,2025-02-05,11,292,353,61,671
137,30,13,2025-02-04,10,334,436,102,1020
85,11,8,2025-02-15,2,145,188,43,86
684,9,1,2025-02-16,8,446,608,162,1296
225,8,29,2025-02-08,15,351,497,146,2190
149,1,10,2025-02-08,1,459,608,149,149
859,15,14,2025-02-18,18,310,352,42,756
191,28,17,2025-02-19,13,341,446,105,1365
924,13,24,2025-02-09,12,431,608,177,2124
442,12,12,2025-02-08,11,296,358,62,682
982,23,5,2025-02-11,8,427,552,125,1000
132,4,30,2025-02-26,17,382,483,101,1717
322,4,26,2025-02-27,20,136,187,51,1020
735,23,21,2025-02-18,8,258,302,44,352
857,2,15,2025-02-20,15,274,361,87,1305
67,6,1,2025-02-18,15,306,411,105,1575
918,12,16,2025-02-28,5,52,71,19,95
67,24,9,2025-02-19,9,479,660,181,1629
731,20,16,2025-02-14,5,222,255,33,165
463,10,18,2025-02-23,10,189,218,29,290
818,29,17,2025-02-14,5,412,533,121,605
698,19,11,2025-02-28,1,332,357,25,25
773,12,19,2025-02-04,3,334,360,26,78
424,24,6,2025-02-24,7,147,219,72,504
793,25,6,2025-02-27,6,35,47,12,72
507,24,4,2025-02-11,3,68,100,32,96
588,23,22,2025-02-13,14,215,293,78,1092
142,28,11,2025-02-06,4,179,217,38,152
725,14,29,2025-02-09,16,66,75,9,144
412,7,8,2025-02-12,3,193,242,49,147
97,17,9,2025-02-01,20,51,76,25,500
61,22,12,2025-02-04,6,20,30,10,60
542,1,1,2025-02-11,13,176,187,11,143
927,19,19,2025-02-12,3,108,123,15,45
636,16,6,2025-02-18,7,196,214,18,126
700,30,5,2025-02-20,12,313,354,41,492
452,23,28,2025-02-25,6,279,312,33,198
839,15,1,2025-02-20,2,498,643,145,290
982,26,4,2025-02-26,10,498,588,90,900
358,22,6,2025-02-19,17,105,153,48,816
510,7,20,2025-02-05,20,491,590,99,1980
466,30,22,2025-02-18,13,421,527,106,1378
120,22,18,2025-02-03,11,146,177,31,341
246,27,16,2025-02-07,13,41,50,9,117
939,30,16,2025-02-26,19,70,100,30,570
94,22,21,2025-02-11,17,308,403,95,1615
545,17,13,2025-02-25,18,349,398,49,882
329,5,15,2025-02-25,7,169,249,80,560
437,13,14,2025-02-13,3,271,287,16,48
107,11,18,2025-02-16,20,219,260,41,820
806,25,10,2025-02-25,2,290,413,123,246
193,3,10,2025-02-19,19,297,335,38,722
322,24,2,2025-02-18,1,44,65,21,21
395,7,12,2025-02-18,2,441,627,186,372
895,14,24,2025-02-17,17,454,513,59,1003
380,22,23,2025-02-02,7,70,88,18,126
191,29,8,2025-02-23,11,57,78,21,231
508,7,19,2025-02-21,20,27,29,2,40
391,7,29,2025-02-23,4,493,582,89,356
927,8,22,2025-02-27,11,110,164,54,594
847,8,12,2025-02-27,13,42,47,5,65
614,8,20,2025-02-22,9,471,690,219,1971
697,19,23,2025-02-28,10,124,183,59,590
670,24,30,2025-02-09,14,373,393,20,280
844,14,13,2025-02-09,7,438,613,175,1225
260,20,1,2025-02-21,13,41,56,15,195
460,5,22,2025-02-23,8,56,75,19,152
119,6,29,2025-02-26,16,54,61,7,112
336,6,24,2025-02-09,13,165,213,48,624
292,28,19,2025-02-09,4,409,451,42,168
843,29,29,2025-02-07,3,304,435,131,393
206,5,17,2025-02-02,16,265,291,26,416
235,2,27,2025-02-13,6,62,86,24,144
826,3,8,2025-02-14,20,209,261,52,1040
147,15,20,2025-02-25,2,359,528,169,338
786,7,25,2025-02-07,11,42,55,13,143
972,5,11,2025-02-28,9,491,554,63,567
474,7,29,2025-02-21,2,220,269,49,98
970,10,17,2025-02-03,8,114,152,38,304
344,22,24,2025-02-15,1,466,582,116,116
864,8,20,2025-02-17,10,305,342,37,370
561,11,2,2025-02-04,3,229,294,65,195
18,20,24,2025-02-06,11,209,223,14,154
924,4,22,2025-02-08,1,215,226,11,11
60,27,13,2025-02-25,19,81,116,35,665
781,21,2,2025-02-19,18,57,60,3,54
844,30,16,2025-02-19,13,164,223,59,767
397,15,30,2025-02-24,8,369,469,100,800
257,12,21,2025-02-15,16,490,713,223,3568
466,18,29,2025-02-12,8,93,110,17,136
749,6,13,2025-02-09,6,208,288,80,480
443,26,10,2025-02-05,2,255,315,60,120
901,18,28,2025-02-08,13,84,120,36,468
362,7,13,2025-02-14,14,255,352,97,1358
455,13,15,2025-02-12,11,186,251,65,715
137,24,17,2025-02-07,8,131,180,49,392
583,7,28,2025-02-24,20,206,300,94,1880
562,28,25,2025-02-26,14,211,283,72,1008
219,13,5,2025-02-16,4,297,399,102,408
308,29,27,2025-02-25,20,231,248,17,340
223,11,18,2025-02-06,13,499,640,141,1833
185,15,1,2025-02-23,7,217,283,66,462
177,9,24,2025-02-22,19,413,463,50,950
412,19,26,2025-02-26,7,97,120,23,161
480,8,28,2025-02-24,5,410,602,192,960
324,20,30,2025-02-25,20,291,402,111,2220
897,2,22,2025-02-04,3,63,67,4,12
943,28,28,2025-02-02,11,456,497,41,451
954,29,12,2025-02-07,5,129,153,24,120
68,12,20,2025-02-11,19,483,687,204,3876
487,11,23,2025-02-06,10,175,192,17,170
576,6,29,2025-02-05,6,232,256,24,144
933,20,14,2025-02-06,18,302,403,101,1818
717,9,23,2025-02-28,8,78,105,27,216
151,30,15,2025-02-04,2,89,129,40,80
485,13,16,2025-02-06,1,320,435,115,115
838,12,30,2025-02-15,19,312,353,41,779
916,1,16,2025-02-22,19,196,284,88,1672
88,29,12,2025-02-03,6,89,118,29,174
694,13,30,2025-02-05,4,498,700,202,808
685,7,21,2025-02-11,10,384,540,156,1560
806,3,12,2025-02-20,16,28,37,9,144
605,14,6,2025-02-12,9,118,151,33,297
533,29,30,2025-02-01,16,183,267,84,1344
54,21,8,2025-02-23,10,154,193,39,390
444,11,2,2025-02-09,15,357,388,31,465
565,2,5,2025-02-28,20,25,35,10,200
20,10,13,2025-02-07,16,214,262,48,768
712,22,9,2025-02-23,13,191,232,41,533
525,28,26,2025-02-14,14,382,460,78,1092
966,12,24,2025-02-09,18,118,150,32,576
274,3,30,2025-02-15,3,432,583,151,453
327,28,17,2025-02-04,1,435,482,47,47
781,4,8,2025-02-03,6,211,228,17,102
586,26,8,2025-02-25,3,462,501,39,117
741,1,24,2025-02-26,11,465,678,213,2343
73,5,19,2025-02-21,15,343,495,152,2280
805,22,4,2025-02-20,4,48,66,18,72
205,30,24,2025-02-03,6,66,91,25,150
94,1,14,2025-02-26,8,127,136,9,72
82,13,11,2025-02-21,17,118,149,31,527
203,23,16,2025-02-20,6,260,307,47,282
693,19,28,2025-02-28,2,246,279,33,66
7,3,6,2025-02-07,9,93,134,41,369
590,7,23,2025-02-04,3,116,132,16,48
330,25,8,2025-02-06,13,345,492,147,1911
304,20,14,2025-02-17,10,131,163,32,320
845,12,24,2025-02-08,17,23,31,8,136
992,22,9,2025-02-10,6,53,57,4,24
506,12,29,2025-02-24,2,337,468,131,262
441,3,22,2025-02-25,15,26,39,13,195
691,3,11,2025-02-19,12,377,511,134,1608
695,3,19,2025-02-09,11,250,303,53,583
831,16,12,2025-02-16,10,410,521,111,1110
560,24,7,2025-02-08,19,107,114,7,133
362,14,15,2025-02-15,11,492,693,201,2211
968,13,15,2025-02-28,15,251,281,30,450
756,25,13,2025-02-14,1,467,520,53,53
325,13,28,2025-02-21,5,224,272,48,240
445,26,27,2025-02-22,6,97,128,31,186
189,7,4,2025-02-01,13,261,292,31,403
346,7,1,2025-02-16,13,101,120,19,247
979,28,18,2025-02-09,8,117,148,31,248
742,16,14,2025-02-14,6,269,400,131,786
62,12,4,2025-02-03,11,381,482,101,1111
297,5,8,2025-02-17,16,431,495,64,1024
503,1,10,2025-02-21,6,193,257,64,384
701,20,14,2025-02-20,4,326,361,35,140
289,11,24,2025-02-12,5,209,273,64,320
485,3,1,2025-02-15,12,233,270,37,444
968,11,23,2025-02-08,11,344,503,159,1749
996,16,26,2025-02-09,18,194,254,60,1080
340,23,7,2025-02-05,11,420,561,141,1551
995,30,8,2025-02-23,19,332,384,52,988
840,8,16,2025-02-19,16,475,503,28,448
524,29,4,2025-02-13,5,339,405,66,330
542,16,15,2025-02-20,9,54,68,14,126
797,7,26,2025-02-25,9,384,428,44,396
869,25,2,2025-02-16,8,134,179,45,360
336,12,27,2025-02-20,16,307,343,36,576
280,11,16,2025-02-11,20,472,610,138,2760
844,26,21,2025-02-07,20,329,363,34,680
752,2,24,2025-02-07,17,429,548,119,2023
255,26,13,2025-02-14,1,172,201,29,29
148,10,1,2025-02-01,14,60,73,13,182
795,30,5,2025-02-15,13,304,341,37,481
455,25,11,2025-02-04,9,253,297,44,396
724,20,15,2025-02-10,6,320,355,35,210
980,1,4,2025-02-02,11,302,382,80,880
146,11,27,2025-02-24,13,301,319,18,234
445,21,11,2025-02-13,6,187,248,61,366
779,2,21,2025-02-10,11,309,430,121,1331
41,29,17,2025-02-02,5,274,296,22,110
70,5,5,2025-02-04,17,103,152,49,833
241,3,25,2025-02-12,12,193,210,17,204
352,25,3,2025-02-16,13,299,322,23,299
427,21,26,2025-02-13,5,300,426,126,630
834,7,15,2025-02-06,4,410,599,189,756
268,8,8,2025-02-02,18,32,34,2,36
864,23,8,2025-02-16,2,41,47,6,12
239,5,28,2025-02-05,17,183,219,36,612
775,21,22,2025-02-13,1,281,392,111,111
505,1,22,2025-02-23,14,301,325,24,336
205,19,2,2025-02-07,8,318,404,86,688
358,23,3,2025-02-19,12,280,407,127,1524
169,13,7,2025-02-05,18,23,34,11,198
763,20,10,2025-02-09,18,211,270,59,1062
164,27,7,2025-02-25,20,151,181,30,600
335,29,9,2025-02-13,4,353,416,63,252
30,15,20,2025-02-21,17,414,510,96,1632
190,4,2,2025-02-13,4,400,588,188,752
211,7,25,2025-02-19,10,446,607,161,1610
220,29,19,2025-02-27,10,204,257,53,530
664,21,8,2025-02-19,9,131,168,37,333
318,1,7,2025-02-27,6,460,552,92,552
512,24,13,2025-02-24,11,254,379,125,1375
617,25,6,2025-02-16,16,307,405,98,1568
815,22,28,2025-02-08,3,335,368,33,99
1,28,1,2025-02-20,2,458,483,25,50
281,30,1,2025-02-10,15,215,296,81,1215
985,6,4,2025-02-02,12,130,174,44,528
995,14,24,2025-02-12,3,163,202,39,117
23,10,25,2025-02-02,4,174,194,20,80
468,30,30,2025-02-26,7,81,119,38,266
763,22,26,2025-02-01,16,109,115,6,96
89,24,8,2025-02-15,19,375,488,113,2147
277,1,23,2025-02-19,16,52,72,20,320
157,7,3,2025-02-13,13,35,37,2,26
443,27,15,2025-02-14,6,26,34,8,48
46,22,3,2025-02-25,9,383,451,68,612
491,7,26,2025-02-09,1,363,426,63,63
893,7,8,2025-02-23,15,434,456,22,330
666,2,28,2025-02-19,14,306,452,146,2044
501,26,8,2025-02-23,2,166,201,35,70
613,12,15,2025-02-27,16,298,335,37,592
675,29,12,2025-02-24,18,296,330,34,612
753,21,12,2025-02-14,6,317,390,73,438
479,12,25,2025-02-10,5,436,590,154,770
911,16,22,2025-02-18,14,204,302,98,1372
89,20,9,2025-02-05,11,493,597,104,1144
478,15,25,2025-02-18,6,475,508,33,198
519,30,28,2025-02-21,5,326,392,66,330
648,27,24,2025-02-06,19,91,136,45,855
812,7,27,2025-02-23,13,61,87,26,338
902,4,17,2025-02-18,2,286,314,28,56
5,9,30,2025-02-18,6,398,459,61,366
727,26,11,2025-02-16,4,186,257,71,284
817,12,18,2025-02-13,17,356,505,149,2533
225,19,12,2025-02-24,14,372,516,144,2016
109,8,21,2025-02-21,15,99,141,42,630
917,25,7,2025-02-23,1,477,671,194,194
517,26,4,2025-02-16,5,488,528,40,200
973,10,8,2025-02-25,13,175,249,74,962
555,21,4,2025-02-27,7,32,34,2,14
303,4,7,2025-02-06,3,54,63,9,27
974,4,14,2025-02-12,13,25,34,9,117
308,11,13,2025-02-12,7,175,217,42,294
604,30,16,2025-02-21,20,323,345,22,440
504,2,16,2025-02-11,12,35,41,6,72
485,28,26,2025-02-13,18,414,453,39,702
706,19,20,2025-02-12,16,33,40,7,112
986,16,25,2025-02-03,16,149,193,44,704
85,8,24,2025-02-27,4,252,308,56,224
346,8,20,2025-02-16,2,185,220,35,70
796,23,28,2025-02-15,7,334,412,78,546
11,22,5,2025-02-19,1,498,636,138,138
71,17,6,2025-02-15,9,376,490,114,1026
821,30,18,2025-02-21,2,149,196,47,94
715,17,16,2025-02-06,15,170,244,74,1110
41,10,20,2025-02-11,14,76,103,27,378
992,27,3,2025-02-07,16,268,311,43,688
397,25,24,2025-02-26,6,415,506,91,546
310,6,8,2025-02-11,19,452,575,123,2337
731,15,26,2025-02-23,4,71,80,9,36
136,24,20,2025-02-19,1,244,311,67,67
814,23,14,2025-02-01,17,479,653,174,2958
651,18,4,2025-02-14,16,37,43,6,96
571,23,14,2025-02-03,3,64,75,11,33
972,22,12,2025-02-16,13,279,408,129,1677
929,30,29,2025-02-05,4,32,36,4,16
585,6,22,2025-02-07,15,357,535,178,2670
383,18,9,2025-02-16,3,424,570,146,438
597,14,4,2025-02-18,2,138,157,19,38
308,5,24,2025-02-23,13,25,30,5,65
523,26,1,2025-02-04,17,360,421,61,1037
544,1,10,2025-02-26,5,183,268,85,425
882,16,26,2025-02-07,7,359,454,95,665
491,7,4,2025-02-06,13,303,405,102,1326
555,28,26,2025-02-03,5,361,400,39,195
523,5,28,2025-02-25,3,264,338,74,222
75,19,6,2025-02-08,14,449,598,149,2086
961,8,27,2025-02-09,14,50,69,19,266
44,28,11,2025-02-25,13,34,39,5,65
744,30,12,2025-02-13,15,330,471,141,2115
231,24,30,2025-02-05,16,334,493,159,2544
522,29,14,2025-02-21,6,143,189,46,276
295,16,25,2025-02-03,14,327,348,21,294
68,18,3,2025-02-23,5,415,556,141,705
379,9,13,2025-02-09,15,352,497,145,2175
940,11,10,2025-02-27,18,329,394,65,1170
316,28,16,2025-02-17,16,217,302,85,1360
860,23,19,2025-02-23,18,492,668,176,3168
614,22,26,2025-02-19,5,260,312,52,260
709,16,11,2025-02-18,17,335,447,112,1904
258,21,9,2025-02-09,10,324,415,91,910
321,30,29,2025-02-11,8,309,351,42,336
996,10,7,2025-02-27,11,285,386,101,1111
286,9,20,2025-02-14,7,413,548,135,945
806,5,26,2025-02-25,10,117,159,42,420
371,23,18,2025-02-18,11,124,175,51,561
596,17,6,2025-02-04,10,346,402,56,560
613,26,21,2025-02-27,11,113,164,51,561
830,16,12,2025-02-08,13,267,367,100,1300
955,19,15,2025-02-18,11,94,109,15,165
74,9,4,2025-02-13,18,221,232,11,198
194,26,30,2025-02-09,16,252,371,119,1904
564,19,27,2025-02-09,17,310,384,74,1258
273,2,14,2025-02-21,16,324,356,32,512
448,13,11,2025-02-04,5,112,124,12,60
779,26,2,2025-02-02,3,162,178,16,48
549,9,5,2025-02-26,4,493,682,189,756
434,7,2,2025-02-22,19,50,53,3,57
346,20,24,2025-02-09,10,240,278,38,380
226,20,20,2025-02-19,9,495,643,148,1332
861,8,5,2025-02-01,18,319,380,61,1098
226,6,26,2025-02-27,13,124,160,36,468
18,6,3,2025-02-19,20,158,223,65,1300
128,4,8,2025-02-28,14,133,154,21,294
625,6,29,2025-02-06,8,163,179,16,128
245,22,10,2025-02-14,19,460,607,147,2793
396,15,7,2025-02-08,4,453,492,39,156
730,15,15,2025-02-05,13,455,604,149,1937
390,1,18,2025-02-25,9,125,181,56,504
504,14,26,2025-02-17,11,184,195,11,121
520,20,13,2025-02-27,15,330,377,47,705
148,23,3,2025-02-20,13,106,149,43,559
213,7,11,2025-02-12,13,160,186,26,338
298,29,8,2025-02-13,20,469,592,123,2460
25,22,30,2025-02-19,8,350,477,127,1016
464,23,26,2025-02-01,13,312,376,64,832
391,1,16,2025-02-14,15,485,602,117,1755
448,9,12,2025-02-08,9,207,302,95,855
267,16,6,2025-02-06,8,457,600,143,1144
530,20,17,2025-02-26,7,453,483,30,210
391,12,2,2025-02-25,8,66,90,24,192
163,3,20,2025-02-23,18,45,52,7,126
538,30,9,2025-02-15,5,170,189,19,95
447,9,28,2025-02-06,8,229,273,44,352
534,3,8,2025-02-28,3,337,362,25,75
671,26,26,2025-02-28,6,167,217,50,300
965,14,29,2025-02-06,8,28,40,12,96
201,20,23,2025-02-03,3,415,455,40,120
837,26,6,2025-02-18,4,418,526,108,432
780,12,24,2025-02-06,5,293,431,138,690
252,26,1,2025-02-11,6,412,483,71,426
833,1,17,2025-02-17,2,221,245,24,48
50,16,5,2025-02-28,5,143,206,63,315
855,12,19,2025-02-26,9,256,297,41,369
180,23,4,2025-02-23,8,102,136,34,272
773,2,3,2025-02-13,5,20,24,4,20
542,26,16,2025-02-22,13,301,389,88,1144
414,29,17,2025-02-15,17,201,282,81,1377
592,23,27,2025-02-24,13,404,470,66,858
960,14,6,2025-02-17,16,84,119,35,560
212,3,20,2025-02-12,10,79,104,25,250
423,13,13,2025-02-10,12,32,38,6,72
204,25,1,2025-02-07,14,416,556,140,1960
151,15,28,2025-02-19,5,352,495,143,715
406,8,5,2025-02-01,8,482,601,119,952
499,13,15,2025-02-23,15,210,304,94,1410
475,5,14,2025-02-02,8,94,137,43,344
945,4,10,2025-02-12,2,199,251,52,104
396,29,21,2025-02-28,14,59,78,19,266
364,27,17,2025-02-18,16,40,59,19,304
890,28,16,2025-02-03,12,189,215,26,312
945,17,6,2025-02-01,4,94,130,36,144
576,9,2,2025-02-01,17,131,175,44,748
381,1,15,2025-02-13,11,428,567,139,1529
356,20,11,2025-02-10,12,46,65,19,228
600,4,29,2025-02-15,16,241,336,95,1520
38,22,25,2025-02-18,19,279,301,22,418
992,5,30,2025-02-27,13,189,255,66,858
451,24,24,2025-02-21,9,93,104,11,99
937,7,3,2025-02-20,13,161,198,37,481
43,2,10,2025-02-01,5,119,147,28,140
199,14,26,2025-02-27,5,238,308,70,350
262,30,7,2025-02-01,3,103,148,45,135
272,24,16,2025-02-26,3,132,166,34,102
170,30,22,2025-02-16,4,60,81,21,84
832,29,11,2025-02-20,12,455,574,119,1428
980,9,19,2025-02-18,18,475,691,216,3888
760,11,21,2025-02-22,11,289,324,35,385
699,27,23,2025-02-19,17,369,434,65,1105
609,25,29,2025-02-08,8,437,463,26,208
495,9,11,2025-02-17,10,275,409,134,1340
415,2,19,2025-02-10,9,74,105,31,279
569,8,28,2025-02-26,8,470,696,226,1808
476,29,5,2025-02-04,18,278,337,59,1062
761,13,14,2025-02-19,11,173,188,15,165
167,20,16,2025-02-22,3,416,496,80,240
911,2,14,2025-02-13,14,98,121,23,322
32,11,12,2025-02-04,10,140,178,38,380
504,30,13,2025-02-19,7,227,282,55,385
241,10,8,2025-02-20,6,192,215,23,138
335,19,13,2025-02-28,3,71,77,6,18
816,24,1,2025-02-05,18,239,304,65,1170
95,30,26,2025-02-26,5,46,48,2,10
182,2,5,2025-02-10,12,367,499,132,1584
847,23,12,2025-02-22,19,64,68,4,76
915,10,11,2025-02-04,2,318,346,28,56
41,20,1,2025-02-27,7,424,478,54,378
401,27,16,2025-02-04,9,323,382,59,531
857,17,3,2025-02-27,20,165,184,19,380
474,20,28,2025-02-09,6,349,488,139,834
528,4,16,2025-02-20,8,372,438,66,528
403,28,11,2025-02-22,6,375,474,99,594
464,12,17,2025-02-10,10,354,484,130,1300
411,14,26,2025-02-08,10,361,432,71,710
247,15,5,2025-02-23,5,38,41,3,15
602,29,4,2025-02-05,4,249,276,27,108
741,3,10,2025-02-25,11,372,444,72,792
245,23,16,2025-02-14,14,82,120,38,532
685,22,18,2025-02-24,19,174,256,82,1558
215,29,16,2025-02-21,2,206,231,25,50
197,12,3,2025-02-02,2,450,645,195,390
259,13,6,2025-02-27,16,257,346,89,1424
408,26,23,2025-02-28,11,250,277,27,297
335,24,23,2025-02-14,11,488,677,189,2079
889,23,6,2025-02-01,6,148,183,35,210
499,29,11,2025-02-05,2,472,525,53,106
526,20,16,2025-02-09,7,389,440,51,357
40,25,1,2025-02-21,12,384,462,78,936
630,12,11,2025-02-01,4,267,373,106,424
993,17,7,2025-02-07,5,190,258,68,340
879,24,24,2025-02-17,9,291,357,66,594
542,19,20,2025-02-20,7,242,338,96,672
749,26,2,2025-02-15,19,300,354,54,1026
774,15,2,2025-02-10,11,29,36,7,77
643,26,3,2025-02-16,14,495,623,128,1792
906,20,19,2025-02-08,11,447,588,141,1551
461,9,10,2025-02-21,2,438,505,67,134
927,19,9,2025-02-13,9,22,28,6,54
42,8,27,2025-02-15,8,223,234,11,88
49,3,26,2025-02-26,9,294,416,122,1098
560,14,1,2025-02-17,10,413,545,132,1320
53,16,19,2025-02-07,18,358,465,107,1926
799,4,28,2025-02-08,13,307,423,116,1508
182,18,21,2025-02-07,1,370,460,90,90
337,21,8,2025-02-16,1,70,78,8,8
768,24,9,2025-02-06,10,363,423,60,600
166,29,14,2025-02-07,6,205,224,19,114
955,10,10,2025-02-18,18,347,375,28,504
160,28,4,2025-02-28,1,142,153,11,11
789,26,25,2025-02-09,6,78,109,31,186
346,4,17,2025-02-25,18,258,330,72,1296
493,22,20,2025-02-09,3,202,284,82,246
362,6,13,2025-02-26,7,299,441,142,994
743,1,30,2025-02-20,3,52,58,6,18
351,6,17,2025-02-27,18,119,151,32,576
947,25,21,2025-02-12,1,194,278,84,84
812,25,14,2025-02-04,17,417,590,173,2941
218,6,7,2025-02-20,16,416,547,131,2096
715,3,24,2025-02-08,16,305,426,121,1936
397,11,21,2025-02-12,7,480,513,33,231
464,7,1,2025-02-19,12,28,42,14,168
957,12,21,2025-02-11,14,403,575,172,2408
993,11,28,2025-02-15,3,88,126,38,114
609,17,18,2025-02-25,4,323,359,36,144
507,18,18,2025-02-24,11,81,108,27,297
34,26,27,2025-02-21,11,145,173,28,308
842,14,10,2025-02-02,4,48,71,23,92
681,5,23,2025-02-09,13,98,115,17,221
871,14,3,2025-02-17,12,58,74,16,192
757,10,14,2025-02-01,1,165,198,33,33
729,3,28,2025-02-05,17,328,433,105,1785
103,12,4,2025-02-04,9,413,496,83,747
910,4,6,2025-02-19,7,318,448,130,910
238,2,9,2025-02-10,18,406,525,119,2142
880,3,26,2025-02-23,18,498,652,154,2772
708,18,10,2025-02-18,10,71,103,32,320
771,30,2,2025-02-10,14,67,90,23,322
276,24,2,2025-02-05,3,68,100,32,96
603,1,4,2025-02-16,2,260,368,108,216
416,18,4,2025-02-09,6,322,474,152,912
917,26,8,2025-02-03,11,106,120,14,154
941,19,23,2025-02-28,4,342,484,142,568
482,7,24,2025-02-23,5,106,146,40,200
842,28,22,2025-02-17,8,228,240,12,96
536,29,9,2025-02-19,7,272,353,81,567
61,14,7,2025-02-20,13,118,168,50,650
300,12,5,2025-02-13,19,230,336,106,2014
295,9,8,2025-02-20,4,381,472,91,364
664,20,16,2025-02-01,4,227,299,72,288
765,9,23,2025-02-05,19,114,161,47,893
595,4,22,2025-02-08,5,384,410,26,130
256,24,2,2025-02-24,3,370,454,84,252
989,7,9,2025-02-04,19,21,28,7,133
735,4,27,2025-02-23,1,231,254,23,23
212,15,5,2025-02-05,4,464,564,100,400
421,13,22,2025-02-17,9,247,333,86,774
879,21,5,2025-02-07,13,200,227,27,351
682,28,22,2025-02-08,16,270,399,129,2064
448,2,9,2025-02-01,14,257,288,31,434
801,29,27,2025-02-02,15,288,340,52,780
424,4,29,2025-02-10,5,165,194,29,145
437,25,1,2025-02-16,17,53,70,17,289
357,10,21,2025-02-08,15,122,166,44,660
283,27,16,2025-02-13,9,102,129,27,243
449,29,5,2025-02-01,8,350,444,94,752
225,18,17,2025-02-21,5,76,89,13,65
380,17,9,2025-02-23,4,159,229,70,280
529,26,10,2025-02-24,13,30,32,2,26
981,29,4,2025-02-08,10,149,211,62,620
776,22,30,2025-02-18,20,314,443,129,2580
543,30,6,2025-02-21,16,290,305,15,240
982,1,11,2025-02-25,18,234,306,72,1296
2,16,7,2025-02-06,4,395,469,74,296
783,14,9,2025-02-23,9,320,365,45,405
412,22,27,2025-02-20,19,308,373,65,1235
390,16,20,2025-02-07,8,186,199,13,104
345,12,16,2025-02-25,8,292,350,58,464
234,14,18,2025-02-01,3,72,94,22,66
141,8,14,2025-02-28,2,124,156,32,64
548,24,3,2025-02-04,18,245,336,91,1638
227,24,7,2025-02-07,12,69,74,5,60
12,30,19,2025-02-14,4,163,218,55,220
912,15,29,2025-02-07,3,194,284,90,270
627,4,3,2025-02-26,9,425,561,136,1224
765,21,25,2025-02-08,2,263,358,95,190
555,6,22,2025-02-25,1,494,706,212,212
837,7,26,2025-02-14,11,71,77,6,66
597,8,30,2025-02-19,9,20,25,5,45
358,30,12,2025-02-25,15,304,414,110,1650
28,24,4,2025-02-21,19,30,41,11,209
198,6,27,2025-02-06,8,397,425,28,224
184,7,27,2025-02-07,7,87,103,16,112
63,22,15,2025-02-08,20,88,94,6,120
744,30,24,2025-02-07,12,341,474,133,1596
780,10,27,2025-02-22,14,98,133,35,490
854,29,6,2025-02-16,13,23,26,3,39
36,18,6,2025-02-22,14,75,82,7,98
162,7,3,2025-02-05,14,75,93,18,252
717,27,6,2025-02-09,17,385,500,115,1955
694,17,29,2025-02-19,19,188,272,84,1596
162,27,20,2025-02-18,19,130,192,62,1178
436,6,20,2025-02-27,15,162,193,31,465
621,7,30,2025-02-24,1,120,148,28,28
385,25,18,2025-02-15,3,467,613,146,438
816,23,5,2025-02-02,8,397,542,145,1160
973,28,4,2025-02-18,16,222,324,102,1632
595,23,24,2025-02-27,5,47,60,13,65
552,29,8,2025-02-26,5,143,209,66,330
521,28,20,2025-02-18,3,143,185,42,126
86,11,17,2025-02-18,3,152,177,25,75
563,5,27,2025-02-06,2,238,302,64,128
859,7,5,2025-02-26,8,377,504,127,1016
531,5,20,2025-02-15,3,236,324,88,264
560,3,24,2025-02-25,11,255,287,32,352
283,28,11,2025-02-01,2,411,434,23,46
28,25,22,2025-02-23,1,461,652,191,191
32,3,11,2025-02-06,19,61,66,5,95
195,16,26,2025-02-04,15,421,611,190,2850
664,12,2,2025-02-26,20,33,45,12,240
362,11,13,2025-02-22,4,426,623,197,788
662,10,25,2025-02-10,9,101,110,9,81
833,5,20,2025-02-22,19,296,374,78,1482
503,17,30,2025-02-25,3,97,110,13,39
782,10,17,2025-02-20,2,180,220,40,80
42,17,14,2025-02-15,1,42,55,13,13
3,22,9,2025-02-08,13,196,262,66,858
91,12,24,2025-02-17,9,291,325,34,306
387,19,4,2025-02-08,14,96,135,39,546
524,8,11,2025-02-12,2,207,246,39,78
175,26,19,2025-02-13,2,302,414,112,224
641,16,2,2025-02-14,7,143,177,34,238
877,20,18,2025-02-15,20,201,282,81,1620
18,25,20,2025-02-25,17,114,126,12,204
63,9,26,2025-02-02,4,463,568,105,420
855,17,4,2025-02-18,17,398,419,21,357
641,24,9,2025-02-28,6,300,443,143,858
511,29,30,2025-02-08,17,119,145,26,442
783,7,17,2025-02-21,3,224,262,38,114
159,22,3,2025-02-05,13,336,455,119,1547
744,6,17,2025-02-19,10,228,270,42,420
22,8,29,2025-02-14,5,208,286,78,390
866,17,14,2025-02-07,4,178,264,86,344
258,3,15,2025-02-28,2,440,539,99,198
969,21,13,2025-02-06,12,404,492,88,1056
298,28,28,2025-02-02,6,226,318,92,552
739,22,12,2025-02-11,18,369,418,49,882
197,28,30,2025-02-24,1,362,394,32,32
387,10,14,2025-02-26,9,461,544,83,747
590,27,17,2025-02-17,1,415,478,63,63
112,12,8,2025-02-18,17,285,322,37,629
283,11,24,2025-02-05,15,332,473,141,2115
64,22,23,2025-02-11,2,168,228,60,120
59,28,10,2025-02-08,7,489,561,72,504
994,25,27,2025-02-12,7,444,571,127,889
602,11,29,2025-02-23,4,222,306,84,336
827,5,26,2025-02-04,3,68,93,25,75
466,17,15,2025-02-24,4,298,319,21,84
1000,7,8,2025-02-19,3,343,465,122,366
505,7,5,2025-02-13,11,135,144,9,99
417,28,2,2025-02-24,3,62,91,29,87
627,25,17,2025-02-16,11,219,239,20,220
984,17,28,2025-02-14,18,388,558,170,3060
914,1,1,2025-02-06,7,440,467,27,189
831,1,19,2025-02-04,11,418,517,99,1089
563,5,27,2025-02-20,17,493,521,28,476
705,13,11,2025-02-16,16,155,214,59,944
843,20,4,2025-02-24,14,489,514,25,350
636,22,7,2025-02-13,12,332,467,135,1620
138,29,2,2025-02-03,10,329,356,27,270
127,28,17,2025-02-21,19,166,182,16,304
300,8,8,2025-02-13,17,264,318,54,918
28,19,5,2025-02-25,14,119,134,15,210
741,6,7,2025-02-20,20,278,310,32,640
246,15,9,2025-02-11,11,234,254,20,220
262,30,2,2025-02-23,10,86,110,24,240
418,24,2,2025-02-27,12,342,362,20,240
812,11,8,2025-02-16,13,239,298,59,767
810,24,2,2025-02-17,4,79,109,30,120
437,25,28,2025-02-01,2,118,170,52,104
57,17,29,2025-02-07,12,219,269,50,600
623,3,27,2025-02-28,1,217,243,26,26
467,3,11,2025-02-24,7,71,105,34,238
787,7,9,2025-02-11,12,46,65,19,228
522,18,6,2025-02-14,19,75,95,20,380
868,16,14,2025-02-25,18,349,508,159,2862
637,7,17,2025-02-27,9,168,233,65,585
42,4,8,2025-02-10,18,22,31,9,162
459,25,7,2025-02-11,10,141,178,37,370
684,30,18,2025-02-24,17,89,110,21,357
218,8,21,2025-02-12,20,390,431,41,820
105,22,12,2025-02-15,1,330,469,139,139
520,12,19,2025-02-19,3,431,509,78,234
588,6,30,2025-02-01,15,150,197,47,705
170,13,25,2025-02-20,19,339,500,161,3059
431,25,20,2025-02-19,13,465,652,187,2431
304,27,18,2025-02-21,20,408,539,131,2620
748,22,22,2025-02-25,15,65,94,29,435
303,5,18,2025-02-26,12,316,386,70,840
975,19,8,2025-02-05,11,309,339,30,330
22,25,17,2025-02-10,19,336,473,137,2603
878,7,6,2025-02-07,4,114,163,49,196
827,27,8,2025-02-10,5,417,620,203,1015
414,19,18,2025-02-02,14,338,461,123,1722
572,16,5,2025-02-13,4,254,354,100,400
996,29,1,2025-02-21,15,109,151,42,630
317,18,24,2025-02-08,17,330,379,49,833
687,22,20,2025-02-12,8,480,709,229,1832
142,22,29,2025-02-18,1,448,635,187,187
292,27,1,2025-02-12,14,474,639,165,2310
146,29,23,2025-02-19,20,242,291,49,980
563,26,28,2025-02-26,5,227,299,72,360
368,18,22,2025-02-05,14,358,419,61,854
803,18,13,2025-02-19,13,196,242,46,598
75,30,27,2025-02-07,1,307,389,82,82
437,4,22,2025-02-27,5,412,468,56,280
542,11,19,2025-02-11,4,148,212,64,256
796,9,13,2025-02-18,5,143,188,45,225
792,10,28,2025-02-17,9,340,495,155,1395
876,1,27,2025-02-06,16,405,466,61,976
7,22,28,2025-02-17,14,327,401,74,1036
907,13,3,2025-02-02,4,446,665,219,876
397,17,7,2025-02-03,3,362,412,50,150
627,11,27,2025-02-27,1,44,65,21,21
385,17,2,2025-02-20,9,61,72,11,99
622,3,28,2025-02-24,11,47,59,12,132
793,6,28,2025-02-21,17,120,173,53,901
973,15,21,2025-02-14,5,45,62,17,85
226,21,9,2025-02-09,1,478,608,130,130
454,20,10,2025-02-13,6,49,67,18,108
460,29,5,2025-02-24,13,410,590,180,2340
688,5,20,2025-02-05,12,29,38,9,108
95,24,28,2025-02-16,16,492,602,110,1760
49,6,19,2025-02-23,20,54,75,21,420
270,1,13,2025-02-17,18,154,166,12,216
200,7,7,2025-02-15,8,65,96,31,248
978,30,11,2025-02-12,6,123,148,25,150
985,13,4,2025-02-15,18,494,536,42,756
11,7,28,2025-02-06,4,60,79,19,76
1,13,4,2025-02-08,14,141,200,59,826
686,11,5,2025-02-15,16,299,391,92,1472
354,13,4,2025-02-07,7,249,270,21,147
684,18,10,2025-02-10,9,323,346,23,207
985,6,28,2025-02-19,11,44,49,5,55
406,10,17,2025-02-02,4,240,282,42,168
55,8,15,2025-02-07,9,445,488,43,387
482,18,4,2025-02-05,15,399,561,162,2430
684,17,6,2025-02-06,3,27,38,11,33
655,3,29,2025-02-16,19,294,418,124,2356
105,21,7,2025-02-09,17,496,738,242,4114
176,19,18,2025-02-11,16,421,581,160,2560
622,15,8,2025-02-25,14,463,658,195,2730
896,27,18,2025-02-08,4,454,582,128,512
557,22,11,2025-02-14,1,193,223,30,30
769,15,24,2025-02-01,16,422,577,155,2480
558,24,21,2025-02-14,13,368,540,172,2236
122,15,16,2025-02-23,2,226,325,99,198
509,8,29,2025-02-13,17,419,592,173,2941
881,26,1,2025-02-12,1,212,274,62,62
87,22,27,2025-02-06,6,134,179,45,270
336,22,6,2025-02-03,13,367,530,163,2119
375,1,25,2025-02-11,18,249,366,117,2106
704,9,13,2025-02-19,5,395,428,33,165
667,25,30,2025-02-06,3,312,347,35,105
582,13,15,2025-02-25,20,40,52,12,240
548,25,22,2025-02-09,8,240,319,79,632
555,10,26,2025-02-18,1,101,112,11,11
941,2,28,2025-02-11,2,329,448,119,238
236,22,27,2025-02-18,14,388,512,124,1736
709,9,17,2025-02-10,5,172,249,77,385
346,28,24,2025-02-20,17,303,404,101,1717
663,3,10,2025-02-12,15,340,440,100,1500
469,26,25,2025-02-02,15,66,80,14,210
184,8,29,2025-02-18,13,249,305,56,728
201,18,25,2025-02-22,6,33,49,16,96
463,9,13,2025-02-25,3,334,360,26,78
643,22,15,2025-02-16,20,292,371,79,1580
555,5,28,2025-02-20,19,488,608,120,2280
510,23,28,2025-02-05,5,183,235,52,260
201,16,24,2025-02-02,18,182,247,65,1170
1,13,21,2025-02-06,8,208,223,15,120
276,29,1,2025-02-22,12,406,608,202,2424
391,24,20,2025-02-11,15,311,332,21,315
690,4,6,2025-02-09,18,110,154,44,792
351,28,12,2025-02-09,9,113,166,53,477
403,15,19,2025-02-13,7,91,110,19,133
835,20,10,2025-02-06,8,344,509,165,1320
700,18,24,2025-02-19,9,424,520,96,864
888,8,28,2025-02-07,18,481,705,224,4032
957,4,11,2025-02-13,6,153,166,13,78
697,30,11,2025-02-06,18,409,492,83,1494
955,16,6,2025-02-11,13,105,156,51,663
176,13,19,2025-02-08,8,195,251,56,448
801,22,12,2025-02-04,8,460,688,228,1824
517,4,18,2025-02-23,13,209,254,45,585
975,21,16,2025-02-17,9,217,321,104,936
573,11,1,2025-02-20,11,407,517,110,1210
697,10,27,2025-02-09,8,23,26,3,24
644,20,4,2025-02-22,17,442,579,137,2329
949,27,4,2025-02-16,20,267,300,33,660
204,17,27,2025-02-23,11,317,367,50,550
813,2,3,2025-02-27,12,127,156,29,348
91,11,10,2025-02-15,4,187,266,79,316
208,4,7,2025-02-24,6,207,275,68,408
220,27,14,2025-02-16,17,69,80,11,187
437,15,28,2025-02-11,2,28,41,13,26
273,28,5,2025-02-23,4,165,244,79,316
812,3,2,2025-02-25,12,110,138,28,336
631,17,4,2025-02-23,19,288,364,76,1444
62,20,24,2025-02-27,5,407,515,108,540
279,12,5,2025-02-08,17,289,376,87,1479
786,12,13,2025-02-06,5,498,597,99,495
829,30,26,2025-02-25,14,233,251,18,252
333,28,25,2025-02-19,17,232,326,94,1598
461,18,15,2025-02-09,10,461,519,58,580
505,23,11,2025-02-17,11,399,579,180,1980
287,18,21,2025-02-11,19,236,350,114,2166
816,28,11,2025-02-26,20,167,189,22,440
132,10,20,2025-02-04,3,435,592,157,471
341,1,5,2025-02-28,1,471,503,32,32
160,26,10,2025-02-12,8,320,429,109,872
238,3,8,2025-02-05,4,429,513,84,336
325,3,7,2025-02-01,11,194,246,52,572
535,7,21,2025-02-21,14,304,420,116,1624
699,4,10,2025-02-10,10,455,584,129,1290
632,13,13,2025-02-19,20,386,491,105,2100
512,28,23,2025-02-08,14,249,362,113,1582
808,15,24,2025-02-10,14,96,133,37,518
133,12,28,2025-02-17,6,490,596,106,636
215,3,17,2025-02-07,6,382,495,113,678
836,4,24,2025-02-05,7,448,483,35,245
205,20,5,2025-02-27,1,340,404,64,64
95,2,13,2025-02-24,1,473,516,43,43
251,14,9,2025-02-16,6,124,170,46,276
475,12,1,2025-02-18,6,412,520,108,648
532,23,3,2025-02-22,15,110,154,44,660
922,12,16,2025-02-15,11,153,212,59,649
372,18,21,2025-02-09,16,89,109,20,320
884,19,2,2025-02-11,5,336,366,30,150
837,25,28,2025-02-22,15,215,313,98,1470
568,8,24,2025-02-04,13,47,61,14,182
187,23,15,2025-02-04,16,109,118,9,144
704,7,7,2025-02-15,7,494,644,150,1050
597,6,27,2025-02-01,11,113,127,14,154
591,19,30,2025-02-20,7,399,493,94,658
176,4,24,2025-02-14,11,356,511,155,1705
78,21,10,2025-02-08,18,301,336,35,630
919,6,11,2025-02-21,12,379,562,183,2196
809,19,28,2025-02-18,7,183,238,55,385
316,9,14,2025-02-04,16,391,524,133,2128
755,24,29,2025-02-16,8,102,144,42,336
297,8,1,2025-02-19,11,153,220,67,737
592,26,25,2025-02-16,20,386,531,145,2900
185,29,15,2025-02-20,19,244,256,12,228
585,6,15,2025-02-03,6,48,58,10,60
683,29,20,2025-02-15,17,486,619,133,2261
116,7,16,2025-02-23,11,90,118,28,308
572,30,17,2025-02-08,5,96,102,6,30
692,25,4,2025-02-05,12,223,307,84,1008
744,28,2,2025-02-18,7,108,115,7,49
46,9,25,2025-02-18,16,330,467,137,2192
703,29,15,2025-02-17,17,279,401,122,2074
449,12,22,2025-02-07,12,361,463,102,1224
190,8,21,2025-02-18,13,493,531,38,494
858,30,25,2025-02-26,2,123,130,7,14
310,8,30,2025-02-13,3,437,571,134,402
814,19,11,2025-02-04,15,54,65,11,165
893,6,7,2025-02-28,19,480,705,225,4275
96,1,25,2025-02-05,19,105,147,42,798
748,19,24,2025-02-12,1,67,79,12,12
490,9,21,2025-02-28,17,118,127,9,153
844,7,30,2025-02-01,19,232,347,115,2185
85,7,22,2025-02-19,16,67,89,22,352
118,5,13,2025-02-02,5,394,441,47,235
213,6,4,2025-02-28,15,229,289,60,900
677,5,2,2025-02-04,20,414,574,160,3200
92,4,4,2025-02-13,13,73,81,8,104
186,2,4,2025-02-20,2,248,276,28,56
352,22,24,2025-02-17,15,497,577,80,1200
948,20,24,2025-02-24,7,38,45,7,49
198,14,13,2025-02-11,7,294,310,16,112
184,15,21,2025-02-22,10,417,536,119,1190
154,25,26,2025-02-10,6,71,77,6,36
24,26,18,2025-02-22,13,340,437,97,1261
945,11,28,2025-02-01,19,360,431,71,1349
138,5,20,2025-02-10,13,85,90,5,65
843,19,7,2025-02-23,12,199,274,75,900
860,26,3,2025-02-26,1,432,635,203,203
733,22,19,2025-02-20,12,85,119,34,408
598,16,27,2025-02-01,4,137,204,67,268
122,5,9,2025-02-07,14,498,603,105,1470
335,18,12,2025-02-13,10,410,601,191,1910
218,28,1,2025-02-09,3,474,656,182,546
160,1,5,2025-02-16,2,236,261,25,50
629,6,16,2025-02-08,18,273,321,48,864
171,20,20,2025-02-02,15,388,533,145,2175
88,14,14,2025-02-28,19,31,38,7,133
134,5,28,2025-02-10,17,352,519,167,2839
110,11,11,2025-02-09,6,443,640,197,1182
647,21,1,2025-02-08,10,36,42,6,60
128,1,20,2025-02-12,13,274,357,83,1079
787,21,15,2025-02-12,14,477,670,193,2702
638,3,12,2025-02-15,19,366,512,146,2774
357,12,10,2025-02-14,6,146,170,24,144
862,4,5,2025-02-27,9,256,319,63,567
114,2,18,2025-02-02,4,428,600,172,688
126,2,7,2025-02-01,14,303,349,46,644
461,13,9,2025-02-25,3,270,303,33,99
529,2,18,2025-02-01,17,69,98,29,493
687,12,15,2025-02-04,5,323,344,21,105
738,4,11,2025-02-23,2,257,280,23,46
521,2,14,2025-02-15,4,146,157,11,44
730,8,11,2025-02-03,2,436,629,193,386
370,17,9,2025-02-16,10,122,172,50,500
180,4,23,2025-02-07,1,28,37,9,9
187,12,18,2025-02-28,17,366,443,77,1309
437,23,14,2025-02-20,9,274,291,17,153
124,18,1,2025-02-11,7,363,512,149,1043
796,7,20,2025-02-13,6,441,624,183,1098
962,15,30,2025-02-09,14,475,583,108,1512
843,5,3,2025-02-12,19,52,67,15,285
851,5,23,2025-02-28,16,29,31,2,32
273,13,14,2025-02-14,4,179,266,87,348
642,19,1,2025-02-25,3,427,471,44,132
458,19,16,2025-02-22,15,83,121,38,570
39,1,24,2025-02-21,9,319,369,50,450
787,18,3,2025-02-27,19,407,556,149,2831
725,21,23,2025-02-09,19,21,25,4,76
684,23,3,2025-02-11,6,41,48,7,42
624,17,2,2025-02-26,19,172,231,59,1121
613,27,16,2025-02-13,20,290,434,144,2880
655,8,21,2025-02-03,7,257,338,81,567
702,4,27,2025-02-14,13,328,427,99,1287
300,4,14,2025-02-13,4,96,110,14,56
294,2,16,2025-02-16,19,156,181,25,475
851,6,25,2025-02-11,14,113,129,16,224
706,17,22,2025-02-19,20,168,220,52,1040
934,4,20,2025-02-15,1,54,74,20,20
933,9,6,2025-02-14,5,33,38,5,25
53,17,15,2025-02-27,18,452,509,57,1026
92,14,2,2025-02-27,6,358,483,125,750
29,21,26,2025-02-22,9,68,97,29,261
924,30,18,2025-02-26,3,140,170,30,90
719,25,20,2025-02-19,17,324,414,90,1530
799,19,15,2025-02-05,4,62,92,30,120
986,1,24,2025-02-27,18,277,369,92,1656
988,10,30,2025-02-22,17,35,50,15,255
872,3,18,2025-02-13,9,175,226,51,459
165,25,4,2025-02-15,12,287,368,81,972
950,8,19,2025-02-15,17,211,263,52,884
12,18,6,2025-02-02,1,152,197,45,45
429,16,11,2025-02-16,3,444,635,191,573
863,7,13,2025-02-19,3,173,228,55,165
94,25,21,2025-02-22,3,498,558,60,180
913,16,22,2025-02-27,19,158,222,64,1216
615,22,14,2025-02-18,17,97,122,25,425
771,13,19,2025-02-22,16,360,481,121,1936
274,2,19,2025-02-12,8,385,425,40,320
927,26,3,2025-02-26,19,236,260,24,456
438,2,16,2025-02-18,8,110,140,30,240
691,29,26,2025-02-23,18,305,351,46,828
741,13,12,2025-02-04,15,317,447,130,1950
825,22,22,2025-02-21,13,113,134,21,273
47,29,20,2025-02-14,10,447,592,145,1450
393,18,8,2025-02-24,9,499,661,162,1458
27,9,15,2025-02-17,10,97,105,8,80
12,5,18,2025-02-11,4,217,242,25,100
956,12,19,2025-02-25,8,442,589,147,1176
282,18,18,2025-02-05,1,277,411,134,134
984,26,25,2025-02-08,9,293,360,67,603
714,17,8,2025-02-20,2,470,586,116,232
265,13,16,2025-02-05,17,247,326,79,1343
70,14,1,2025-02-20,3,65,77,12,36
220,27,4,2025-02-19,8,203,274,71,568
615,21,27,2025-02-06,7,385,475,90,630
239,7,16,2025-02-24,14,477,501,24,336
192,8,2,2025-02-09,11,304,389,85,935
411,11,25,2025-02-27,1,485,545,60,60
929,9,25,2025-02-10,16,94,110,16,256
632,4,14,2025-02-11,2,466,530,64,128
297,9,1,2025-02-26,19,233,287,54,1026
65,16,25,2025-02-24,16,479,699,220,3520
766,3,25,2025-02-17,5,378,441,63,315
552,19,25,2025-02-18,2,299,387,88,176
930,24,1,2025-02-28,13,256,365,109,1417
149,4,9,2025-02-03,15,158,195,37,555
869,4,26,2025-02-08,11,338,383,45,495
404,21,13,2025-02-09,18,236,313,77,1386
552,20,26,2025-02-08,19,222,303,81,1539
563,15,10,2025-02-17,13,310,369,59,767
914,28,3,2025-02-11,11,321,375,54,594
322,26,22,2025-02-02,4,83,110,27,108
740,20,22,2025-02-06,2,452,614,162,324
490,12,8,2025-02-23,13,475,647,172,2236
360,4,3,2025-02-16,3,236,320,84,252
64,8,27,2025-02-20,18,405,566,161,2898
827,13,7,2025-02-14,11,147,182,35,385
727,21,5,2025-02-04,17,316,369,53,901
382,20,2,2025-02-13,16,23,25,2,32
609,21,21,2025-02-19,10,433,481,48,480
544,19,9,2025-02-06,2,170,249,79,158
385,22,28,2025-02-09,18,334,416,82,1476
510,14,2,2025-02-11,14,154,173,19,266
840,26,30,2025-02-10,11,236,340,104,1144
502,25,15,2025-02-11,18,476,506,30,540
462,26,10,2025-02-25,11,133,151,18,198
519,26,20,2025-02-01,14,86,100,14,196
802,12,9,2025-02-26,13,468,572,104,1352
134,28,21,2025-02-06,14,192,262,70,980
56,4,13,2025-02-21,11,329,435,106,1166
235,30,2,2025-02-01,14,102,146,44,616
122,6,5,2025-02-10,6,410,578,168,1008
439,29,16,2025-02-23,16,179,220,41,656
783,11,20,2025-02-03,13,34,37,3,39
182,9,23,2025-02-04,3,210,307,97,291
873,17,27,2025-02-09,18,428,549,121,2178
398,2,1,2025-02-25,18,27,30,3,54
603,17,13,2025-02-16,16,306,339,33,528
896,3,6,2025-02-19,20,471,694,223,4460
455,30,26,2025-02-01,9,248,275,27,243
736,14,26,2025-02-09,6,346,490,144,864
78,5,24,2025-02-04,6,47,54,7,42
258,8,24,2025-02-25,16,195,225,30,480
355,23,19,2025-02-24,13,463,643,180,2340
50,15,18,2025-02-12,6,208,310,102,612
971,17,6,2025-02-10,5,83,112,29,145
712,25,8,2025-02-17,11,469,546,77,847
817,25,9,2025-02-02,2,366,540,174,348
261,10,21,2025-02-12,10,353,445,92,920
758,5,28,2025-02-07,3,77,86,9,27
199,5,30,2025-02-23,15,166,232,66,990
630,25,24,2025-02-24,16,369,544,175,2800
752,27,3,2025-02-15,15,481,672,191,2865
783,7,8,2025-02-22,10,350,469,119,1190
761,6,16,2025-02-06,1,118,170,52,52
569,18,13,2025-02-22,6,439,475,36,216
487,12,23,2025-02-01,18,51,72,21,378
69,20,26,2025-02-13,8,443,473,30,240
337,23,21,2025-02-07,2,217,287,70,140
812,8,11,2025-02-24,18,277,394,117,2106
274,20,29,2025-02-08,11,454,524,70,770
313,1,2,2025-02-28,4,283,306,23,92
894,13,15,2025-02-16,17,166,213,47,799
69,27,14,2025-02-12,6,162,189,27,162
939,22,12,2025-02-09,9,238,256,18,162
545,7,27,2025-02-18,12,372,402,30,360
618,20,7,2025-02-15,18,74,78,4,72
703,21,25,2025-02-26,11,143,192,49,539
127,5,18,2025-02-15,17,282,380,98,1666
896,18,24,2025-02-13,20,310,406,96,1920
601,17,17,2025-02-25,5,473,685,212,1060
708,20,2,2025-02-10,11,266,349,83,913
137,27,16,2025-02-04,9,449,562,113,1017
141,9,13,2025-02-08,2,434,473,39,78
747,20,18,2025-02-24,13,383,446,63,819
275,5,29,2025-02-07,18,352,405,53,954
461,6,17,2025-02-08,8,310,436,126,1008
155,4,21,2025-02-22,18,275,292,17,306
943,27,6,2025-02-19,7,108,139,31,217
528,30,2,2025-02-23,19,305,447,142,2698
172,5,4,2025-02-02,4,27,31,4,16
180,29,1,2025-02-01,3,374,481,107,321
473,14,13,2025-02-04,2,485,516,31,62
862,21,20,2025-02-22,18,490,691,201,3618
493,23,13,2025-02-04,1,300,326,26,26
303,7,12,2025-02-13,3,167,180,13,39
742,8,29,2025-02-18,10,495,591,96,960
250,21,3,2025-02-19,17,406,435,29,493
495,9,14,2025-02-26,18,348,387,39,702
323,10,14,2025-02-28,19,181,258,77,1463
810,4,2,2025-02-01,7,395,552,157,1099
18,15,27,2025-02-25,13,488,552,64,832
379,27,27,2025-02-09,11,400,526,126,1386
449,27,3,2025-02-11,1,482,656,174,174
447,14,29,2025-02-22,13,236,276,40,520
76,1,29,2025-02-21,13,489,595,106,1378
889,3,23,2025-02-03,8,164,172,8,64
458,18,11,2025-02-04,13,334,474,140,1820
939,19,9,2025-02-25,20,260,278,18,360
630,1,12,2025-02-25,18,409,465,56,1008
430,18,7,2025-02-10,18,92,112,20,360
744,19,19,2025-02-20,13,101,124,23,299
471,26,1,2025-02-17,8,296,369,73,584
569,17,29,2025-02-21,19,80,101,21,399
699,22,21,2025-02-16,20,57,69,12,240
380,26,19,2025-02-14,6,205,257,52,312
80,19,15,2025-02-13,1,374,493,119,119
130,1,3,2025-02-05,14,471,643,172,2408
368,15,28,2025-02-21,17,315,410,95,1615
894,6,13,2025-02-01,10,60,78,18,180
6,25,29,2025-02-19,12,498,554,56,672
75,26,15,2025-02-12,11,281,335,54,594
981,4,15,2025-02-16,15,168,230,62,930
688,24,5,2025-02-16,10,217,287,70,700
803,3,4,2025-02-18,18,94,111,17,306
624,23,19,2025-02-13,5,243,284,41,205
167,5,20,2025-02-16,11,282,371,89,979
461,2,26,2025-02-23,9,389,536,147,1323
273,30,5,2025-02-04,18,197,267,70,1260
382,16,27,2025-02-27,2,183,228,45,90
518,5,1,2025-02-28,19,92,102,10,190
891,12,16,2025-02-27,1,383,501,118,118
961,24,2,2025-02-03,13,132,194,62,806
921,11,14,2025-02-09,2,255,287,32,64
848,5,9,2025-02-28,16,110,140,30,480
942,18,20,2025-02-11,9,22,24,2,18
498,17,21,2025-02-27,17,113,127,14,238
269,23,15,2025-02-08,3,89,133,44,132
75,13,30,2025-02-18,12,23,29,6,72
61,26,12,2025-02-18,2,66,73,7,14
381,1,20,2025-02-06,15,473,668,195,2925
836,22,3,2025-02-11,6,238,259,21,126
902,2,24,2025-02-12,8,438,630,192,1536
452,2,27,2025-02-19,5,122,131,9,45
474,3,26,2025-02-14,19,180,244,64,1216
5,16,9,2025-02-23,3,469,599,130,390
805,10,18,2025-02-23,11,377,446,69,759
831,21,5,2025-02-26,19,287,362,75,1425
608,18,19,2025-02-07,14,196,217,21,294
264,9,16,2025-02-25,4,231,329,98,392
91,20,26,2025-02-24,17,493,549,56,952
486,7,26,2025-02-10,18,62,71,9,162
790,24,25,2025-02-03,2,152,182,30,60
158,12,25,2025-02-18,20,226,260,34,680
188,3,15,2025-02-10,7,471,661,190,1330
746,12,15,2025-02-09,17,411,595,184,3128
248,11,28,2025-02-05,14,291,313,22,308
883,9,18,2025-02-14,2,401,499,98,196
199,19,18,2025-02-08,9,476,564,88,792
555,17,7,2025-02-18,10,110,131,21,210
234,13,30,2025-02-26,10,227,332,105,1050
554,2,11,2025-02-11,2,248,351,103,206
950,9,23,2025-02-02,13,204,255,51,663
344,12,3,2025-02-12,13,101,115,14,182
188,24,27,2025-02-01,20,37,48,11,220
342,29,25,2025-02-11,4,41,52,11,44
717,10,24,2025-02-01,20,72,104,32,640
103,3,4,2025-02-15,17,218,238,20,340
704,1,5,2025-02-11,10,380,560,180,1800
699,13,2,2025-02-22,6,106,142,36,216
416,23,20,2025-02-12,8,181,257,76,608
955,9,23,2025-02-03,6,20,29,9,54
683,5,6,2025-02-15,11,421,592,171,1881
580,12,28,2025-02-02,1,100,144,44,44
778,26,23,2025-02-02,3,183,201,18,54
220,28,24,2025-02-06,12,428,575,147,1764
703,19,9,2025-02-15,20,193,205,12,240
290,2,27,2025-02-16,4,411,513,102,408
196,28,5,2025-02-15,20,301,323,22,440
363,23,24,2025-02-19,12,349,371,22,264
237,22,25,2025-02-27,3,44,46,2,6
403,10,22,2025-02-20,7,175,245,70,490
13,7,23,2025-02-19,4,21,25,4,16
130,2,29,2025-02-07,14,43,55,12,168
716,25,10,2025-02-03,3,297,352,55,165
629,30,4,2025-02-08,11,470,624,154,1694
914,6,18,2025-02-12,12,409,567,158,1896
932,12,22,2025-02-19,11,95,102,7,77
398,3,2,2025-02-02,14,269,351,82,1148
592,1,21,2025-02-01,13,312,388,76,988
936,30,27,2025-02-18,2,57,74,17,34
735,15,16,2025-02-09,2,418,570,152,304
248,16,17,2025-02-09,5,386,560,174,870
224,22,7,2025-02-19,10,177,232,55,550
987,12,28,2025-02-08,1,21,26,5,5
470,13,25,2025-02-28,6,191,229,38,228
224,6,21,2025-02-12,1,57,73,16,16
389,11,9,2025-02-05,13,114,134,20,260
471,18,9,2025-02-06,19,51,68,17,323
678,19,23,2025-02-25,5,132,185,53,265
316,11,28,2025-02-04,3,27,37,10,30
33,19,2,2025-02-21,14,449,608,159,2226
365,8,1,2025-02-21,18,304,444,140,2520
523,9,8,2025-02-01,5,473,689,216,1080
91,13,13,2025-02-15,8,426,473,47,376
950,1,10,2025-02-22,11,492,719,227,2497
343,25,29,2025-02-19,18,424,633,209,3762
462,11,28,2025-02-19,6,64,72,8,48
755,19,25,2025-02-14,10,105,129,24,240
237,27,8,2025-02-14,6,428,451,23,138
711,5,15,2025-02-12,12,286,324,38,456
262,15,15,2025-02-01,20,84,88,4,80
456,4,3,2025-02-26,12,451,506,55,660
731,25,18,2025-02-01,6,116,144,28,168
981,6,4,2025-02-21,20,391,527,136,2720
70,12,30,2025-02-17,4,287,375,88,352
501,24,1,2025-02-22,12,309,338,29,348
109,25,4,2025-02-17,14,128,165,37,518
341,18,18,2025-02-03,19,470,560,90,1710
768,15,23,2025-02-16,6,380,517,137,822
391,18,17,2025-02-02,2,404,605,201,402
348,30,8,2025-02-16,18,411,581,170,3060
619,28,7,2025-02-03,18,212,281,69,1242
159,17,30,2025-02-19,16,480,541,61,976
522,9,11,2025-02-10,2,356,389,33,66
527,5,6,2025-02-24,16,103,108,5,80
182,18,7,2025-02-20,10,294,326,32,320
949,27,8,2025-02-05,5,50,58,8,40
285,9,16,2025-02-09,7,394,437,43,301
768,28,17,2025-02-24,4,53,66,13,52
977,12,19,2025-02-20,7,378,399,21,147
130,24,21,2025-02-24,1,85,91,6,6
213,2,9,2025-02-23,5,132,189,57,285
134,23,15,2025-02-16,12,455,668,213,2556
713,29,4,2025-02-08,12,387,440,53,636
921,25,25,2025-02-05,17,67,83,16,272
908,2,14,2025-02-09,13,120,126,6,78
845,2,12,2025-02-23,20,138,203,65,1300
451,15,15,2025-02-12,13,482,633,151,1963
626,18,8,2025-02-05,3,370,392,22,66
166,20,3,2025-02-14,3,260,308,48,144
886,20,2,2025-02-28,6,318,441,123,738
544,7,4,2025-02-26,1,154,179,25,25
989,24,18,2025-02-27,9,54,72,18,162
402,6,5,2025-02-19,3,430,620,190,570
962,4,14,2025-02-16,1,276,297,21,21
416,18,29,2025-02-12,14,450,669,219,3066
403,15,25,2025-02-02,13,139,190,51,663
953,5,3,2025-02-19,17,431,529,98,1666
371,2,10,2025-02-19,10,418,582,164,1640
261,10,21,2025-02-02,15,240,294,54,810
202,22,10,2025-02-20,7,387,445,58,406
427,12,1,2025-02-10,20,212,239,27,540
195,5,28,2025-02-06,13,88,110,22,286
855,4,3,2025-02-10,5,150,172,22,110
421,22,5,2025-02-27,11,355,461,106,1166
329,9,22,2025-02-05,4,367,470,103,412
526,21,29,2025-02-02,18,396,504,108,1944
609,22,20,2025-02-04,20,496,612,116,2320
655,8,24,2025-02-10,3,356,470,114,342
700,13,9,2025-02-08,7,306,368,62,434
246,29,5,2025-02-24,10,255,380,125,1250
192,29,12,2025-02-22,2,206,266,60,120
231,8,9,2025-02-07,2,434,590,156,312
80,3,23,2025-02-27,12,454,613,159,1908
512,13,1,2025-02-12,9,209,301,92,828
798,24,13,2025-02-23,19,365,427,62,1178
339,26,15,2025-02-13,19,384,558,174,3306
817,9,24,2025-02-25,11,122,148,26,286
246,14,12,2025-02-19,16,458,537,79,1264
396,30,24,2025-02-20,17,215,319,104,1768
66,14,7,2025-02-09,5,60,68,8,40
293,12,1,2025-02-18,1,313,375,62,62
859,30,20,2025-02-10,17,64,91,27,459
190,25,13,2025-02-20,5,185,260,75,375
381,19,13,2025-02-13,10,452,565,113,1130
116,28,30,2025-02-08,1,252,363,111,111
283,5,8,2025-02-12,19,80,94,14,266
395,4,30,2025-02-27,10,46,69,23,230
977,9,21,2025-02-18,19,120,139,19,361
919,6,14,2025-02-27,4,174,244,70,280
908,10,7,2025-02-23,2,251,328,77,154
226,22,25,2025-02-15,8,73,108,35,280
698,29,1,2025-02-01,18,350,476,126,2268
125,16,17,2025-02-27,12,490,551,61,732
955,4,3,2025-02-12,18,248,271,23,414
955,18,9,2025-02-11,6,127,154,27,162
993,22,9,2025-02-24,6,241,349,108,648
518,26,15,2025-02-09,9,452,613,161,1449
912,22,16,2025-02-02,4,274,312,38,152
989,6,28,2025-02-21,1,374,482,108,108
816,11,29,2025-02-24,5,133,194,61,305
474,15,5,2025-02-19,14,224,304,80,1120
417,7,7,2025-02-15,1,77,91,14,14
64,21,27,2025-02-02,12,437,489,52,624
450,30,18,2025-02-03,1,494,727,233,233
334,21,17,2025-02-22,2,38,40,2,4
156,16,28,2025-02-22,6,393,435,42,252
317,6,11,2025-02-15,7,81,101,20,140
619,10,8,2025-02-19,4,413,604,191,764
782,13,17,2025-02-26,3,273,409,136,408
931,2,7,2025-02-04,7,213,283,70,490
360,23,5,2025-02-17,13,110,160,50,650
28,20,21,2025-02-06,19,391,522,131,2489
497,26,8,2025-02-12,5,388,473,85,425
631,12,27,2025-02-28,7,485,560,75,525
174,5,21,2025-02-23,15,136,186,50,750
195,29,17,2025-02-20,20,109,115,6,120
373,28,16,2025-02-23,8,420,508,88,704
133,8,14,2025-02-14,3,279,337,58,174
36,16,13,2025-02-03,2,302,450,148,296
47,17,6,2025-02-13,20,274,385,111,2220
124,25,17,2025-02-26,6,444,637,193,1158
391,2,4,2025-02-01,16,83,93,10,160
103,12,21,2025-02-28,18,133,193,60,1080
572,22,18,2025-02-21,6,381,415,34,204
880,16,22,2025-02-26,14,492,673,181,2534
269,18,28,2025-02-09,13,264,301,37,481
454,25,9,2025-02-05,5,127,189,62,310
988,7,23,2025-02-05,5,102,149,47,235
521,1,21,2025-02-04,20,169,197,28,560
158,12,18,2025-02-22,19,98,135,37,703
681,22,21,2025-02-28,6,111,153,42,252
363,13,2,2025-02-13,6,440,638,198,1188
346,7,12,2025-02-21,2,480,588,108,216
854,29,21,2025-02-26,16,462,651,189,3024
69,28,21,2025-02-04,18,48,56,8,144
701,26,16,2025-02-09,4,443,512,69,276
498,22,11,2025-02-08,18,176,246,70,1260
669,18,11,2025-02-05,1,474,638,164,164
226,25,13,2025-02-06,13,358,385,27,351
804,10,22,2025-02-13,8,312,444,132,1056
485,22,12,2025-02-13,3,180,248,68,204
810,16,2,2025-02-12,11,148,193,45,495
819,6,30,2025-02-21,3,208,226,18,54
738,9,3,2025-02-03,19,412,603,191,3629
351,11,14,2025-02-09,1,311,457,146,146
94,19,24,2025-02-13,19,128,168,40,760
462,18,16,2025-02-12,6,50,63,13,78
1,26,5,2025-02-01,9,106,132,26,234
163,22,1,2025-02-03,20,463,622,159,3180
99,5,24,2025-02-22,3,96,114,18,54
964,7,19,2025-02-08,14,483,713,230,3220
414,15,18,2025-02-19,15,227,242,15,225
978,17,16,2025-02-07,3,104,129,25,75
915,16,8,2025-02-03,20,414,469,55,1100
449,21,13,2025-02-22,1,255,378,123,123
713,19,17,2025-02-18,20,263,353,90,1800
431,12,8,2025-02-27,7,343,466,123,861
922,30,23,2025-02-23,10,123,136,13,130
94,21,25,2025-02-13,11,178,202,24,264
977,17,22,2025-02-24,19,346,415,69,1311
239,4,5,2025-02-02,6,81,106,25,150
361,27,1,2025-02-25,12,268,379,111,1332
279,10,19,2025-02-21,15,429,628,199,2985
492,1,23,2025-02-02,1,91,113,22,22
575,15,13,2025-02-10,10,298,402,104,1040
446,16,13,2025-02-10,19,249,328,79,1501
946,10,29,2025-02-03,14,437,498,61,854
912,12,14,2025-02-23,2,151,217,66,132
34,1,14,2025-02-08,12,181,247,66,792
482,7,2,2025-02-19,13,159,207,48,624
632,6,15,2025-02-15,3,76,110,34,102
580,21,12,2025-02-05,19,376,459,83,1577
329,7,2,2025-02-23,12,323,407,84,1008
9,6,12,2025-02-12,4,102,131,29,116
474,14,22,2025-02-07,14,173,200,27,378
81,28,11,2025-02-20,10,489,629,140,1400
871,18,27,2025-02-19,11,333,409,76,836
945,10,14,2025-02-22,14,146,173,27,378
339,25,9,2025-02-28,10,401,461,60,600
727,9,26,2025-02-03,10,333,368,35,350
584,30,20,2025-02-19,8,405,536,131,1048
854,23,28,2025-02-09,9,316,396,80,720
232,19,29,2025-02-09,14,155,164,9,126
778,22,27,2025-02-22,18,107,119,12,216
49,19,11,2025-02-17,14,85,112,27,378
489,24,30,2025-02-07,19,362,513,151,2869
658,25,29,2025-02-17,19,459,675,216,4104
103,8,6,2025-02-04,1,477,664,187,187
457,5,2,2025-02-23,6,78,112,34,204
780,2,16,2025-02-11,10,480,688,208,2080
357,7,10,2025-02-21,14,209,251,42,588
820,19,5,2025-02-28,5,39,45,6,30
44,10,9,2025-02-19,14,454,539,85,1190
952,3,5,2025-02-24,20,134,175,41,820
843,1,5,2025-02-24,12,74,82,8,96
118,7,24,2025-02-28,15,190,273,83,1245
886,12,17,2025-02-23,20,220,250,30,600
597,11,21,2025-02-22,16,21,27,6,96
441,26,3,2025-02-19,20,131,193,62,1240
268,23,12,2025-02-18,10,116,135,19,190
336,13,13,2025-02-08,3,57,66,9,27
556,18,12,2025-02-02,7,171,248,77,539
196,27,14,2025-02-06,5,37,53,16,80
200,10,15,2025-02-10,6,155,191,36,216
672,4,1,2025-02-10,8,359,450,91,728
594,14,17,2025-02-24,13,420,596,176,2288
852,1,2,2025-02-18,11,383,524,141,1551
145,19,28,2025-02-09,13,405,531,126,1638
52,5,29,2025-02-26,3,351,473,122,366
499,15,29,2025-02-10,3,258,301,43,129
39,10,7,2025-02-27,11,49,55,6,66
550,26,26,2025-02-27,12,44,49,5,60
835,18,20,2025-02-09,14,220,264,44,616
460,25,11,2025-02-24,6,121,138,17,102
533,5,20,2025-02-26,8,24,27,3,24
138,11,13,2025-02-19,4,130,148,18,72
11,8,1,2025-02-08,7,149,184,35,245
452,3,24,2025-02-23,4,363,528,165,660
803,15,12,2025-02-27,1,244,350,106,106
146,25,16,2025-02-20,20,197,273,76,1520
323,8,29,2025-02-24,2,108,127,19,38
380,7,2,2025-02-03,6,486,561,75,450
596,18,25,2025-02-09,16,107,124,17,272
222,9,23,2025-02-26,5,43,48,5,25
304,15,3,2025-02-26,19,434,600,166,3154
940,25,1,2025-02-03,15,387,435,48,720
168,22,26,2025-02-05,10,46,67,21,210
60,15,27,2025-02-24,14,489,696,207,2898
677,29,18,2025-02-15,4,445,651,206,824
658,21,23,2025-02-16,11,442,516,74,814
109,20,26,2025-02-27,20,499,718,219,4380
948,9,2,2025-02-13,12,347,449,102,1224
550,28,30,2025-02-15,5,423,573,150,750
645,5,11,2025-02-17,3,112,125,13,39
614,2,26,2025-02-19,11,217,266,49,539
547,10,23,2025-02-09,17,391,541,150,2550
970,8,16,2025-02-08,7,251,328,77,539
964,3,26,2025-02-06,4,86,94,8,32
49,4,17,2025-02-15,17,41,47,6,102
355,23,18,2025-02-14,20,45,61,16,320
913,29,3,2025-02-15,2,461,655,194,388
299,23,2,2025-02-26,8,326,364,38,304
107,19,20,2025-02-20,9,375,454,79,711
613,11,24,2025-02-25,4,272,298,26,104
180,5,29,2025-02-16,13,403,469,66,858
226,18,15,2025-02-06,6,30,36,6,36
297,5,5,2025-02-04,13,110,134,24,312
329,22,26,2025-02-09,19,470,630,160,3040
871,7,30,2025-02-07,1,374,484,110,110
201,7,10,2025-02-10,10,246,355,109,1090
854,1,10,2025-02-17,17,275,352,77,1309
595,30,11,2025-02-01,9,257,272,15,135
171,1,28,2025-02-12,20,369,450,81,1620
520,22,12,2025-02-03,20,412,595,183,3660
195,26,22,2025-02-15,16,151,201,50,800
926,6,13,2025-02-14,7,101,149,48,336
613,24,11,2025-02-14,8,157,178,21,168
944,16,16,2025-02-11,6,101,148,47,282
581,5,1,2025-02-14,3,473,582,109,327
556,3,5,2025-02-26,20,88,93,5,100
378,19,24,2025-02-06,5,323,381,58,290
74,11,30,2025-02-28,14,131,140,9,126
606,11,11,2025-02-25,19,225,260,35,665
251,15,22,2025-02-24,5,350,432,82,410
847,20,24,2025-02-10,6,41,51,10,60
78,11,22,2025-02-09,20,283,301,18,360
685,18,11,2025-02-04,7,124,171,47,329
229,21,18,2025-02-25,2,42,49,7,14
548,28,28,2025-02-08,6,52,74,22,132
86,6,28,2025-02-05,4,444,501,57,228
79,12,24,2025-02-10,17,359,524,165,2805
116,23,12,2025-02-18,5,465,579,114,570
428,18,16,2025-02-13,10,477,503,26,260
782,19,4,2025-02-17,11,154,200,46,506
60,13,10,2025-02-10,5,448,639,191,955
1,2,26,2025-02-13,6,311,456,145,870
938,30,16,2025-02-15,17,265,307,42,714
322,17,11,2025-02-25,13,346,426,80,1040
969,28,13,2025-02-24,10,416,576,160,1600
611,14,24,2025-02-05,7,171,230,59,413
115,20,5,2025-02-23,14,434,484,50,700
77,7,6,2025-02-01,10,373,402,29,290
292,6,20,2025-02-09,18,131,184,53,954
116,10,24,2025-02-16,17,489,707,218,3706
792,28,23,2025-02-28,4,66,83,17,68
630,15,5,2025-02-27,14,321,425,104,1456
628,9,19,2025-02-23,17,69,93,24,408
527,23,7,2025-02-04,18,30,32,2,36
897,14,14,2025-02-14,1,397,540,143,143
173,23,1,2025-02-02,1,198,291,93,93
766,6,18,2025-02-11,7,298,366,68,476
894,4,1,2025-02-11,2,187,264,77,154
277,8,29,2025-02-17,8,301,412,111,888
958,12,18,2025-02-23,6,493,610,117,702
830,20,6,2025-02-22,19,412,546,134,2546
62,15,13,2025-02-18,14,103,146,43,602
775,14,30,2025-02-08,8,110,157,47,376
911,7,29,2025-02-28,17,332,482,150,2550
690,26,29,2025-02-07,7,437,554,117,819
922,24,3,2025-02-17,11,345,380,35,385
647,18,30,2025-02-26,13,110,135,25,325
108,8,14,2025-02-18,10,417,458,41,410
997,3,7,2025-02-05,17,425,476,51,867
922,8,23,2025-02-20,5,70,95,25,125
870,17,24,2025-02-08,12,479,543,64,768
755,20,24,2025-02-28,3,290,367,77,231
726,25,24,2025-02-23,1,227,336,109,109
494,16,13,2025-02-04,2,236,328,92,184
741,12,27,2025-02-19,6,23,31,8,48
957,18,17,2025-02-04,9,146,204,58,522
637,5,15,2025-02-20,15,229,252,23,345
941,17,23,2025-02-04,12,323,400,77,924
874,18,21,2025-02-08,18,374,443,69,1242
677,16,6,2025-02-24,1,386,548,162,162
155,23,13,2025-02-13,12,376,556,180,2160
409,18,13,2025-02-25,6,333,480,147,882
589,27,4,2025-02-05,11,249,284,35,385
632,17,19,2025-02-19,6,195,233,38,228
617,9,22,2025-02-14,1,411,514,103,103
306,29,5,2025-02-19,20,31,39,8,160
643,16,5,2025-02-25,20,230,285,55,1100
312,3,25,2025-02-15,19,336,413,77,1463
23,18,1,2025-02-18,20,254,302,48,960
697,16,9,2025-02-18,12,371,493,122,1464
585,10,13,2025-02-09,3,280,318,38,114
623,26,17,2025-02-28,10,77,95,18,180
249,10,27,2025-02-15,17,342,412,70,1190
409,24,19,2025-02-18,18,74,111,37,666
300,25,19,2025-02-18,1,155,183,28,28
11,26,20,2025-02-06,17,432,530,98,1666
11,11,6,2025-02-04,2,103,127,24,48
985,15,2,2025-02-13,13,168,218,50,650
924,2,1,2025-02-27,18,111,130,19,342
854,9,12,2025-02-17,4,414,476,62,248
570,29,18,2025-02-19,18,117,169,52,936
824,2,11,2025-02-16,10,361,511,150,1500
565,8,20,2025-02-20,16,154,219,65,1040
762,4,18,2025-02-12,14,463,535,72,1008
153,30,15,2025-02-26,12,488,515,27,324
1,7,2,2025-02-22,12,388,476,88,1056
696,13,4,2025-02-19,20,202,271,69,1380
18,30,12,2025-02-13,10,69,90,21,210
786,19,7,2025-02-27,15,297,401,104,1560
919,10,14,2025-02-15,19,46,59,13,247
492,30,24,2025-02-01,4,291,367,76,304
425,29,21,2025-02-26,2,35,39,4,8
769,7,14,2025-02-12,4,44,51,7,28
941,10,10,2025-02-09,5,327,431,104,520
45,13,16,2025-02-09,11,236,307,71,781
952,13,27,2025-02-12,6,174,256,82,492
387,5,26,2025-02-25,5,79,94,15,75
353,20,20,2025-02-14,16,90,107,17,272
436,25,6,2025-02-06,6,83,110,27,162
340,8,7,2025-02-21,10,245,345,100,1000
265,16,10,2025-02-16,13,175,226,51,663
702,26,11,2025-02-12,20,134,177,43,860
335,6,4,2025-02-28,8,293,337,44,352
7,16,27,2025-02-03,5,167,200,33,165
357,7,4,2025-02-06,20,48,50,2,40
256,13,5,2025-02-22,6,66,97,31,186
70,30,23,2025-02-25,16,141,207,66,1056
656,5,21,2025-02-15,16,100,124,24,384
278,18,21,2025-02-18,8,336,405,69,552
329,23,22,2025-02-11,18,186,210,24,432
599,22,10,2025-02-06,12,91,125,34,408
321,4,13,2025-02-04,17,187,238,51,867
630,3,15,2025-02-03,2,192,281,89,178
542,28,21,2025-02-02,12,177,234,57,684
265,15,15,2025-02-10,9,261,301,40,360
375,21,7,2025-02-12,5,172,215,43,215
542,24,24,2025-02-28,10,77,110,33,330
865,15,4,2025-02-12,19,173,236,63,1197
585,15,7,2025-02-09,10,453,659,206,2060
209,2,11,2025-02-08,16,281,363,82,1312
228,7,4,2025-02-17,7,235,256,21,147
807,3,23,2025-02-07,8,442,592,150,1200
941,20,6,2025-02-14,2,282,356,74,148
548,29,6,2025-02-26,18,54,65,11,198
179,16,18,2025-02-16,7,24,28,4,28
569,14,6,2025-02-11,3,180,204,24,72
456,23,10,2025-02-14,11,445,600,155,1705
949,11,24,2025-02-08,16,435,614,179,2864
525,2,4,2025-02-17,19,462,507,45,855
436,22,16,2025-02-07,10,162,233,71,710
509,3,24,2025-02-16,15,400,488,88,1320
167,19,26,2025-02-13,19,497,536,39,741
318,8,7,2025-02-27,13,89,117,28,364
590,9,29,2025-02-13,14,154,229,75,1050
350,2,20,2025-02-19,19,319,448,129,2451
707,2,4,2025-02-02,18,324,421,97,1746
492,8,19,2025-02-01,18,483,558,75,1350
954,22,23,2025-02-11,6,68,93,25,150
554,20,14,2025-02-22,17,168,245,77,1309
175,21,10,2025-02-13,9,396,583,187,1683
796,17,10,2025-02-20,20,390,490,100,2000
380,15,6,2025-02-18,12,441,617,176,2112
503,11,21,2025-02-23,19,198,275,77,1463
130,17,24,2025-02-04,19,46,52,6,114
74,15,24,2025-02-19,15,394,509,115,1725
677,29,22,2025-02-28,3,439,488,49,147
542,18,7,2025-02-21,20,484,695,211,4220
921,3,15,2025-02-01,11,404,530,126,1386
307,30,9,2025-02-11,4,424,496,72,288
949,7,14,2025-02-16,6,287,430,143,858
536,4,3,2025-02-06,7,346,368,22,154
541,17,11,2025-02-25,14,454,586,132,1848
794,3,19,2025-02-08,20,271,386,115,2300
82,9,30,2025-02-11,19,25,36,11,209
24,24,26,2025-02-20,19,342,489,147,2793
854,4,15,2025-02-15,19,44,54,10,190
152,18,28,2025-02-14,14,319,365,46,644
843,26,12,2025-02-03,11,401,512,111,1221
769,1,25,2025-02-24,15,403,425,22,330
857,22,11,2025-02-07,5,364,447,83,415
765,24,4,2025-02-04,19,143,201,58,1102
82,1,8,2025-02-28,18,84,120,36,648
486,10,5,2025-02-21,11,198,219,21,231
741,14,2,2025-02-19,2,373,481,108,216
847,18,26,2025-02-04,17,387,428,41,697
291,11,2,2025-02-05,10,128,176,48,480
212,13,3,2025-02-11,17,274,313,39,663
776,13,5,2025-02-15,3,131,178,47,141
522,24,20,2025-02-13,19,145,166,21,399
248,26,20,2025-02-02,1,340,408,68,68
330,28,25,2025-02-27,14,66,80,14,196
979,10,15,2025-02-22,8,64,86,22,176
882,13,27,2025-02-13,8,319,405,86,688
191,12,12,2025-02-26,4,71,87,16,64
253,13,22,2025-02-20,2,357,396,39,78
521,30,8,2025-02-16,16,113,142,29,464
876,6,18,2025-02-20,14,412,553,141,1974
420,1,11,2025-02-08,10,110,141,31,310
387,26,9,2025-02-09,3,438,599,161,483
423,3,2,2025-02-04,20,376,473,97,1940
972,11,21,2025-02-07,11,294,424,130,1430
651,30,10,2025-02-14,9,41,61,20,180
987,4,2,2025-02-07,18,299,314,15,270
503,7,1,2025-02-09,5,269,333,64,320
433,5,30,2025-02-28,17,466,511,45,765
649,9,22,2025-02-09,15,79,102,23,345
593,8,19,2025-02-11,7,494,524,30,210
422,19,26,2025-02-02,14,273,336,63,882
712,25,28,2025-02-22,20,340,505,165,3300
942,1,19,2025-02-06,6,278,359,81,486
879,9,20,2025-02-17,15,411,481,70,1050
328,25,12,2025-02-04,8,445,634,189,1512
337,18,24,2025-02-15,5,453,576,123,615
465,9,29,2025-02-07,1,348,517,169,169
826,18,18,2025-02-04,4,407,498,91,364
853,27,9,2025-02-25,2,123,146,23,46
214,19,17,2025-02-25,17,481,519,38,646
506,7,18,2025-02-16,15,353,489,136,2040
985,17,8,2025-02-24,8,129,159,30,240
780,16,15,2025-02-01,9,68,79,11,99
9,20,1,2025-02-20,4,198,225,27,108
846,21,28,2025-02-14,1,115,149,34,34
406,5,12,2025-02-09,6,40,59,19,114
70,21,28,2025-02-06,8,477,519,42,336
36,24,21,2025-02-12,15,256,284,28,420
275,25,9,2025-02-03,1,48,66,18,18
507,23,19,2025-02-27,9,71,93,22,198
164,9,12,2025-02-25,8,450,584,134,1072
78,2,20,2025-02-16,20,178,195,17,340
650,30,5,2025-02-05,9,298,441,143,1287
29,19,24,2025-02-24,18,263,294,31,558
400,9,28,2025-02-19,14,124,140,16,224
383,3,16,2025-02-27,10,426,475,49,490
297,1,9,2025-02-27,7,108,134,26,182
111,18,27,2025-02-20,2,38,43,5,10
392,17,14,2025-02-04,13,130,139,9,117
13,5,18,2025-02-13,15,375,504,129,1935
58,30,30,2025-02-05,2,36,47,11,22
799,26,8,2025-02-13,14,389,432,43,602
585,12,7,2025-02-14,18,318,338,20,360
348,15,16,2025-02-20,11,35,38,3,33
507,8,5,2025-02-11,19,26,28,2,38
473,7,20,2025-02-15,3,117,162,45,135
36,21,15,2025-02-06,6,67,74,7,42
554,27,13,2025-02-19,2,400,512,112,224
906,3,21,2025-02-13,16,92,104,12,192
26,26,27,2025-02-09,11,465,681,216,2376
793,9,24,2025-02-14,4,273,300,27,108
172,18,26,2025-02-03,16,447,471,24,384
263,10,8,2025-02-14,2,94,134,40,80
778,10,10,2025-02-28,5,114,138,24,120
96,21,13,2025-02-01,5,195,221,26,130
934,19,9,2025-02-25,3,92,136,44,132
936,30,22,2025-02-24,1,318,373,55,55
760,27,15,2025-02-26,16,472,534,62,992
632,1,7,2025-02-22,6,235,315,80,480
362,11,4,2025-02-08,5,260,321,61,305
668,15,20,2025-02-27,10,388,505,117,1170
994,22,5,2025-02-09,12,443,603,160,1920
599,18,12,2025-02-04,13,38,42,4,52
109,19,22,2025-02-04,11,496,641,145,1595
945,27,3,2025-02-06,14,296,428,132,1848
776,23,10,2025-02-24,20,430,555,125,2500
424,9,16,2025-02-18,14,425,614,189,2646
527,22,14,2025-02-05,7,257,314,57,399
61,30,1,2025-02-17,17,157,187,30,510
266,1,17,2025-02-24,8,244,346,102,816
571,3,19,2025-02-04,19,36,46,10,190
635,28,19,2025-02-05,3,243,288,45,135
52,13,19,2025-02-24,17,497,706,209,3553
916,7,13,2025-02-20,5,446,508,62,310
334,8,9,2025-02-18,9,281,350,69,621
460,2,17,2025-02-06,4,134,175,41,164
541,14,11,2025-02-09,14,115,128,13,182
877,1,6,2025-02-03,6,122,169,47,282
504,22,24,2025-02-05,1,203,296,93,93
2,29,7,2025-02-25,7,21,23,2,14
19,18,17,2025-02-13,8,426,503,77,616
732,13,15,2025-02-08,19,76,101,25,475
4,17,17,2025-02-19,19,66,73,7,133
122,13,26,2025-02-01,1,316,468,152,152
871,3,13,2025-02-19,5,440,509,69,345
702,16,7,2025-02-15,19,364,469,105,1995
792,19,24,2025-02-15,20,42,51,9,180
555,26,24,2025-02-11,10,298,446,148,1480
974,3,28,2025-02-28,18,237,300,63,1134
265,13,8,2025-02-02,2,31,45,14,28
836,27,19,2025-02-17,9,370,425,55,495
445,4,29,2025-02-04,8,248,270,22,176
99,17,29,2025-02-03,11,67,90,23,253
569,21,12,2025-02-23,9,188,240,52,468
778,19,26,2025-02-10,5,29,33,4,20
267,26,28,2025-02-22,1,55,67,12,12
332,25,8,2025-02-09,14,230,245,15,210
330,13,19,2025-02-20,20,148,174,26,520
912,23,9,2025-02-28,13,241,301,60,780
734,2,4,2025-02-02,18,90,105,15,270
660,24,1,2025-02-26,5,381,532,151,755
933,3,23,2025-02-17,5,491,546,55,275
228,17,15,2025-02-20,10,20,22,2,20
913,13,5,2025-02-02,17,197,251,54,918
72,16,9,2025-02-23,11,483,537,54,594
233,26,30,2025-02-12,7,230,274,44,308
974,30,8,2025-02-12,15,28,30,2,30
90,6,20,2025-02-04,18,91,118,27,486
340,4,18,2025-02-04,14,500,541,41,574
181,26,21,2025-02-11,12,309,327,18,216
682,28,29,2025-02-13,4,472,502,30,120
476,20,6,2025-02-08,2,155,192,37,74
25,2,3,2025-02-05,18,144,185,41,738
470,3,1,2025-02-03,6,122,182,60,360
131,19,24,2025-02-21,14,55,66,11,154
129,1,21,2025-02-09,18,386,470,84,1512
510,24,14,2025-02-14,11,134,198,64,704
791,29,24,2025-02-25,9,179,219,40,360
48,29,10,2025-02-21,6,477,532,55,330
451,14,8,2025-02-28,10,216,307,91,910
26,4,20,2025-02-03,11,141,148,7,77
512,24,24,2025-02-26,7,394,469,75,525
866,5,9,2025-02-08,12,305,452,147,1764
86,16,14,2025-02-18,6,103,152,49,294
776,4,24,2025-02-22,5,442,555,113,565
976,6,13,2025-02-15,1,280,343,63,63
429,23,26,2025-02-13,12,497,678,181,2172
410,5,28,2025-02-05,9,59,87,28,252
637,29,15,2025-02-14,18,246,315,69,1242
865,9,26,2025-02-20,10,262,330,68,680
83,22,6,2025-02-19,2,347,397,50,100
16,2,14,2025-02-04,17,175,223,48,816
495,10,5,2025-02-05,8,180,259,79,632
832,7,10,2025-02-02,10,391,484,93,930
757,25,13,2025-02-18,5,76,85,9,45
345,26,21,2025-02-14,9,329,455,126,1134
365,6,12,2025-02-09,19,422,476,54,1026
994,13,22,2025-02-23,9,430,506,76,684
839,3,25,2025-02-04,4,363,497,134,536
505,25,7,2025-02-18,18,61,79,18,324
475,8,1,2025-02-28,14,139,165,26,364
346,22,19,2025-02-26,10,276,398,122,1220
515,26,6,2025-02-24,3,290,372,82,246
601,26,14,2025-02-18,1,227,280,53,53
887,25,1,2025-02-12,4,438,480,42,168
45,6,3,2025-02-06,12,179,204,25,300
768,9,3,2025-02-26,6,146,210,64,384
122,23,13,2025-02-02,10,332,460,128,1280
541,14,1,2025-02-27,8,274,305,31,248
731,24,21,2025-02-28,17,217,233,16,272
60,7,6,2025-02-02,7,73,96,23,161
564,27,19,2025-02-20,20,487,721,234,4680
83,3,26,2025-02-09,2,500,528,28,56
305,30,30,2025-02-16,4,143,157,14,56
707,16,24,2025-02-04,19,441,556,115,2185
668,18,14,2025-02-02,4,472,629,157,628
398,29,30,2025-02-05,12,370,508,138,1656
770,2,24,2025-02-17,9,70,92,22,198
292,28,21,2025-02-15,17,188,271,83,1411
944,1,21,2025-02-04,3,125,185,60,180
349,8,11,2025-02-17,6,381,421,40,240
484,30,6,2025-02-18,17,366,527,161,2737
455,17,24,2025-02-01,16,90,126,36,576
614,25,2,2025-02-23,8,259,285,26,208
426,4,14,2025-02-01,18,373,478,105,1890
798,20,16,2025-02-27,5,86,125,39,195
694,20,29,2025-02-25,19,344,514,170,3230
258,16,16,2025-02-25,4,294,335,41,164
347,27,8,2025-02-02,15,469,581,112,1680
885,4,29,2025-02-01,6,428,505,77,462
16,22,24,2025-02-23,18,207,290,83,1494
477,28,17,2025-02-02,1,106,142,36,36
686,28,10,2025-02-07,5,129,186,57,285
988,6,6,2025-02-27,4,220,289,69,276
809,13,20,2025-02-22,13,302,365,63,819
467,9,13,2025-02-22,16,30,37,7,112
454,22,22,2025-02-12,3,243,323,80,240
122,8,19,2025-02-28,12,376,521,145,1740
899,5,3,2025-02-11,2,396,436,40,80
417,29,10,2025-02-27,5,218,236,18,90
492,30,1,2025-02-07,7,206,221,15,105
964,27,21,2025-02-17,9,477,669,192,1728
289,28,7,2025-02-23,4,337,435,98,392
228,19,5,2025-02-10,18,457,540,83,1494
68,8,1,2025-02-01,10,487,535,48,480
436,20,26,2025-02-26,3,436,461,25,75
879,8,2,2025-02-05,4,208,304,96,384
387,16,24,2025-02-12,18,218,297,79,1422
414,23,26,2025-02-08,8,361,520,159,1272
630,28,11,2025-02-08,10,301,328,27,270
4,11,1,2025-02-27,4,470,654,184,736
934,16,14,2025-02-09,5,271,346,75,375
828,19,26,2025-02-14,4,183,231,48,192
566,11,11,2025-02-24,4,90,117,27,108
79,29,15,2025-02-16,11,433,474,41,451
240,19,12,2025-02-25,19,274,350,76,1444
350,12,9,2025-02-05,13,457,673,216,2808
47,25,22,2025-02-26,20,256,287,31,620
752,13,1,2025-02-05,10,422,499,77,770
777,24,27,2025-02-12,9,236,330,94,846
480,5,2,2025-02-12,3,246,270,24,72
472,7,2,2025-02-27,17,257,284,27,459
394,26,9,2025-02-25,16,292,437,145,2320
771,8,16,2025-02-22,2,130,142,12,24
326,10,8,2025-02-17,1,417,473,56,56
453,10,27,2025-02-03,10,277,396,119,1190
723,15,22,2025-02-06,13,45,51,6,78
177,11,9,2025-02-25,13,370,476,106,1378
152,29,15,2025-02-06,18,284,405,121,2178
47,15,14,2025-02-14,9,89,94,5,45
669,29,13,2025-02-22,7,93,118,25,175
70,28,27,2025-02-23,7,193,221,28,196
562,30,13,2025-02-16,14,374,416,42,588
619,5,7,2025-02-17,14,389,497,108,1512
487,20,2,2025-02-14,1,428,500,72,72
941,30,17,2025-02-13,19,367,424,57,1083
59,23,11,2025-02-25,12,418,483,65,780
7,12,26,2025-02-01,17,447,591,144,2448
149,16,7,2025-02-19,14,400,435,35,490
927,11,20,2025-02-28,15,239,353,114,1710
796,1,11,2025-02-07,11,230,288,58,638
755,16,17,2025-02-20,15,275,377,102,1530
353,9,6,2025-02-14,3,320,437,117,351
29,8,27,2025-02-26,17,152,170,18,306
186,16,7,2025-02-28,13,403,575,172,2236
467,24,7,2025-02-06,2,381,430,49,98
967,21,5,2025-02-16,4,74,103,29,116
856,15,27,2025-02-12,16,238,315,77,1232
992,16,4,2025-02-14,6,49,69,20,120
162,20,29,2025-02-18,12,78,92,14,168
858,18,13,2025-02-19,18,139,148,9,162
180,4,27,2025-02-14,19,24,27,3,57
878,26,6,2025-02-06,1,480,543,63,63
424,19,26,2025-02-18,1,68,102,34,34
912,9,6,2025-02-22,13,157,200,43,559
80,2,14,2025-02-18,1,464,502,38,38
476,29,29,2025-02-25,1,491,563,72,72
83,13,30,2025-02-07,15,474,664,190,2850
910,11,22,2025-02-01,2,169,222,53,106
214,6,14,2025-02-27,15,113,132,19,285
287,13,19,2025-02-08,4,461,652,191,764
164,19,9,2025-02-26,15,241,359,118,1770
938,18,1,2025-02-18,8,308,328,20,160
408,25,30,2025-02-11,9,51,57,6,54
359,20,24,2025-02-20,18,186,204,18,324
619,8,24,2025-02-20,8,85,107,22,176
162,25,16,2025-02-06,18,460,501,41,738
917,19,4,2025-02-27,13,133,160,27,351
49,10,25,2025-02-19,14,50,55,5,70
441,23,14,2025-02-15,13,350,420,70,910
176,15,28,2025-02-06,18,349,414,65,1170
211,19,16,2025-02-09,20,403,537,134,2680
383,1,15,2025-02-24,1,278,399,121,121
446,10,27,2025-02-01,14,403,513,110,1540
373,25,14,2025-02-28,1,106,113,7,7
11,22,23,2025-02-04,19,451,645,194,3686
610,2,6,2025-02-06,3,482,587,105,315
846,10,29,2025-02-27,8,337,359,22,176
266,18,19,2025-02-02,19,135,152,17,323
161,12,7,2025-02-08,7,108,114,6,42
172,8,12,2025-02-03,2,98,139,41,82
928,21,26,2025-02-11,12,456,679,223,2676
117,20,29,2025-02-24,8,192,226,34,272
816,23,22,2025-02-02,8,457,563,106,848
517,27,18,2025-02-26,18,165,225,60,1080
214,20,7,2025-02-25,8,118,170,52,416
302,28,8,2025-02-13,6,323,401,78,468
8,26,18,2025-02-01,12,308,427,119,1428
552,21,8,2025-02-04,5,445,661,216,1080
276,25,9,2025-02-03,6,470,616,146,876
455,25,11,2025-02-25,20,221,263,42,840
896,20,20,2025-02-20,5,48,53,5,25
249,16,13,2025-02-07,3,266,334,68,204
603,12,9,2025-02-06,3,484,511,27,81
187,20,25,2025-02-28,9,348,380,32,288
209,29,15,2025-02-11,20,427,467,40,800
136,6,13,2025-02-15,3,379,437,58,174
494,12,8,2025-02-24,13,85,125,40,520
876,9,16,2025-02-11,5,361,518,157,785
645,30,13,2025-02-09,13,72,105,33,429
146,23,1,2025-02-20,14,81,101,20,280
785,8,1,2025-02-01,19,323,362,39,741
760,29,18,2025-02-09,11,467,519,52,572
63,7,6,2025-02-23,4,52,63,11,44
236,28,11,2025-02-12,1,182,199,17,17
215,24,25,2025-02-05,4,317,424,107,428
307,8,22,2025-02-27,2,284,407,123,246
497,30,19,2025-02-15,5,153,193,40,200
998,5,12,2025-02-23,9,460,510,50,450
995,3,17,2025-02-18,8,382,542,160,1280
644,26,22,2025-02-11,18,425,467,42,756
185,24,30,2025-02-01,10,415,537,122,1220
505,2,14,2025-02-16,13,444,581,137,1781
985,7,29,2025-02-08,6,321,422,101,606
572,14,12,2025-02-04,12,466,619,153,1836
59,6,11,2025-02-15,18,360,425,65,1170
444,9,2,2025-02-17,11,345,440,95,1045
804,12,24,2025-02-17,17,118,168,50,850
555,6,25,2025-02-11,14,383,539,156,2184
139,13,26,2025-02-06,1,398,509,111,111
408,16,5,2025-02-22,19,418,471,53,1007
313,30,7,2025-02-28,11,397,484,87,957
805,19,13,2025-02-06,18,101,114,13,234
891,12,1,2025-02-25,4,293,332,39,156
747,26,22,2025-02-21,13,106,147,41,533
308,15,6,2025-02-18,14,116,153,37,518
258,29,6,2025-02-21,1,66,95,29,29
174,26,6,2025-02-08,9,64,75,11,99
588,6,20,2025-02-01,1,330,451,121,121
428,13,6,2025-02-27,15,40,44,4,60
409,1,9,2025-02-27,11,443,632,189,2079
986,19,12,2025-02-14,7,114,123,9,63
857,10,21,2025-02-02,1,387,447,60,60
77,2,24,2025-02-25,3,314,361,47,141
380,25,7,2025-02-18,20,110,122,12,240
306,27,15,2025-02-03,3,323,371,48,144
873,1,23,2025-02-02,14,30,44,14,196
148,15,16,2025-02-22,2,184,226,42,84
410,4,30,2025-02-22,14,445,636,191,2674
486,14,28,2025-02-05,13,164,188,24,312
539,23,12,2025-02-01,1,313,375,62,62
475,6,7,2025-02-09,14,66,83,17,238
436,22,5,2025-02-28,8,364,400,36,288
889,29,7,2025-02-26,14,78,82,4,56
960,26,20,2025-02-09,10,384,419,35,350
446,10,5,2025-02-07,4,219,264,45,180
922,27,10,2025-02-04,7,255,288,33,231
482,22,29,2025-02-13,17,205,259,54,918
431,29,30,2025-02-25,2,236,339,103,206
214,26,9,2025-02-20,10,112,149,37,370
47,27,9,2025-02-14,3,262,314,52,156
349,4,17,2025-02-18,15,30,45,15,225
856,28,16,2025-02-20,20,309,351,42,840
307,23,6,2025-02-02,6,166,216,50,300
456,10,9,2025-02-25,9,59,82,23,207
173,8,9,2025-02-12,14,419,503,84,1176
202,17,27,2025-02-13,19,150,188,38,722
780,1,6,2025-02-12,10,415,536,121,1210
764,8,13,2025-02-27,5,234,305,71,355
43,9,23,2025-02-15,6,121,155,34,204
752,23,9,2025-02-03,1,21,28,7,7
233,17,28,2025-02-11,11,266,368,102,1122
275,6,3,2025-02-13,9,140,167,27,243
605,20,1,2025-02-27,2,317,444,127,254
489,18,3,2025-02-09,14,45,53,8,112
867,21,21,2025-02-14,4,170,195,25,100
518,30,17,2025-02-09,9,128,161,33,297
406,24,13,2025-02-03,18,405,508,103,1854
668,28,12,2025-02-14,9,478,591,113,1017
479,5,22,2025-02-13,8,226,294,68,544
829,29,26,2025-02-03,12,357,423,66,792
711,3,17,2025-02-12,17,402,532,130,2210
35,2,5,2025-02-15,16,493,672,179,2864
591,27,4,2025-02-01,17,177,212,35,595
715,15,21,2025-02-27,18,217,230,13,234
1000,8,12,2025-02-14,14,37,44,7,98
38,8,23,2025-02-08,15,156,228,72,1080
607,17,8,2025-02-07,1,222,281,59,59
451,22,7,2025-02-01,13,261,356,95,1235
909,29,4,2025-02-18,5,113,156,43,215
431,14,29,2025-02-28,16,486,636,150,2400
288,25,3,2025-02-20,1,414,530,116,116
521,21,17,2025-02-14,11,131,167,36,396
338,22,20,2025-02-26,2,218,275,57,114
211,19,14,2025-02-07,10,368,521,153,1530
714,17,23,2025-02-20,17,407,516,109,1853
410,1,24,2025-02-28,11,428,641,213,2343
331,28,1,2025-02-28,10,312,347,35,350
849,4,23,2025-02-15,2,154,207,53,106
575,14,25,2025-02-23,3,299,430,131,393
700,24,15,2025-02-01,14,220,251,31,434
860,2,25,2025-02-03,13,410,461,51,663
954,22,29,2025-02-01,16,118,174,56,896
595,19,6,2025-02-25,17,449,596,147,2499
690,19,27,2025-02-18,6,271,299,28,168
158,14,23,2025-02-11,7,415,586,171,1197
475,3,15,2025-02-24,1,293,363,70,70
851,10,20,2025-02-09,6,227,298,71,426
162,1,7,2025-02-23,19,294,400,106,2014
681,8,29,2025-02-03,8,187,222,35,280
656,20,23,2025-02-01,4,164,199,35,140
580,20,14,2025-02-15,1,214,282,68,68
66,20,11,2025-02-27,18,244,277,33,594
377,9,20,2025-02-17,6,159,184,25,150
935,17,24,2025-02-25,9,357,501,144,1296
832,2,23,2025-02-05,3,258,355,97,291
115,14,16,2025-02-17,1,217,290,73,73
977,21,9,2025-02-22,8,367,404,37,296
905,21,17,2025-02-19,2,72,88,16,32
872,9,29,2025-02-25,19,491,675,184,3496
146,29,28,2025-02-21,17,67,80,13,221
205,15,25,2025-02-02,4,263,283,20,80
614,5,14,2025-02-21,10,41,51,10,100
50,7,1,2025-02-17,18,36,46,10,180
920,28,28,2025-02-03,15,101,124,23,345
542,6,20,2025-02-14,18,109,146,37,666
789,10,27,2025-02-10,17,187,260,73,1241
31,22,28,2025-02-01,15,95,122,27,405
676,19,11,2025-02-19,6,348,467,119,714
647,9,3,2025-02-03,14,296,311,15,210
960,19,22,2025-02-04,20,472,686,214,4280
880,4,6,2025-02-26,16,227,278,51,816
16,18,2,2025-02-17,5,450,476,26,130
640,4,15,2025-02-02,6,492,610,118,708
689,29,29,2025-02-09,9,157,180,23,207
823,20,13,2025-02-21,6,348,405,57,342
535,22,27,2025-02-16,1,61,69,8,8
754,24,10,2025-02-26,5,172,193,21,105
898,12,7,2025-02-14,20,29,38,9,180
962,30,5,2025-02-08,15,206,239,33,495
188,18,30,2025-02-09,19,251,309,58,1102
836,30,23,2025-02-02,8,332,405,73,584
780,15,1,2025-02-05,10,144,176,32,320
137,28,25,2025-02-23,10,41,50,9,90
228,23,25,2025-02-14,9,276,383,107,963
717,18,27,2025-02-15,12,418,616,198,2376
696,1,8,2025-02-28,13,443,605,162,2106
861,29,29,2025-02-17,18,95,105,10,180
896,23,19,2025-02-15,16,147,189,42,672
284,23,13,2025-02-14,5,121,179,58,290
237,14,2,2025-02-13,13,433,545,112,1456
795,20,17,2025-02-14,10,319,346,27,270
382,19,10,2025-02-19,16,486,697,211,3376
683,29,6,2025-02-05,2,151,171,20,40
538,13,6,2025-02-06,14,308,409,101,1414
12,13,14,2025-02-13,3,252,372,120,360
583,19,14,2025-02-06,7,476,574,98,686
625,19,30,2025-02-20,5,321,469,148,740
618,26,24,2025-02-18,8,130,155,25,200
567,24,16,2025-02-28,13,304,390,86,1118
728,16,15,2025-02-20,6,210,307,97,582
445,1,10,2025-02-04,8,150,193,43,344
51,17,28,2025-02-26,9,478,633,155,1395
253,4,11,2025-02-07,20,290,402,112,2240
1000,25,20,2025-02-03,5,84,103,19,95
31,1,29,2025-02-03,10,172,184,12,120
675,23,15,2025-02-13,5,450,597,147,735
765,3,26,2025-02-10,8,456,486,30,240
292,24,30,2025-02-19,3,131,155,24,72
18,7,17,2025-02-26,19,273,326,53,1007
923,21,27,2025-02-18,16,87,93,6,96
628,18,14,2025-02-21,11,446,603,157,1727
305,6,24,2025-02-26,5,171,249,78,390
338,20,23,2025-02-21,5,48,62,14,70
240,11,27,2025-02-08,1,311,457,146,146
437,14,20,2025-02-26,4,338,498,160,640
573,29,20,2025-02-13,5,488,718,230,1150
963,27,25,2025-02-18,2,352,526,174,348
379,13,18,2025-02-05,1,63,80,17,17
374,8,21,2025-02-01,15,335,413,78,1170
103,30,17,2025-02-14,19,190,283,93,1767
157,25,25,2025-02-21,10,454,650,196,1960
318,8,26,2025-02-10,16,151,167,16,256
168,11,8,2025-02-03,7,266,358,92,644
324,28,13,2025-02-04,1,46,59,13,13
508,7,21,2025-02-06,3,274,410,136,408
359,2,8,2025-02-14,3,407,533,126,378
680,6,2,2025-02-05,11,446,593,147,1617
856,19,20,2025-02-24,3,322,367,45,135
496,7,7,2025-02-15,2,117,139,22,44
189,26,10,2025-02-28,10,160,229,69,690
294,18,20,2025-02-01,9,272,338,66,594
455,24,18,2025-02-14,5,416,479,63,315
68,30,29,2025-02-01,16,231,276,45,720
797,25,20,2025-02-03,16,342,364,22,352
941,23,18,2025-02-28,12,65,82,17,204
245,22,6,2025-02-28,18,323,390,67,1206
275,12,13,2025-02-07,9,38,50,12,108
76,18,26,2025-02-12,17,20,24,4,68
558,24,3,2025-02-24,4,184,267,83,332
463,9,9,2025-02-23,20,220,297,77,1540
255,20,22,2025-02-04,13,44,59,15,195
841,16,1,2025-02-02,10,25,33,8,80
914,27,26,2025-02-01,10,183,266,83,830
121,18,9,2025-02-01,8,329,482,153,1224
729,18,5,2025-02-06,3,431,557,126,378
698,7,19,2025-02-13,13,413,463,50,650
963,24,24,2025-02-02,8,283,344,61,488
841,18,18,2025-02-13,9,341,507,166,1494
762,1,22,2025-02-15,18,296,312,16,288
402,11,6,2025-02-20,11,66,98,32,352
392,10,23,2025-02-14,20,125,180,55,1100
740,8,11,2025-02-24,14,87,99,12,168
955,7,20,2025-02-15,10,154,221,67,670
516,30,17,2025-02-02,14,269,288,19,266
738,20,18,2025-02-16,2,325,366,41,82
696,23,4,2025-02-20,20,67,87,20,400
741,27,23,2025-02-21,10,463,532,69,690
95,7,22,2025-02-28,5,435,533,98,490
103,4,11,2025-02-18,9,303,364,61,549
49,11,6,2025-02-26,13,143,162,19,247
123,4,20,2025-02-21,13,36,43,7,91
466,26,22,2025-02-22,6,95,101,6,36
232,20,29,2025-02-16,1,263,333,70,70
280,12,23,2025-02-09,10,265,365,100,1000
982,26,2,2025-02-28,18,367,533,166,2988
792,5,30,2025-02-21,7,60,75,15,105
66,10,13,2025-02-24,3,441,586,145,435
348,24,8,2025-02-19,9,235,339,104,936
498,26,13,2025-02-14,5,466,575,109,545
255,11,23,2025-02-25,19,212,311,99,1881
373,8,1,2025-02-05,13,57,79,22,286
309,1,5,2025-02-12,16,436,567,131,2096
460,1,7,2025-02-13,17,225,241,16,272
951,27,2,2025-02-13,8,41,50,9,72
245,14,27,2025-02-01,12,42,47,5,60
544,29,21,2025-02-03,14,156,223,67,938
639,18,19,2025-02-04,1,460,528,68,68
45,19,4,2025-02-06,2,432,598,166,332
655,1,5,2025-02-12,5,31,41,10,50
348,6,23,2025-02-07,15,407,495,88,1320
479,23,20,2025-02-12,8,459,505,46,368
665,27,6,2025-02-13,2,45,60,15,30
547,14,2,2025-02-05,15,198,290,92,1380
971,16,30,2025-02-10,11,151,214,63,693
646,19,5,2025-02-02,11,166,230,64,704
986,20,10,2025-02-23,10,493,591,98,980
527,3,4,2025-02-18,1,342,445,103,103
736,18,20,2025-02-13,12,342,413,71,852
217,10,29,2025-02-27,10,410,491,81,810
416,6,28,2025-02-06,20,426,579,153,3060
153,4,16,2025-02-20,16,46,55,9,144
418,13,1,2025-02-08,14,72,102,30,420
861,5,10,2025-02-18,14,35,44,9,126
304,15,28,2025-02-21,5,407,505,98,490
944,13,1,2025-02-05,7,200,282,82,574
65,12,17,2025-02-12,1,56,68,12,12
204,22,1,2025-02-03,15,137,186,49,735
651,3,14,2025-02-16,4,181,225,44,176
356,17,15,2025-02-19,2,211,234,23,46
262,10,3,2025-02-07,8,322,385,63,504
453,19,9,2025-02-02,13,155,214,59,767
375,7,4,2025-02-22,11,375,552,177,1947
940,15,19,2025-02-02,11,390,490,100,1100
587,30,24,2025-02-03,17,346,453,107,1819
408,14,24,2025-02-10,13,317,363,46,598
339,13,29,2025-02-04,18,140,159,19,342
331,23,20,2025-02-16,9,341,461,120,1080
472,13,18,2025-02-01,12,371,468,97,1164
791,6,8,2025-02-24,16,453,572,119,1904
749,3,18,2025-02-09,8,458,482,24,192
658,4,19,2025-02-06,6,33,44,11,66
443,16,8,2025-02-07,7,455,645,190,1330
707,23,20,2025-02-23,16,128,180,52,832
137,7,19,2025-02-28,13,168,196,28,364
191,28,18,2025-02-05,11,142,198,56,616
836,13,30,2025-02-26,15,212,281,69,1035
608,21,6,2025-02-09,6,244,308,64,384
243,20,30,2025-02-23,6,134,184,50,300
889,11,21,2025-02-05,2,89,103,14,28
187,1,19,2025-02-04,9,372,557,185,1665
67,14,20,2025-02-07,8,409,576,167,1336
529,9,10,2025-02-05,7,172,219,47,329
73,20,19,2025-02-17,5,475,629,154,770
819,22,16,2025-02-11,11,461,501,40,440
863,9,23,2025-02-11,5,479,587,108,540
937,30,15,2025-02-11,14,311,423,112,1568
638,3,7,2025-02-18,8,83,88,5,40
734,27,13,2025-02-26,10,145,166,21,210
159,6,25,2025-02-25,14,340,468,128,1792
155,30,5,2025-02-16,15,259,326,67,1005
209,3,14,2025-02-24,17,378,560,182,3094
978,13,13,2025-02-10,16,34,50,16,256
454,1,7,2025-02-18,12,46,53,7,84
817,2,11,2025-02-20,11,106,141,35,385
816,10,5,2025-02-21,10,63,87,24,240
39,21,16,2025-02-26,10,392,421,29,290
920,16,9,2025-02-01,14,262,367,105,1470
376,17,6,2025-02-14,15,235,261,26,390
583,30,1,2025-02-27,14,445,499,54,756
863,2,8,2025-02-23,13,117,165,48,624
679,12,21,2025-02-28,13,472,698,226,2938
269,14,24,2025-02-03,10,313,392,79,790
323,20,16,2025-02-21,19,126,138,12,228
948,7,19,2025-02-23,19,367,465,98,1862
589,27,18,2025-02-23,9,451,676,225,2025
809,3,9,2025-02-20,17,238,254,16,272
758,20,29,2025-02-11,11,27,39,12,132
612,23,26,2025-02-22,7,93,132,39,273
794,28,14,2025-02-10,7,85,94,9,63
228,19,9,2025-02-13,4,86,94,8,32
736,18,19,2025-02-23,18,432,580,148,2664
677,28,30,2025-02-04,11,335,395,60,660
956,11,8,2025-02-09,1,22,30,8,8
187,22,15,2025-02-14,6,90,131,41,246
837,19,17,2025-02-23,10,500,637,137,1370
177,27,29,2025-02-21,6,194,238,44,264
473,24,17,2025-02-23,16,52,74,22,352
793,17,17,2025-02-05,5,124,155,31,155
659,18,21,2025-02-16,2,188,253,65,130
996,28,10,2025-02-03,13,287,308,21,273
715,3,24,2025-02-07,9,314,420,106,954
411,10,15,2025-02-24,19,326,421,95,1805
891,9,13,2025-02-01,11,283,352,69,759
455,20,9,2025-02-19,13,118,171,53,689
555,8,1,2025-02-28,20,459,672,213,4260
158,7,13,2025-02-26,4,45,64,19,76
61,19,29,2025-02-05,14,62,76,14,196
136,1,4,2025-02-14,11,202,294,92,1012
751,15,22,2025-02-17,14,162,194,32,448
682,30,17,2025-02-13,11,187,260,73,803
368,29,16,2025-02-12,4,108,126,18,72
442,9,1,2025-02-01,2,217,279,62,124
346,17,26,2025-02-26,14,433,558,125,1750
136,10,22,2025-02-02,12,56,69,13,156
362,9,11,2025-02-04,5,109,158,49,245
883,10,9,2025-02-03,17,321,425,104,1768
956,10,1,2025-02-05,7,123,158,35,245
935,18,14,2025-02-01,17,417,482,65,1105
326,27,16,2025-02-28,2,393,424,31,62
21,8,14,2025-02-07,2,471,626,155,310
830,30,9,2025-02-05,7,282,378,96,672
63,6,2,2025-02-26,11,394,422,28,308
627,24,18,2025-02-08,1,331,463,132,132
285,24,3,2025-02-07,9,362,474,112,1008
598,25,14,2025-02-21,3,441,584,143,429
611,16,28,2025-02-28,19,469,595,126,2394
861,9,11,2025-02-05,18,157,173,16,288
372,13,20,2025-02-09,17,26,31,5,85
937,2,15,2025-02-07,12,405,566,161,1932
770,23,16,2025-02-10,17,27,35,8,136
511,21,21,2025-02-08,19,148,200,52,988
910,11,19,2025-02-27,18,43,48,5,90
443,1,6,2025-02-23,20,148,173,25,500
667,28,26,2025-02-28,2,430,497,67,134
93,12,30,2025-02-17,20,410,456,46,920
534,9,20,2025-02-27,1,259,294,35,35
320,5,2,2025-02-08,4,308,427,119,476
681,15,16,2025-02-10,18,243,305,62,1116
625,12,4,2025-02-22,10,54,69,15,150
436,24,9,2025-02-22,17,389,436,47,799
4,17,17,2025-02-25,5,449,594,145,725
806,21,17,2025-02-28,13,376,482,106,1378
961,9,4,2025-02-19,14,101,117,16,224
785,8,6,2025-02-14,1,397,532,135,135
740,18,13,2025-02-23,20,407,479,72,1440
471,14,27,2025-02-16,10,495,635,140,1400
102,28,15,2025-02-07,1,216,266,50,50
864,19,7,2025-02-22,3,210,229,19,57
832,17,30,2025-02-26,3,259,335,76,228
154,10,25,2025-02-05,13,441,535,94,1222
349,19,10,2025-02-14,20,300,395,95,1900
24,30,14,2025-02-05,8,88,111,23,184
148,8,21,2025-02-16,4,250,333,83,332
969,19,1,2025-02-05,6,136,172,36,216
848,19,2,2025-02-02,14,181,257,76,1064
894,26,23,2025-02-18,15,48,65,17,255
566,9,26,2025-02-15,15,317,379,62,930
266,3,21,2025-02-26,15,235,299,64,960
322,7,19,2025-02-17,3,439,635,196,588
558,18,20,2025-02-22,2,451,565,114,228
216,15,17,2025-02-03,12,318,343,25,300
506,20,2,2025-02-18,19,174,212,38,722
624,25,23,2025-02-21,13,105,129,24,312
564,7,17,2025-02-09,18,282,352,70,1260
211,17,1,2025-02-28,5,28,38,10,50
409,3,5,2025-02-08,19,224,304,80,1520
185,4,30,2025-02-21,20,34,45,11,220
342,24,3,2025-02-18,18,71,79,8,144
581,21,26,2025-02-18,17,349,427,78,1326
672,26,25,2025-02-04,17,412,457,45,765
828,1,21,2025-02-27,16,23,34,11,176
398,23,25,2025-02-28,20,38,55,17,340
49,15,19,2025-02-05,8,266,373,107,856
604,18,5,2025-02-13,18,330,479,149,2682
230,9,29,2025-02-23,17,359,527,168,2856
448,22,10,2025-02-20,15,491,526,35,525
731,11,2,2025-02-14,16,187,235,48,768
629,14,28,2025-02-17,8,117,141,24,192
708,15,1,2025-02-26,16,246,284,38,608
104,25,6,2025-02-27,7,71,85,14,98
349,21,2,2025-02-22,11,245,332,87,957
34,12,5,2025-02-21,3,288,364,76,228
618,22,29,2025-02-24,8,284,333,49,392
842,9,9,2025-02-02,10,208,310,102,1020
551,7,4,2025-02-03,10,52,62,10,100
495,2,21,2025-02-23,4,405,453,48,192
233,21,26,2025-02-11,2,121,149,28,56
455,4,11,2025-02-21,13,439,646,207,2691
547,20,3,2025-02-24,2,318,425,107,214
900,28,15,2025-02-20,15,295,317,22,330
904,5,8,2025-02-21,10,431,603,172,1720
274,12,14,2025-02-17,10,154,190,36,360
485,19,26,2025-02-10,1,488,680,192,192
238,27,25,2025-02-14,14,172,244,72,1008
68,14,7,2025-02-05,20,183,232,49,980
777,16,17,2025-02-22,7,464,512,48,336
597,16,12,2025-02-15,6,327,477,150,900
686,5,22,2025-02-15,8,73,93,20,160
985,18,25,2025-02-24,7,383,409,26,182
579,27,3,2025-02-11,18,208,305,97,1746
678,10,21,2025-02-06,8,136,154,18,144
93,13,28,2025-02-24,12,55,71,16,192
642,24,9,2025-02-18,8,318,396,78,624
399,1,15,2025-02-07,10,169,238,69,690
867,16,23,2025-02-09,13,110,151,41,533
354,24,21,2025-02-19,12,298,351,53,636
85,30,21,2025-02-16,9,399,586,187,1683
952,20,4,2025-02-14,3,246,259,13,39
14,6,29,2025-02-06,3,282,380,98,294
415,19,18,2025-02-03,10,476,714,238,2380
234,26,25,2025-02-10,9,361,457,96,864
716,29,2,2025-02-23,19,150,213,63,1197
209,23,16,2025-02-26,15,167,177,10,150
132,19,26,2025-02-24,5,294,362,68,340
681,21,8,2025-02-07,1,435,486,51,51
985,28,21,2025-02-12,1,314,432,118,118
600,13,23,2025-02-27,6,79,103,24,144
194,14,13,2025-02-15,15,83,110,27,405
387,14,14,2025-02-14,3,20,22,2,6
321,24,13,2025-02-08,9,109,154,45,405
944,2,5,2025-02-26,5,88,119,31,155
226,9,20,2025-02-19,18,40,43,3,54
214,24,15,2025-02-14,18,133,193,60,1080
500,12,20,2025-02-24,1,68,86,18,18
464,20,3,2025-02-11,5,345,410,65,325
834,13,4,2025-02-09,10,33,44,11,110
217,8,25,2025-02-28,12,52,65,13,156
872,13,30,2025-02-12,14,471,560,89,1246
890,26,13,2025-02-27,2,76,99,23,46
253,16,25,2025-02-05,13,131,141,10,130
599,26,25,2025-02-12,13,477,632,155,2015
343,12,19,2025-02-25,6,347,393,46,276
702,15,13,2025-02-28,9,435,475,40,360
623,2,1,2025-02-07,18,185,194,9,162
184,24,26,2025-02-11,11,52,72,20,220
214,27,30,2025-02-26,9,419,494,75,675
700,9,29,2025-02-18,13,266,296,30,390
547,30,18,2025-02-08,19,20,24,4,76
774,8,8,2025-02-03,9,493,598,105,945
388,24,24,2025-02-23,3,211,287,76,228
300,19,27,2025-02-07,5,203,222,19,95
267,23,26,2025-02-19,15,289,371,82,1230
604,27,11,2025-02-07,3,88,127,39,117
9,10,1,2025-02-19,11,166,193,27,297
508,21,14,2025-02-14,4,283,322,39,156
716,17,26,2025-02-12,17,46,50,4,68
741,23,18,2025-02-16,8,63,75,12,96
597,3,11,2025-02-03,3,148,171,23,69
493,18,14,2025-02-06,4,429,453,24,96
818,18,3,2025-02-18,15,69,74,5,75
688,13,21,2025-02-17,11,236,280,44,484
339,25,15,2025-02-27,2,228,305,77,154
668,27,1,2025-02-05,14,440,576,136,1904
203,8,30,2025-02-26,3,210,310,100,300
184,23,24,2025-02-07,1,226,241,15,15
190,7,2,2025-02-06,17,241,348,107,1819
663,23,11,2025-02-23,1,365,437,72,72
851,5,6,2025-02-10,4,69,81,12,48
158,1,13,2025-02-14,16,38,42,4,64
78,9,11,2025-02-24,19,309,344,35,665
98,28,13,2025-02-14,8,125,179,54,432
532,5,5,2025-02-05,5,162,173,11,55
328,8,28,2025-02-19,5,114,154,40,200
49,12,13,2025-02-05,1,68,101,33,33
757,20,25,2025-02-02,3,78,109,31,93
263,18,10,2025-02-07,8,314,344,30,240
234,21,6,2025-02-12,6,284,347,63,378
997,4,26,2025-02-07,6,144,199,55,330
261,11,27,2025-02-28,14,367,432,65,910
130,7,10,2025-02-06,17,224,265,41,697
824,10,20,2025-02-15,14,426,448,22,308
271,19,17,2025-02-14,14,118,138,20,280
764,2,24,2025-02-26,19,202,235,33,627
769,15,21,2025-02-22,16,340,495,155,2480
841,8,9,2025-02-22,19,301,402,101,1919
370,6,20,2025-02-16,8,202,249,47,376
793,3,11,2025-02-23,6,216,322,106,636
414,12,27,2025-02-11,19,453,489,36,684
500,25,29,2025-02-13,6,209,294,85,510
894,21,17,2025-02-02,20,489,605,116,2320
308,4,9,2025-02-16,12,132,153,21,252
