ID_zbozi,ID_lekarna,ID_vedouci,datum,pocet_prodanych_ks,nakupni_cena_CZK,prodejni_cena_CZK,marze_CZK,trzba_CZK
655,4,1,24.01.2025,9,145,167,22,198
755,4,22,24.01.2025,18,64,84,20,360
33,1,3,07.01.2025,8,278,367,89,712
575,7,23,21.01.2025,18,234,269,35,630
604,9,26,28.01.2025,1,408,576,168,168
715,14,11,09.01.2025,5,130,192,62,310
345,4,3,13.01.2025,4,203,291,88,352
619,9,26,02.01.2025,15,294,325,31,465
945,13,3,18.01.2025,10,444,592,148,1480
907,28,12,19.01.2025,7,380,411,31,217
678,8,25,10.01.2025,3,457,528,71,213
104,13,9,15.01.2025,12,103,125,22,264
215,22,9,23.01.2025,3,331,442,111,333
547,24,8,06.01.2025,15,214,251,37,555
948,21,23,18.01.2025,8,370,442,72,576
787,25,2,08.01.2025,2,432,515,83,166
275,3,7,30.01.2025,19,468,643,175,3325
218,21,16,13.01.2025,15,93,109,16,240
253,24,18,18.01.2025,9,402,528,126,1134
920,19,13,12.01.2025,8,90,115,25,200
94,25,2,28.01.2025,4,98,131,33,132
812,22,14,20.01.2025,3,217,265,48,144
480,17,9,18.01.2025,1,368,506,138,138
699,29,18,25.01.2025,9,413,553,140,1260
115,10,14,06.01.2025,15,21,31,10,150
897,24,9,17.01.2025,6,279,408,129,774
892,21,10,27.01.2025,17,331,377,46,782
383,25,6,18.01.2025,17,490,515,25,425
332,16,1,04.01.2025,12,469,700,231,2772
827,10,8,02.01.2025,8,469,612,143,1144
81,3,24,16.01.2025,3,409,527,118,354
129,5,22,16.01.2025,18,104,122,18,324
894,20,14,31.01.2025,7,495,640,145,1015
748,23,7,23.01.2025,10,224,336,112,1120
666,12,15,29.01.2025,17,251,277,26,442
231,3,11,01.01.2025,19,303,350,47,893
226,1,3,23.01.2025,2,137,148,11,22
33,28,11,03.01.2025,17,141,166,25,425
498,7,18,05.01.2025,19,315,398,83,1577
804,16,26,14.01.2025,7,68,74,6,42
442,12,14,14.01.2025,15,462,637,175,2625
690,21,21,04.01.2025,2,226,311,85,170
820,28,4,08.01.2025,7,117,151,34,238
144,14,6,09.01.2025,15,147,212,65,975
78,15,26,28.01.2025,18,70,75,5,90
554,27,1,03.01.2025,8,105,129,24,192
493,7,28,13.01.2025,2,104,127,23,46
400,9,30,26.01.2025,15,166,206,40,600
981,24,26,18.01.2025,16,99,112,13,208
223,2,19,24.01.2025,18,51,71,20,360
59,2,19,16.01.2025,17,490,703,213,3621
162,2,17,03.01.2025,6,55,72,17,102
692,28,8,13.01.2025,4,475,621,146,584
593,20,2,20.01.2025,3,234,315,81,243
579,17,11,30.01.2025,9,124,168,44,396
322,8,9,13.01.2025,5,363,487,124,620
469,11,30,25.01.2025,3,24,30,6,18
577,4,3,18.01.2025,7,279,326,47,329
956,12,29,03.01.2025,8,209,246,37,296
449,27,18,23.01.2025,10,333,497,164,1640
827,21,17,01.01.2025,18,173,254,81,1458
107,29,5,09.01.2025,4,475,522,47,188
567,5,9,10.01.2025,20,127,174,47,940
209,22,21,28.01.2025,9,278,353,75,675
928,30,28,02.01.2025,3,344,427,83,249
284,2,1,11.01.2025,5,346,516,170,850
166,24,15,18.01.2025,14,307,324,17,238
78,29,23,29.01.2025,5,299,319,20,100
379,19,18,05.01.2025,14,85,91,6,84
374,29,30,26.01.2025,2,480,581,101,202
699,8,22,04.01.2025,12,419,546,127,1524
896,14,20,24.01.2025,5,493,724,231,1155
886,6,26,26.01.2025,6,471,582,111,666
184,24,30,11.01.2025,14,430,581,151,2114
753,26,8,09.01.2025,6,423,578,155,930
392,28,2,28.01.2025,16,133,152,19,304
941,15,12,10.01.2025,8,134,142,8,64
198,13,11,09.01.2025,3,415,488,73,219
657,17,13,22.01.2025,18,189,278,89,1602
119,29,9,06.01.2025,19,155,165,10,190
611,14,12,24.01.2025,11,243,321,78,858
524,4,13,29.01.2025,19,117,136,19,361
726,14,1,17.01.2025,18,371,510,139,2502
760,24,22,07.01.2025,12,240,260,20,240
681,30,11,20.01.2025,11,359,514,155,1705
738,29,10,17.01.2025,10,361,445,84,840
413,23,10,18.01.2025,5,118,146,28,140
963,13,22,24.01.2025,6,335,438,103,618
416,18,27,01.01.2025,10,166,190,24,240
805,19,20,21.01.2025,11,258,322,64,704
692,7,17,16.01.2025,6,357,388,31,186
528,22,21,20.01.2025,11,67,95,28,308
770,8,22,10.01.2025,8,432,492,60,480
26,2,8,16.01.2025,20,455,635,180,3600
467,14,29,21.01.2025,19,119,163,44,836
394,16,13,08.01.2025,5,355,483,128,640
915,25,28,25.01.2025,4,418,519,101,404
181,26,23,17.01.2025,15,45,59,14,210
940,28,4,15.01.2025,5,430,541,111,555
544,18,20,11.01.2025,15,333,472,139,2085
914,17,14,27.01.2025,18,248,361,113,2034
762,28,16,15.01.2025,9,404,469,65,585
653,9,25,25.01.2025,17,268,357,89,1513
282,15,3,23.01.2025,10,140,164,24,240
328,29,18,03.01.2025,5,97,112,15,75
711,5,23,07.01.2025,3,232,286,54,162
556,15,14,02.01.2025,7,446,553,107,749
927,25,19,31.01.2025,1,458,662,204,204
590,13,16,01.01.2025,12,172,239,67,804
874,29,27,14.01.2025,18,402,555,153,2754
820,20,29,08.01.2025,16,132,155,23,368
498,1,13,11.01.2025,13,390,438,48,624
479,30,5,20.01.2025,18,33,48,15,270
607,19,22,01.01.2025,3,349,434,85,255
888,15,6,02.01.2025,9,214,256,42,378
466,11,11,25.01.2025,13,162,225,63,819
852,14,9,27.01.2025,3,260,275,15,45
553,2,12,08.01.2025,3,419,620,201,603
42,25,1,31.01.2025,8,122,174,52,416
637,5,8,05.01.2025,16,362,399,37,592
971,7,15,23.01.2025,9,412,501,89,801
621,20,24,23.01.2025,4,418,593,175,700
988,10,4,19.01.2025,1,495,589,94,94
694,30,13,13.01.2025,7,58,76,18,126
851,21,8,04.01.2025,10,455,618,163,1630
825,4,26,19.01.2025,2,197,254,57,114
678,12,3,17.01.2025,11,26,37,11,121
843,16,4,14.01.2025,12,345,501,156,1872
471,23,5,14.01.2025,6,395,507,112,672
667,9,20,26.01.2025,18,416,527,111,1998
447,27,24,19.01.2025,9,185,265,80,720
851,30,3,09.01.2025,15,144,200,56,840
584,20,22,13.01.2025,11,34,43,9,99
333,6,16,07.01.2025,12,428,499,71,852
287,29,20,23.01.2025,9,304,321,17,153
971,7,3,08.01.2025,14,270,351,81,1134
247,23,16,21.01.2025,16,249,350,101,1616
96,10,8,13.01.2025,8,176,237,61,488
378,16,18,17.01.2025,12,237,355,118,1416
564,11,12,23.01.2025,15,158,188,30,450
237,4,24,07.01.2025,11,81,112,31,341
974,25,23,06.01.2025,7,130,180,50,350
284,24,19,25.01.2025,17,325,383,58,986
103,27,7,10.01.2025,8,204,231,27,216
15,23,18,05.01.2025,9,43,64,21,189
567,10,23,31.01.2025,5,346,499,153,765
503,4,28,01.01.2025,19,165,208,43,817
452,11,6,31.01.2025,2,149,220,71,142
490,4,27,03.01.2025,13,271,294,23,299
645,22,2,05.01.2025,5,435,567,132,660
312,3,8,04.01.2025,18,411,509,98,1764
611,26,20,08.01.2025,17,214,268,54,918
454,10,28,19.01.2025,14,176,230,54,756
62,20,24,04.01.2025,7,340,389,49,343
677,3,6,08.01.2025,6,302,327,25,150
3,14,15,23.01.2025,20,260,307,47,940
238,10,23,10.01.2025,15,56,76,20,300
947,9,26,26.01.2025,19,358,505,147,2793
203,14,4,18.01.2025,8,351,392,41,328
273,27,5,03.01.2025,2,104,146,42,84
610,24,27,19.01.2025,10,244,270,26,260
706,10,23,13.01.2025,9,276,357,81,729
449,3,20,02.01.2025,14,396,473,77,1078
257,1,3,08.01.2025,19,320,473,153,2907
784,22,27,09.01.2025,19,40,56,16,304
180,16,17,21.01.2025,15,489,575,86,1290
600,14,21,27.01.2025,16,66,83,17,272
419,11,11,22.01.2025,4,459,515,56,224
422,23,16,10.01.2025,13,436,607,171,2223
38,15,3,11.01.2025,9,185,204,19,171
792,13,28,17.01.2025,1,356,513,157,157
474,14,2,07.01.2025,17,205,273,68,1156
511,21,15,25.01.2025,2,124,145,21,42
135,30,10,15.01.2025,16,82,87,5,80
646,20,26,08.01.2025,6,179,232,53,318
566,14,3,08.01.2025,4,256,378,122,488
664,27,5,16.01.2025,10,280,383,103,1030
426,27,16,16.01.2025,8,253,328,75,600
393,7,30,20.01.2025,17,402,581,179,3043
885,3,9,25.01.2025,14,194,285,91,1274
520,9,27,01.01.2025,10,391,463,72,720
602,19,22,16.01.2025,5,248,321,73,365
354,11,18,25.01.2025,18,213,267,54,972
330,28,7,23.01.2025,8,312,381,69,552
877,25,14,02.01.2025,11,401,506,105,1155
936,26,13,13.01.2025,5,273,405,132,660
130,17,19,11.01.2025,4,467,668,201,804
103,17,30,15.01.2025,1,389,434,45,45
892,21,5,03.01.2025,16,420,624,204,3264
347,20,23,13.01.2025,3,456,546,90,270
691,28,18,13.01.2025,11,340,467,127,1397
778,16,28,18.01.2025,2,336,363,27,54
647,22,30,10.01.2025,8,402,438,36,288
101,25,21,23.01.2025,4,247,278,31,124
307,29,1,02.01.2025,11,427,459,32,352
368,12,14,05.01.2025,8,291,360,69,552
699,26,6,06.01.2025,6,60,79,19,114
392,20,22,08.01.2025,16,487,639,152,2432
238,15,21,09.01.2025,15,150,203,53,795
921,26,15,29.01.2025,10,366,474,108,1080
76,15,12,19.01.2025,10,347,515,168,1680
707,9,15,28.01.2025,10,121,181,60,600
874,16,4,08.01.2025,13,312,378,66,858
303,23,10,01.01.2025,13,160,169,9,117
886,22,25,24.01.2025,2,486,643,157,314
509,27,29,29.01.2025,10,417,588,171,1710
622,26,12,08.01.2025,7,337,392,55,385
774,24,25,22.01.2025,5,341,373,32,160
643,21,2,10.01.2025,15,37,48,11,165
750,5,3,30.01.2025,10,187,259,72,720
180,7,5,26.01.2025,18,468,696,228,4104
544,17,30,09.01.2025,6,151,221,70,420
967,16,26,10.01.2025,11,431,475,44,484
987,3,5,25.01.2025,8,460,623,163,1304
691,13,28,26.01.2025,18,207,226,19,342
405,1,9,18.01.2025,4,252,306,54,216
767,22,9,19.01.2025,13,441,590,149,1937
381,4,22,08.01.2025,16,32,43,11,176
966,18,11,30.01.2025,20,133,178,45,900
651,27,15,30.01.2025,10,352,434,82,820
144,2,2,10.01.2025,16,79,86,7,112
909,18,5,13.01.2025,15,209,283,74,1110
761,23,18,14.01.2025,19,400,551,151,2869
907,14,21,04.01.2025,16,335,413,78,1248
975,9,2,23.01.2025,12,131,164,33,396
974,8,28,12.01.2025,4,371,451,80,320
924,21,12,02.01.2025,13,161,183,22,286
126,28,27,15.01.2025,3,359,411,52,156
655,20,1,02.01.2025,11,144,215,71,781
806,19,7,03.01.2025,18,126,166,40,720
833,28,8,11.01.2025,5,423,616,193,965
3,9,28,05.01.2025,5,296,344,48,240
179,4,22,28.01.2025,1,87,92,5,5
809,26,8,19.01.2025,11,28,32,4,44
54,5,24,14.01.2025,17,78,108,30,510
488,15,25,12.01.2025,17,323,355,32,544
516,8,20,02.01.2025,17,174,219,45,765
988,1,2,16.01.2025,13,238,323,85,1105
503,23,30,15.01.2025,3,480,521,41,123
623,5,3,05.01.2025,9,339,453,114,1026
562,23,11,13.01.2025,20,291,344,53,1060
518,20,14,04.01.2025,4,456,613,157,628
899,25,18,24.01.2025,7,240,301,61,427
234,14,11,27.01.2025,15,224,277,53,795
98,11,14,11.01.2025,9,211,312,101,909
704,30,16,03.01.2025,3,445,484,39,117
443,4,24,24.01.2025,12,435,482,47,564
62,19,18,18.01.2025,11,363,401,38,418
363,28,22,31.01.2025,14,464,678,214,2996
53,10,20,10.01.2025,12,73,96,23,276
218,5,22,16.01.2025,8,453,498,45,360
866,18,12,04.01.2025,9,313,361,48,432
440,28,18,25.01.2025,20,334,452,118,2360
571,1,20,30.01.2025,9,34,38,4,36
720,25,10,30.01.2025,11,199,209,10,110
891,5,19,22.01.2025,13,55,61,6,78
649,1,3,24.01.2025,17,130,159,29,493
465,11,6,12.01.2025,10,389,465,76,760
965,19,20,03.01.2025,2,99,111,12,24
633,2,22,03.01.2025,9,246,332,86,774
498,20,15,14.01.2025,9,130,181,51,459
117,12,14,04.01.2025,10,367,497,130,1300
499,17,22,10.01.2025,2,132,162,30,60
614,2,1,07.01.2025,10,128,179,51,510
783,9,10,11.01.2025,4,23,29,6,24
441,6,5,13.01.2025,18,380,438,58,1044
573,27,22,26.01.2025,12,56,69,13,156
760,2,14,01.01.2025,15,491,533,42,630
321,19,14,19.01.2025,13,383,512,129,1677
297,4,13,01.01.2025,11,107,151,44,484
633,15,27,23.01.2025,12,65,81,16,192
109,8,14,19.01.2025,13,288,313,25,325
892,10,24,11.01.2025,8,190,266,76,608
79,17,21,04.01.2025,17,281,320,39,663
795,12,12,24.01.2025,5,140,153,13,65
263,7,6,20.01.2025,5,409,569,160,800
78,6,25,21.01.2025,16,257,357,100,1600
779,19,15,22.01.2025,19,349,466,117,2223
640,11,28,21.01.2025,11,97,121,24,264
481,15,21,10.01.2025,9,322,346,24,216
520,3,10,15.01.2025,15,39,42,3,45
852,10,3,21.01.2025,3,334,440,106,318
394,15,19,18.01.2025,2,250,365,115,230
586,21,7,11.01.2025,20,263,335,72,1440
981,2,15,04.01.2025,11,385,419,34,374
662,6,2,08.01.2025,15,244,314,70,1050
625,6,12,12.01.2025,10,218,269,51,510
347,22,20,02.01.2025,11,53,64,11,121
572,22,13,10.01.2025,9,390,559,169,1521
988,30,20,28.01.2025,5,190,206,16,80
680,5,30,12.01.2025,10,355,484,129,1290
402,5,20,23.01.2025,3,178,232,54,162
659,26,11,27.01.2025,5,363,496,133,665
970,24,22,30.01.2025,17,67,90,23,391
434,17,12,01.01.2025,12,178,201,23,276
220,11,25,16.01.2025,7,135,202,67,469
159,3,10,28.01.2025,4,279,390,111,444
856,24,29,17.01.2025,2,358,430,72,144
785,20,5,20.01.2025,13,98,110,12,156
852,23,25,20.01.2025,6,389,485,96,576
421,12,22,24.01.2025,8,247,327,80,640
771,24,26,15.01.2025,8,293,339,46,368
989,26,26,16.01.2025,7,208,282,74,518
585,15,15,25.01.2025,10,418,511,93,930
541,14,6,27.01.2025,7,430,569,139,973
894,9,2,21.01.2025,16,467,568,101,1616
957,4,23,28.01.2025,17,455,503,48,816
86,25,6,09.01.2025,15,483,619,136,2040
851,14,3,31.01.2025,8,438,549,111,888
358,30,1,14.01.2025,2,222,283,61,122
242,13,3,12.01.2025,8,34,41,7,56
102,27,23,21.01.2025,11,425,474,49,539
40,10,30,27.01.2025,16,376,535,159,2544
778,23,16,15.01.2025,20,22,32,10,200
20,9,7,27.01.2025,5,300,442,142,710
624,17,14,04.01.2025,10,141,167,26,260
49,8,14,21.01.2025,20,254,274,20,400
857,29,16,20.01.2025,18,28,37,9,162
589,8,23,05.01.2025,10,239,251,12,120
362,8,19,14.01.2025,6,360,486,126,756
537,12,3,31.01.2025,17,298,381,83,1411
520,18,1,13.01.2025,16,42,56,14,224
383,9,24,01.01.2025,12,423,457,34,408
247,24,22,21.01.2025,4,415,544,129,516
775,11,5,02.01.2025,12,299,360,61,732
659,6,27,25.01.2025,15,376,476,100,1500
187,26,5,03.01.2025,15,38,45,7,105
45,26,7,29.01.2025,2,181,266,85,170
528,13,27,18.01.2025,16,149,159,10,160
663,7,10,12.01.2025,2,463,623,160,320
280,4,26,12.01.2025,14,475,584,109,1526
451,29,13,11.01.2025,6,274,373,99,594
377,30,26,17.01.2025,9,430,467,37,333
435,3,14,20.01.2025,6,299,353,54,324
106,3,11,22.01.2025,10,176,220,44,440
735,14,6,23.01.2025,15,199,249,50,750
745,28,30,12.01.2025,20,242,284,42,840
811,2,3,22.01.2025,13,206,264,58,754
768,22,6,31.01.2025,1,93,133,40,40
695,26,15,02.01.2025,5,54,62,8,40
661,12,12,13.01.2025,19,36,48,12,228
696,15,12,12.01.2025,15,410,445,35,525
141,17,12,13.01.2025,11,352,414,62,682
984,4,1,24.01.2025,6,275,353,78,468
936,18,4,09.01.2025,9,380,475,95,855
627,10,23,30.01.2025,16,122,135,13,208
874,3,15,06.01.2025,15,64,91,27,405
991,28,11,22.01.2025,12,383,413,30,360
556,10,29,10.01.2025,6,384,526,142,852
718,21,6,26.01.2025,12,280,322,42,504
206,26,5,08.01.2025,16,33,40,7,112
587,12,15,26.01.2025,18,86,114,28,504
89,3,10,13.01.2025,16,289,357,68,1088
420,27,19,03.01.2025,5,182,244,62,310
461,15,22,17.01.2025,12,85,123,38,456
799,18,21,19.01.2025,6,413,613,200,1200
444,17,30,28.01.2025,2,445,492,47,94
157,10,6,06.01.2025,11,498,682,184,2024
355,17,29,10.01.2025,3,148,168,20,60
980,18,9,05.01.2025,10,334,431,97,970
515,21,6,19.01.2025,19,98,110,12,228
640,24,29,20.01.2025,11,451,661,210,2310
43,27,28,01.01.2025,3,43,64,21,63
790,19,9,21.01.2025,7,412,539,127,889
633,21,1,16.01.2025,18,168,225,57,1026
310,16,8,26.01.2025,13,172,216,44,572
706,2,6,15.01.2025,14,267,336,69,966
349,20,5,11.01.2025,11,395,590,195,2145
354,13,5,25.01.2025,12,283,369,86,1032
327,8,15,04.01.2025,9,250,290,40,360
100,2,10,31.01.2025,13,462,613,151,1963
255,28,29,06.01.2025,11,498,652,154,1694
321,7,25,06.01.2025,16,283,357,74,1184
901,10,16,01.01.2025,3,221,282,61,183
990,8,7,19.01.2025,12,44,47,3,36
507,20,29,27.01.2025,16,166,214,48,768
868,4,14,05.01.2025,9,392,476,84,756
413,12,2,13.01.2025,2,311,405,94,188
372,18,10,03.01.2025,13,278,348,70,910
564,9,27,20.01.2025,20,80,89,9,180
100,13,12,26.01.2025,11,305,449,144,1584
774,5,7,20.01.2025,17,225,287,62,1054
47,2,5,23.01.2025,11,431,544,113,1243
468,5,20,29.01.2025,17,91,109,18,306
628,11,6,13.01.2025,20,398,569,171,3420
608,11,17,27.01.2025,17,292,371,79,1343
577,10,16,27.01.2025,1,208,249,41,41
113,14,19,10.01.2025,1,325,411,86,86
991,21,26,25.01.2025,19,315,363,48,912
53,19,16,06.01.2025,17,342,470,128,2176
794,27,13,05.01.2025,8,36,47,11,88
718,4,7,01.01.2025,15,180,223,43,645
423,23,7,14.01.2025,17,416,551,135,2295
483,28,28,24.01.2025,2,381,424,43,86
213,18,11,22.01.2025,16,289,352,63,1008
980,6,15,30.01.2025,18,195,253,58,1044
693,25,28,24.01.2025,9,332,421,89,801
981,8,9,18.01.2025,10,135,199,64,640
305,25,10,23.01.2025,7,373,510,137,959
325,16,12,18.01.2025,9,167,185,18,162
693,18,13,29.01.2025,13,439,529,90,1170
792,26,5,10.01.2025,2,167,247,80,160
81,12,30,15.01.2025,9,402,509,107,963
207,27,18,09.01.2025,18,376,441,65,1170
112,20,24,19.01.2025,8,144,154,10,80
927,17,8,21.01.2025,8,46,50,4,32
339,23,16,04.01.2025,5,22,33,11,55
952,6,14,21.01.2025,16,264,354,90,1440
775,10,11,10.01.2025,2,484,676,192,384
668,19,8,18.01.2025,2,487,713,226,452
428,29,27,06.01.2025,2,448,550,102,204
508,6,30,24.01.2025,10,468,499,31,310
306,19,20,04.01.2025,11,165,207,42,462
657,18,17,16.01.2025,5,455,581,126,630
280,7,26,04.01.2025,11,103,142,39,429
664,9,23,06.01.2025,1,397,477,80,80
303,19,22,25.01.2025,7,109,144,35,245
655,29,13,27.01.2025,14,283,339,56,784
411,22,4,06.01.2025,5,264,316,52,260
255,1,9,13.01.2025,8,248,345,97,776
977,11,10,19.01.2025,19,25,29,4,76
369,23,8,02.01.2025,4,258,307,49,196
416,22,17,30.01.2025,10,373,411,38,380
939,10,12,20.01.2025,8,132,195,63,504
490,5,15,24.01.2025,20,211,261,50,1000
563,30,16,25.01.2025,18,430,580,150,2700
224,25,8,22.01.2025,20,467,656,189,3780
539,15,17,23.01.2025,12,59,86,27,324
115,2,27,18.01.2025,17,123,161,38,646
154,6,11,28.01.2025,17,246,271,25,425
211,23,19,16.01.2025,3,480,614,134,402
829,2,15,05.01.2025,17,232,291,59,1003
60,18,15,22.01.2025,10,390,413,23,230
261,27,1,24.01.2025,7,316,342,26,182
434,12,23,03.01.2025,18,50,74,24,432
71,30,16,02.01.2025,10,229,259,30,300
139,25,21,24.01.2025,14,211,316,105,1470
392,15,28,30.01.2025,13,212,230,18,234
988,22,28,18.01.2025,5,354,509,155,775
122,6,18,13.01.2025,17,85,117,32,544
229,27,1,25.01.2025,1,172,216,44,44
737,18,14,18.01.2025,13,441,509,68,884
472,12,5,09.01.2025,7,499,720,221,1547
784,4,2,26.01.2025,14,334,466,132,1848
905,29,1,08.01.2025,7,54,59,5,35
35,15,20,22.01.2025,2,145,201,56,112
412,15,8,18.01.2025,7,406,584,178,1246
58,5,17,10.01.2025,8,437,639,202,1616
590,11,19,20.01.2025,11,141,167,26,286
147,22,17,08.01.2025,14,173,203,30,420
571,19,29,24.01.2025,6,340,461,121,726
570,16,2,12.01.2025,13,422,543,121,1573
714,14,14,05.01.2025,10,212,240,28,280
551,16,8,28.01.2025,8,173,248,75,600
148,26,15,30.01.2025,2,307,379,72,144
427,18,17,05.01.2025,13,144,168,24,312
339,21,3,30.01.2025,15,453,551,98,1470
549,24,27,07.01.2025,2,157,191,34,68
620,20,2,28.01.2025,3,116,164,48,144
602,24,22,18.01.2025,7,265,303,38,266
929,11,10,31.01.2025,1,128,188,60,60
986,24,4,24.01.2025,16,488,566,78,1248
619,23,7,13.01.2025,8,302,361,59,472
290,13,15,18.01.2025,12,177,207,30,360
526,29,16,15.01.2025,4,431,643,212,848
481,25,27,11.01.2025,7,209,249,40,280
47,19,28,08.01.2025,5,28,33,5,25
958,19,19,24.01.2025,14,171,191,20,280
338,8,13,19.01.2025,8,275,357,82,656
967,22,11,09.01.2025,16,390,522,132,2112
503,15,6,24.01.2025,12,106,118,12,144
560,16,6,30.01.2025,18,348,515,167,3006
537,2,27,28.01.2025,3,438,592,154,462
783,1,14,05.01.2025,8,54,74,20,160
10,7,17,15.01.2025,12,50,66,16,192
683,30,20,30.01.2025,16,357,453,96,1536
7,18,18,14.01.2025,1,28,36,8,8
282,18,10,01.01.2025,17,436,595,159,2703
441,26,30,06.01.2025,4,490,536,46,184
153,8,7,20.01.2025,17,149,211,62,1054
274,26,13,03.01.2025,12,227,285,58,696
250,23,8,10.01.2025,3,354,530,176,528
666,25,2,03.01.2025,13,214,261,47,611
488,2,21,01.01.2025,6,62,79,17,102
445,21,26,11.01.2025,19,459,683,224,4256
917,17,30,02.01.2025,8,128,186,58,464
709,29,19,16.01.2025,9,43,63,20,180
701,30,9,29.01.2025,18,308,415,107,1926
184,30,28,11.01.2025,1,126,166,40,40
771,27,23,27.01.2025,13,495,537,42,546
167,19,8,19.01.2025,13,366,532,166,2158
340,13,25,24.01.2025,5,424,634,210,1050
742,3,17,24.01.2025,12,47,51,4,48
238,27,3,11.01.2025,20,413,548,135,2700
610,13,25,11.01.2025,1,344,404,60,60
462,16,8,12.01.2025,18,212,264,52,936
697,19,22,13.01.2025,3,415,551,136,408
818,8,23,03.01.2025,3,157,176,19,57
729,26,21,05.01.2025,13,182,221,39,507
94,1,10,15.01.2025,12,409,479,70,840
136,3,6,14.01.2025,15,305,396,91,1365
418,4,1,03.01.2025,12,303,331,28,336
613,26,11,28.01.2025,13,26,31,5,65
398,25,3,24.01.2025,18,483,723,240,4320
249,19,17,06.01.2025,13,106,118,12,156
309,9,16,05.01.2025,3,105,131,26,78
432,10,16,26.01.2025,3,204,237,33,99
253,24,21,16.01.2025,20,335,381,46,920
110,5,10,01.01.2025,13,190,271,81,1053
390,26,28,11.01.2025,15,191,238,47,705
844,28,21,20.01.2025,5,173,207,34,170
971,23,7,16.01.2025,11,110,163,53,583
992,11,10,24.01.2025,16,314,440,126,2016
334,13,9,27.01.2025,13,206,227,21,273
578,7,19,18.01.2025,6,369,515,146,876
28,24,15,31.01.2025,7,244,344,100,700
852,23,3,27.01.2025,14,364,464,100,1400
649,10,8,09.01.2025,5,386,479,93,465
387,3,15,20.01.2025,16,318,391,73,1168
519,30,30,28.01.2025,14,298,318,20,280
992,12,23,29.01.2025,18,324,433,109,1962
88,4,25,08.01.2025,12,105,141,36,432
46,19,21,22.01.2025,13,405,486,81,1053
816,14,4,01.01.2025,4,152,175,23,92
765,17,18,19.01.2025,19,133,166,33,627
401,15,25,22.01.2025,19,373,476,103,1957
354,1,16,04.01.2025,10,232,340,108,1080
88,4,27,31.01.2025,5,198,236,38,190
467,26,7,17.01.2025,16,198,250,52,832
449,24,23,15.01.2025,11,54,64,10,110
830,23,4,01.01.2025,11,351,386,35,385
820,6,30,24.01.2025,8,284,320,36,288
164,11,18,14.01.2025,15,138,194,56,840
645,6,6,21.01.2025,14,222,236,14,196
629,29,7,15.01.2025,19,239,293,54,1026
722,7,7,09.01.2025,3,315,345,30,90
893,18,6,12.01.2025,11,120,151,31,341
269,22,28,16.01.2025,17,347,413,66,1122
398,20,13,19.01.2025,4,198,239,41,164
469,20,6,27.01.2025,10,490,650,160,1600
87,22,5,11.01.2025,4,142,169,27,108
188,12,23,05.01.2025,17,218,270,52,884
142,19,13,14.01.2025,6,269,359,90,540
711,30,21,30.01.2025,6,304,342,38,228
296,5,6,11.01.2025,15,337,362,25,375
368,1,16,05.01.2025,7,437,534,97,679
576,17,21,16.01.2025,14,370,470,100,1400
728,27,15,16.01.2025,6,62,81,19,114
815,25,8,10.01.2025,2,160,184,24,48
296,6,25,15.01.2025,19,400,559,159,3021
508,18,17,04.01.2025,19,78,91,13,247
557,27,12,18.01.2025,2,409,562,153,306
560,7,14,04.01.2025,8,172,248,76,608
34,15,9,12.01.2025,3,244,351,107,321
121,25,26,08.01.2025,7,435,601,166,1162
706,12,28,23.01.2025,20,343,426,83,1660
631,5,26,07.01.2025,7,432,465,33,231
360,18,9,20.01.2025,18,106,127,21,378
721,10,10,19.01.2025,9,459,588,129,1161
922,22,27,04.01.2025,5,404,567,163,815
941,2,9,28.01.2025,5,379,546,167,835
256,5,23,11.01.2025,8,409,585,176,1408
403,16,5,19.01.2025,9,341,422,81,729
463,3,21,26.01.2025,3,226,290,64,192
285,23,30,29.01.2025,12,252,372,120,1440
336,19,1,28.01.2025,3,394,586,192,576
651,22,23,12.01.2025,3,427,551,124,372
224,14,27,07.01.2025,16,157,188,31,496
291,11,18,19.01.2025,5,309,443,134,670
808,11,29,22.01.2025,2,43,47,4,8
803,27,15,01.01.2025,4,495,711,216,864
452,15,1,31.01.2025,14,123,184,61,854
932,5,29,21.01.2025,10,101,146,45,450
898,9,3,21.01.2025,12,148,161,13,156
681,29,21,06.01.2025,2,222,296,74,148
744,23,25,08.01.2025,14,355,387,32,448
98,1,7,16.01.2025,3,87,115,28,84
532,22,15,01.01.2025,1,376,453,77,77
124,28,14,23.01.2025,5,264,286,22,110
393,3,24,26.01.2025,4,72,86,14,56
903,10,5,13.01.2025,5,348,521,173,865
147,3,17,19.01.2025,1,332,446,114,114
451,12,24,07.01.2025,5,490,605,115,575
704,15,28,07.01.2025,3,479,525,46,138
771,4,19,24.01.2025,13,199,295,96,1248
323,26,5,08.01.2025,9,350,381,31,279
567,20,20,24.01.2025,20,165,231,66,1320
708,1,28,28.01.2025,10,125,160,35,350
522,7,24,13.01.2025,10,350,376,26,260
920,26,8,16.01.2025,13,77,89,12,156
654,20,3,17.01.2025,1,204,300,96,96
136,13,28,27.01.2025,19,235,285,50,950
700,6,25,16.01.2025,3,28,37,9,27
15,9,7,02.01.2025,2,424,521,97,194
294,21,23,17.01.2025,14,236,322,86,1204
85,21,18,18.01.2025,20,98,115,17,340
318,3,17,30.01.2025,7,433,485,52,364
335,13,19,21.01.2025,3,178,243,65,195
748,28,8,02.01.2025,8,64,94,30,240
119,15,20,20.01.2025,2,178,240,62,124
674,24,6,04.01.2025,1,382,425,43,43
12,6,16,31.01.2025,12,287,368,81,972
843,24,9,06.01.2025,12,84,117,33,396
895,9,24,29.01.2025,4,414,602,188,752
344,26,14,09.01.2025,17,52,61,9,153
999,19,21,03.01.2025,16,253,324,71,1136
57,16,28,19.01.2025,6,208,233,25,150
792,4,29,19.01.2025,4,136,188,52,208
3,2,28,28.01.2025,1,145,155,10,10
373,13,30,05.01.2025,6,496,735,239,1434
37,18,26,30.01.2025,14,134,160,26,364
427,30,24,11.01.2025,9,442,480,38,342
382,4,17,22.01.2025,2,111,128,17,34
529,2,13,03.01.2025,15,463,545,82,1230
866,10,11,03.01.2025,18,253,267,14,252
206,10,19,26.01.2025,10,398,529,131,1310
476,12,19,16.01.2025,7,395,575,180,1260
779,26,8,05.01.2025,1,497,614,117,117
239,18,12,21.01.2025,1,191,201,10,10
674,13,28,24.01.2025,10,73,83,10,100
244,14,16,31.01.2025,2,92,126,34,68
96,2,30,08.01.2025,17,231,315,84,1428
382,15,24,03.01.2025,19,68,87,19,361
653,27,13,03.01.2025,19,310,334,24,456
679,5,8,10.01.2025,9,455,542,87,783
821,13,23,27.01.2025,11,182,228,46,506
240,3,7,05.01.2025,19,75,84,9,171
169,15,15,11.01.2025,14,81,105,24,336
988,25,7,15.01.2025,10,257,300,43,430
123,3,6,26.01.2025,10,443,606,163,1630
618,2,7,27.01.2025,11,95,104,9,99
255,12,13,17.01.2025,2,366,434,68,136
840,6,1,31.01.2025,13,457,573,116,1508
767,18,8,04.01.2025,15,72,102,30,450
144,4,1,02.01.2025,8,86,98,12,96
411,12,22,21.01.2025,3,318,418,100,300
940,27,3,01.01.2025,3,121,176,55,165
455,26,5,03.01.2025,11,82,88,6,66
473,2,6,30.01.2025,19,241,342,101,1919
405,16,1,13.01.2025,14,108,131,23,322
931,6,9,09.01.2025,15,472,527,55,825
629,20,20,08.01.2025,10,275,340,65,650
564,16,2,03.01.2025,9,216,240,24,216
205,21,29,26.01.2025,17,147,196,49,833
822,18,26,01.01.2025,13,420,576,156,2028
492,18,26,16.01.2025,12,487,635,148,1776
330,13,9,06.01.2025,1,183,241,58,58
31,29,26,25.01.2025,9,49,69,20,180
484,17,12,25.01.2025,19,139,207,68,1292
103,8,22,08.01.2025,9,293,415,122,1098
940,24,2,25.01.2025,8,314,449,135,1080
817,13,12,30.01.2025,6,110,127,17,102
326,26,24,23.01.2025,12,487,641,154,1848
721,23,12,31.01.2025,19,308,343,35,665
972,7,27,26.01.2025,16,297,353,56,896
503,2,3,02.01.2025,8,328,377,49,392
540,16,1,11.01.2025,20,123,174,51,1020
349,23,6,30.01.2025,11,50,53,3,33
601,23,30,05.01.2025,4,453,583,130,520
374,3,12,23.01.2025,13,320,351,31,403
310,11,5,06.01.2025,14,425,569,144,2016
499,21,11,06.01.2025,18,375,544,169,3042
629,26,12,08.01.2025,19,437,493,56,1064
315,24,23,10.01.2025,5,110,152,42,210
972,23,19,13.01.2025,19,36,41,5,95
326,30,26,31.01.2025,20,133,178,45,900
107,30,16,05.01.2025,11,401,435,34,374
356,11,6,21.01.2025,3,440,602,162,486
655,24,29,11.01.2025,15,25,29,4,60
256,23,3,12.01.2025,9,422,464,42,378
2,2,13,15.01.2025,14,105,152,47,658
505,29,13,12.01.2025,18,212,232,20,360
491,26,28,19.01.2025,8,103,129,26,208
819,28,2,10.01.2025,1,183,214,31,31
108,3,11,06.01.2025,13,102,141,39,507
561,29,3,11.01.2025,20,334,485,151,3020
722,1,14,31.01.2025,6,330,479,149,894
161,2,4,11.01.2025,7,117,144,27,189
568,24,30,24.01.2025,18,155,209,54,972
305,8,4,02.01.2025,13,312,405,93,1209
503,5,2,12.01.2025,1,238,259,21,21
844,22,21,20.01.2025,16,122,133,11,176
212,6,21,10.01.2025,3,262,375,113,339
316,26,13,16.01.2025,16,478,644,166,2656
94,21,18,13.01.2025,6,209,303,94,564
379,6,15,02.01.2025,9,245,309,64,576
232,27,9,19.01.2025,2,97,135,38,76
684,4,3,22.01.2025,12,433,560,127,1524
995,25,19,08.01.2025,18,51,73,22,396
839,17,14,31.01.2025,18,371,534,163,2934
487,19,29,08.01.2025,16,173,188,15,240
925,28,23,02.01.2025,17,312,454,142,2414
820,19,22,20.01.2025,5,81,120,39,195
460,6,6,07.01.2025,7,84,90,6,42
81,22,14,07.01.2025,5,447,589,142,710
328,30,24,30.01.2025,3,64,78,14,42
407,18,11,28.01.2025,9,286,359,73,657
895,1,26,23.01.2025,20,320,411,91,1820
430,4,14,05.01.2025,5,310,408,98,490
777,4,30,04.01.2025,19,419,459,40,760
293,28,18,29.01.2025,12,469,579,110,1320
393,21,16,19.01.2025,20,262,280,18,360
283,13,5,20.01.2025,20,368,501,133,2660
40,13,29,29.01.2025,11,373,432,59,649
764,16,30,09.01.2025,12,30,36,6,72
813,10,10,09.01.2025,16,459,626,167,2672
101,28,8,05.01.2025,10,400,500,100,1000
846,11,9,24.01.2025,14,329,441,112,1568
193,15,7,30.01.2025,14,399,506,107,1498
529,28,12,27.01.2025,2,283,398,115,230
68,10,23,17.01.2025,13,89,125,36,468
537,29,19,01.01.2025,6,118,170,52,312
206,27,2,08.01.2025,2,253,271,18,36
370,23,7,09.01.2025,12,441,555,114,1368
407,21,30,04.01.2025,1,143,174,31,31
609,15,6,31.01.2025,16,320,415,95,1520
353,6,27,29.01.2025,9,403,574,171,1539
93,10,1,13.01.2025,2,103,148,45,90
799,7,28,08.01.2025,8,366,418,52,416
668,14,17,01.01.2025,1,262,383,121,121
663,6,20,26.01.2025,1,134,156,22,22
825,10,23,31.01.2025,9,236,343,107,963
873,12,15,09.01.2025,7,258,306,48,336
534,27,20,13.01.2025,19,72,76,4,76
679,27,27,12.01.2025,18,351,462,111,1998
290,10,22,04.01.2025,16,52,62,10,160
284,21,11,28.01.2025,9,153,206,53,477
976,29,21,10.01.2025,7,96,123,27,189
247,29,2,26.01.2025,20,226,304,78,1560
698,5,24,01.01.2025,16,171,200,29,464
429,13,13,24.01.2025,2,318,435,117,234
586,27,7,11.01.2025,8,371,479,108,864
804,16,30,31.01.2025,12,279,331,52,624
175,27,22,29.01.2025,18,112,132,20,360
483,5,24,09.01.2025,18,410,599,189,3402
970,22,29,11.01.2025,3,133,161,28,84
763,28,10,14.01.2025,11,210,245,35,385
302,15,28,04.01.2025,16,47,68,21,336
598,19,20,03.01.2025,16,475,540,65,1040
123,28,22,13.01.2025,17,172,213,41,697
892,28,5,05.01.2025,7,195,241,46,322
584,29,30,15.01.2025,5,181,260,79,395
185,25,3,16.01.2025,11,343,512,169,1859
321,21,2,01.01.2025,15,160,183,23,345
793,6,19,25.01.2025,6,270,379,109,654
799,3,5,20.01.2025,14,344,428,84,1176
440,16,13,01.01.2025,2,293,334,41,82
383,1,29,11.01.2025,17,117,124,7,119
5,21,24,08.01.2025,8,375,542,167,1336
320,5,4,13.01.2025,17,321,381,60,1020
67,27,2,10.01.2025,10,253,349,96,960
611,17,11,14.01.2025,5,195,292,97,485
502,12,25,07.01.2025,6,484,708,224,1344
414,1,8,08.01.2025,5,128,177,49,245
604,17,6,04.01.2025,12,384,516,132,1584
39,13,29,21.01.2025,9,414,534,120,1080
50,20,2,22.01.2025,4,354,505,151,604
50,23,4,14.01.2025,15,214,237,23,345
259,16,23,05.01.2025,7,375,509,134,938
10,10,14,22.01.2025,4,359,461,102,408
638,20,23,05.01.2025,14,445,647,202,2828
524,24,20,04.01.2025,10,78,109,31,310
510,7,20,07.01.2025,9,445,572,127,1143
207,12,23,14.01.2025,10,102,109,7,70
509,30,7,23.01.2025,16,189,218,29,464
14,22,3,30.01.2025,4,447,585,138,552
506,5,3,25.01.2025,17,58,80,22,374
104,29,9,21.01.2025,8,253,378,125,1000
304,9,15,02.01.2025,4,436,492,56,224
41,28,10,12.01.2025,11,238,329,91,1001
98,28,25,29.01.2025,2,24,34,10,20
680,21,6,11.01.2025,12,477,595,118,1416
637,9,29,24.01.2025,3,210,298,88,264
188,4,13,13.01.2025,15,159,227,68,1020
707,28,16,26.01.2025,14,352,510,158,2212
171,4,5,23.01.2025,2,452,507,55,110
427,30,19,16.01.2025,19,367,458,91,1729
626,13,25,12.01.2025,20,34,49,15,300
902,27,24,29.01.2025,5,267,391,124,620
116,29,14,15.01.2025,2,52,61,9,18
322,1,23,28.01.2025,17,412,570,158,2686
742,19,8,31.01.2025,11,285,366,81,891
718,20,4,14.01.2025,8,266,321,55,440
693,21,13,05.01.2025,18,476,711,235,4230
56,1,21,30.01.2025,6,278,398,120,720
873,16,28,06.01.2025,3,404,514,110,330
247,11,9,02.01.2025,17,134,174,40,680
388,13,27,08.01.2025,3,255,319,64,192
587,15,3,28.01.2025,16,248,296,48,768
510,24,21,01.01.2025,4,226,279,53,212
571,18,1,27.01.2025,3,425,562,137,411
634,21,10,29.01.2025,17,307,351,44,748
688,15,11,12.01.2025,2,438,504,66,132
466,11,18,25.01.2025,20,327,413,86,1720
673,12,23,15.01.2025,4,69,96,27,108
228,1,11,12.01.2025,10,300,385,85,850
719,4,2,29.01.2025,6,272,303,31,186
735,24,24,14.01.2025,4,150,199,49,196
193,4,30,28.01.2025,13,130,163,33,429
801,7,23,11.01.2025,4,407,503,96,384
949,21,27,22.01.2025,19,83,116,33,627
462,15,22,19.01.2025,17,88,131,43,731
5,17,24,02.01.2025,18,498,620,122,2196
600,16,30,17.01.2025,6,374,490,116,696
749,27,5,04.01.2025,13,356,470,114,1482
904,11,17,29.01.2025,13,234,349,115,1495
938,23,25,08.01.2025,9,223,331,108,972
994,10,15,26.01.2025,5,90,111,21,105
717,29,24,17.01.2025,10,451,616,165,1650
882,11,23,24.01.2025,18,343,394,51,918
215,20,23,10.01.2025,12,491,664,173,2076
728,21,6,17.01.2025,18,375,501,126,2268
728,4,25,12.01.2025,18,265,348,83,1494
966,22,23,14.01.2025,18,166,240,74,1332
433,26,1,17.01.2025,4,32,39,7,28
55,22,2,07.01.2025,9,404,567,163,1467
294,22,9,05.01.2025,2,373,523,150,300
209,25,18,02.01.2025,12,436,547,111,1332
631,28,22,24.01.2025,18,462,532,70,1260
663,18,13,08.01.2025,17,421,593,172,2924
713,10,23,22.01.2025,2,494,604,110,220
427,26,22,11.01.2025,18,47,50,3,54
258,7,20,28.01.2025,15,444,511,67,1005
649,23,23,21.01.2025,12,406,534,128,1536
757,20,7,25.01.2025,7,170,213,43,301
700,3,6,31.01.2025,6,396,507,111,666
387,2,14,09.01.2025,18,155,172,17,306
599,28,9,01.01.2025,11,258,353,95,1045
159,2,5,30.01.2025,11,325,349,24,264
955,21,20,27.01.2025,10,271,381,110,1100
564,12,3,26.01.2025,11,289,332,43,473
189,17,3,26.01.2025,17,101,125,24,408
550,13,3,12.01.2025,8,472,541,69,552
340,11,12,10.01.2025,7,405,538,133,931
487,18,27,25.01.2025,1,78,105,27,27
457,8,29,21.01.2025,20,490,651,161,3220
982,2,22,29.01.2025,11,215,314,99,1089
968,4,13,09.01.2025,18,390,459,69,1242
934,17,27,25.01.2025,12,283,399,116,1392
457,16,2,10.01.2025,7,184,236,52,364
971,4,6,31.01.2025,18,293,309,16,288
68,7,22,21.01.2025,7,462,628,166,1162
856,4,7,18.01.2025,14,351,498,147,2058
74,24,22,05.01.2025,1,255,350,95,95
39,3,3,02.01.2025,6,426,496,70,420
73,19,27,08.01.2025,9,228,279,51,459
646,13,14,11.01.2025,1,219,296,77,77
548,1,21,24.01.2025,20,52,72,20,400
600,2,23,28.01.2025,3,203,298,95,285
109,10,26,22.01.2025,10,330,359,29,290
784,30,15,13.01.2025,13,440,593,153,1989
486,6,18,08.01.2025,5,402,493,91,455
817,28,18,10.01.2025,5,172,233,61,305
937,26,28,24.01.2025,12,25,32,7,84
569,5,4,02.01.2025,1,313,413,100,100
551,18,3,10.01.2025,7,403,558,155,1085
744,12,7,14.01.2025,17,92,103,11,187
227,20,27,09.01.2025,7,78,88,10,70
819,19,28,02.01.2025,18,256,343,87,1566
75,10,22,03.01.2025,9,70,80,10,90
595,16,11,12.01.2025,5,363,488,125,625
103,10,20,03.01.2025,7,182,231,49,343
337,20,22,10.01.2025,19,98,128,30,570
374,26,11,31.01.2025,14,106,112,6,84
253,26,8,23.01.2025,14,161,230,69,966
138,22,24,11.01.2025,16,256,320,64,1024
794,10,16,18.01.2025,4,109,146,37,148
84,27,9,28.01.2025,5,476,615,139,695
270,24,29,21.01.2025,3,392,425,33,99
20,28,17,21.01.2025,1,436,572,136,136
415,25,19,07.01.2025,2,302,353,51,102
916,18,16,21.01.2025,5,207,254,47,235
913,25,19,24.01.2025,10,88,111,23,230
523,3,13,12.01.2025,17,25,34,9,153
869,26,20,22.01.2025,6,407,522,115,690
457,6,6,19.01.2025,19,357,515,158,3002
150,24,24,16.01.2025,12,40,46,6,72
500,8,3,09.01.2025,12,139,149,10,120
212,17,30,26.01.2025,12,218,275,57,684
466,29,2,02.01.2025,11,72,98,26,286
534,21,27,09.01.2025,9,316,409,93,837
179,13,21,13.01.2025,12,320,430,110,1320
856,3,17,09.01.2025,13,484,557,73,949
416,12,27,28.01.2025,12,269,378,109,1308
909,20,1,17.01.2025,5,245,276,31,155
79,17,21,09.01.2025,7,96,109,13,91
371,20,23,27.01.2025,4,358,413,55,220
831,11,24,04.01.2025,16,365,462,97,1552
216,19,6,21.01.2025,14,31,36,5,70
131,19,19,06.01.2025,5,342,438,96,480
913,19,5,02.01.2025,6,152,223,71,426
530,13,20,19.01.2025,1,469,644,175,175
678,27,10,31.01.2025,3,130,163,33,99
483,28,16,06.01.2025,8,445,550,105,840
147,26,19,27.01.2025,6,339,457,118,708
271,6,24,22.01.2025,11,492,617,125,1375
605,3,8,13.01.2025,13,87,96,9,117
208,17,28,30.01.2025,17,370,458,88,1496
154,20,4,06.01.2025,16,481,638,157,2512
40,29,26,18.01.2025,17,405,447,42,714
494,22,5,29.01.2025,20,296,421,125,2500
919,25,22,21.01.2025,14,287,356,69,966
896,2,23,17.01.2025,14,137,202,65,910
494,26,25,13.01.2025,12,321,453,132,1584
930,25,27,23.01.2025,19,70,87,17,323
261,16,25,08.01.2025,3,165,218,53,159
557,14,9,07.01.2025,1,383,530,147,147
8,19,17,04.01.2025,17,23,28,5,85
211,23,26,11.01.2025,14,205,225,20,280
437,21,19,09.01.2025,9,457,590,133,1197
579,12,20,09.01.2025,13,406,464,58,754
566,26,18,16.01.2025,6,209,272,63,378
496,9,10,19.01.2025,12,416,569,153,1836
754,5,28,28.01.2025,4,402,464,62,248
802,23,6,04.01.2025,7,280,344,64,448
347,26,18,20.01.2025,2,102,125,23,46
652,1,26,03.01.2025,5,261,383,122,610
446,3,3,09.01.2025,8,209,227,18,144
39,24,13,30.01.2025,13,334,449,115,1495
294,23,20,02.01.2025,6,347,442,95,570
11,7,28,22.01.2025,17,166,189,23,391
803,20,17,17.01.2025,8,334,376,42,336
37,12,8,21.01.2025,1,100,109,9,9
283,25,13,12.01.2025,13,227,298,71,923
531,1,24,23.01.2025,3,490,534,44,132
292,24,27,18.01.2025,19,198,239,41,779
836,9,8,20.01.2025,7,252,370,118,826
589,1,9,06.01.2025,14,279,306,27,378
75,17,10,11.01.2025,4,431,552,121,484
264,29,18,27.01.2025,19,148,202,54,1026
990,13,19,16.01.2025,8,407,490,83,664
795,15,22,15.01.2025,19,461,490,29,551
120,9,3,13.01.2025,8,366,500,134,1072
820,11,14,31.01.2025,12,284,367,83,996
718,27,9,08.01.2025,10,67,82,15,150
767,27,11,03.01.2025,18,496,561,65,1170
322,12,7,29.01.2025,19,157,178,21,399
765,22,30,30.01.2025,7,275,380,105,735
241,24,8,28.01.2025,9,125,144,19,171
855,8,27,20.01.2025,12,99,139,40,480
123,30,3,22.01.2025,16,334,352,18,288
878,18,2,28.01.2025,16,210,279,69,1104
505,29,29,29.01.2025,19,464,545,81,1539
188,25,30,17.01.2025,9,223,256,33,297
591,5,2,17.01.2025,14,264,389,125,1750
34,17,12,13.01.2025,6,254,378,124,744
716,17,15,11.01.2025,1,26,35,9,9
389,19,4,11.01.2025,12,333,479,146,1752
192,18,9,08.01.2025,9,261,387,126,1134
352,12,6,16.01.2025,14,127,157,30,420
771,12,12,28.01.2025,13,163,204,41,533
586,5,19,22.01.2025,8,436,477,41,328
277,26,8,18.01.2025,14,458,559,101,1414
150,26,24,05.01.2025,16,432,455,23,368
432,16,5,29.01.2025,17,293,403,110,1870
805,16,10,09.01.2025,18,459,599,140,2520
408,4,23,06.01.2025,2,130,184,54,108
488,27,21,04.01.2025,15,401,481,80,1200
370,12,18,18.01.2025,9,196,208,12,108
125,12,28,22.01.2025,20,121,158,37,740
666,21,18,06.01.2025,10,201,240,39,390
523,16,25,24.01.2025,15,475,516,41,615
629,10,15,21.01.2025,5,464,522,58,290
828,30,11,14.01.2025,20,312,384,72,1440
929,3,3,06.01.2025,11,136,162,26,286
669,10,23,09.01.2025,20,350,430,80,1600
909,15,25,28.01.2025,12,402,528,126,1512
989,15,14,06.01.2025,6,457,485,28,168
746,8,22,09.01.2025,3,127,143,16,48
106,4,3,30.01.2025,16,300,322,22,352
790,13,17,25.01.2025,3,73,85,12,36
160,3,21,30.01.2025,13,178,205,27,351
756,10,15,21.01.2025,5,87,112,25,125
175,1,2,22.01.2025,12,460,672,212,2544
885,16,15,28.01.2025,18,498,584,86,1548
456,5,23,18.01.2025,6,322,425,103,618
647,24,21,29.01.2025,19,242,311,69,1311
655,18,10,30.01.2025,12,266,344,78,936
825,3,15,10.01.2025,12,231,270,39,468
311,1,1,17.01.2025,5,196,231,35,175
548,1,23,30.01.2025,16,406,513,107,1712
10,25,14,26.01.2025,10,325,375,50,500
8,18,12,07.01.2025,14,471,613,142,1988
405,8,6,23.01.2025,13,444,542,98,1274
270,3,14,21.01.2025,8,284,396,112,896
932,20,26,23.01.2025,9,165,221,56,504
545,26,9,14.01.2025,7,456,493,37,259
140,10,4,21.01.2025,15,336,421,85,1275
718,20,16,07.01.2025,11,29,32,3,33
993,18,1,06.01.2025,4,164,192,28,112
733,15,24,01.01.2025,8,66,74,8,64
506,7,11,14.01.2025,10,422,595,173,1730
381,15,23,26.01.2025,2,189,205,16,32
769,5,2,09.01.2025,13,56,72,16,208
186,7,29,27.01.2025,9,438,535,97,873
13,4,25,23.01.2025,8,217,303,86,688
454,8,24,02.01.2025,7,255,352,97,679
97,17,22,07.01.2025,16,219,297,78,1248
320,30,11,06.01.2025,2,401,590,189,378
534,4,9,16.01.2025,10,121,147,26,260
54,28,22,07.01.2025,4,140,187,47,188
333,1,6,26.01.2025,9,319,352,33,297
809,8,1,02.01.2025,19,421,573,152,2888
705,20,5,12.01.2025,3,147,165,18,54
94,22,20,11.01.2025,2,50,60,10,20
158,23,18,26.01.2025,4,84,107,23,92
325,18,26,21.01.2025,12,432,627,195,2340
751,7,1,23.01.2025,13,203,279,76,988
257,29,2,16.01.2025,15,306,362,56,840
714,16,7,19.01.2025,6,298,360,62,372
750,15,9,28.01.2025,20,488,701,213,4260
165,3,17,05.01.2025,15,171,243,72,1080
555,12,15,01.01.2025,17,214,295,81,1377
905,1,20,28.01.2025,12,417,554,137,1644
329,24,3,22.01.2025,18,439,537,98,1764
537,22,16,25.01.2025,18,98,130,32,576
331,14,21,11.01.2025,4,69,89,20,80
69,2,27,31.01.2025,5,111,160,49,245
207,4,16,07.01.2025,4,36,47,11,44
857,13,22,16.01.2025,17,339,463,124,2108
263,2,12,08.01.2025,20,387,419,32,640
953,30,7,21.01.2025,16,495,718,223,3568
82,15,26,21.01.2025,2,204,265,61,122
961,29,14,27.01.2025,12,426,583,157,1884
844,20,9,17.01.2025,2,395,427,32,64
312,3,7,31.01.2025,17,69,76,7,119
237,18,13,07.01.2025,7,289,389,100,700
584,21,6,18.01.2025,18,232,321,89,1602
785,21,19,12.01.2025,15,379,511,132,1980
905,4,6,26.01.2025,6,301,370,69,414
346,22,6,18.01.2025,20,246,362,116,2320
925,11,18,11.01.2025,12,231,322,91,1092
441,27,24,11.01.2025,20,143,186,43,860
220,13,25,18.01.2025,9,204,302,98,882
459,13,1,24.01.2025,2,165,217,52,104
531,5,29,10.01.2025,1,173,258,85,85
220,28,11,01.01.2025,9,490,637,147,1323
570,19,30,19.01.2025,5,68,73,5,25
365,5,5,09.01.2025,12,475,623,148,1776
239,9,26,10.01.2025,3,312,384,72,216
940,7,24,03.01.2025,11,425,539,114,1254
500,27,29,23.01.2025,19,439,640,201,3819
610,21,10,02.01.2025,19,215,233,18,342
58,30,25,11.01.2025,12,470,666,196,2352
427,30,28,04.01.2025,8,402,540,138,1104
617,30,1,21.01.2025,13,47,56,9,117
43,11,18,19.01.2025,5,187,239,52,260
227,5,2,22.01.2025,13,248,344,96,1248
590,17,3,08.01.2025,14,168,236,68,952
152,5,11,03.01.2025,16,312,432,120,1920
562,13,9,03.01.2025,13,276,344,68,884
715,5,25,05.01.2025,16,306,349,43,688
405,21,19,07.01.2025,18,335,502,167,3006
537,8,8,03.01.2025,9,417,519,102,918
702,30,19,03.01.2025,4,363,449,86,344
375,12,7,11.01.2025,12,324,436,112,1344
789,10,6,12.01.2025,20,440,658,218,4360
453,20,5,15.01.2025,2,493,699,206,412
205,22,12,05.01.2025,3,77,106,29,87
249,20,30,05.01.2025,10,27,33,6,60
824,4,10,15.01.2025,16,31,37,6,96
758,18,7,07.01.2025,18,287,398,111,1998
562,16,20,24.01.2025,5,375,512,137,685
19,13,19,29.01.2025,17,42,49,7,119
62,10,7,26.01.2025,20,158,170,12,240
671,1,3,13.01.2025,9,359,515,156,1404
676,12,28,04.01.2025,1,169,243,74,74
665,13,8,13.01.2025,17,383,419,36,612
324,16,28,20.01.2025,18,65,74,9,162
513,15,18,30.01.2025,1,40,46,6,6
543,10,11,16.01.2025,13,401,449,48,624
356,22,12,12.01.2025,10,140,210,70,700
514,9,26,02.01.2025,9,469,574,105,945
835,1,18,31.01.2025,9,135,151,16,144
919,13,22,05.01.2025,3,393,480,87,261
984,22,20,28.01.2025,8,233,270,37,296
157,14,10,30.01.2025,20,188,235,47,940
135,7,21,05.01.2025,19,297,403,106,2014
208,28,5,10.01.2025,17,485,539,54,918
931,25,5,21.01.2025,19,489,548,59,1121
70,18,18,31.01.2025,4,114,136,22,88
901,5,24,01.01.2025,11,470,699,229,2519
985,14,10,15.01.2025,9,97,136,39,351
110,5,6,01.01.2025,20,335,392,57,1140
581,20,8,20.01.2025,8,138,188,50,400
368,3,23,25.01.2025,16,88,112,24,384
620,16,23,21.01.2025,12,114,163,49,588
504,16,5,06.01.2025,7,135,144,9,63
783,1,30,09.01.2025,14,133,184,51,714
208,25,7,03.01.2025,6,494,731,237,1422
450,28,20,16.01.2025,11,463,581,118,1298
253,14,13,25.01.2025,2,331,457,126,252
390,24,11,13.01.2025,20,500,692,192,3840
609,18,17,21.01.2025,2,286,314,28,56
468,27,29,02.01.2025,8,285,368,83,664
753,2,18,13.01.2025,17,411,548,137,2329
51,7,10,15.01.2025,13,472,560,88,1144
848,10,15,06.01.2025,14,170,225,55,770
56,23,17,29.01.2025,5,257,366,109,545
463,3,24,17.01.2025,4,112,157,45,180
961,29,23,18.01.2025,5,221,273,52,260
462,1,6,15.01.2025,19,479,657,178,3382
207,29,15,03.01.2025,9,185,252,67,603
929,23,26,06.01.2025,4,66,73,7,28
461,21,12,03.01.2025,17,382,467,85,1445
811,17,20,31.01.2025,6,213,276,63,378
45,25,6,30.01.2025,11,309,446,137,1507
884,5,6,28.01.2025,5,111,155,44,220
53,14,10,10.01.2025,15,167,222,55,825
121,29,5,31.01.2025,7,21,28,7,49
260,1,15,16.01.2025,16,298,421,123,1968
623,29,16,08.01.2025,7,321,432,111,777
465,14,15,03.01.2025,20,327,344,17,340
904,18,9,20.01.2025,18,439,624,185,3330
51,6,5,02.01.2025,12,38,42,4,48
34,22,19,27.01.2025,20,172,206,34,680
90,2,4,14.01.2025,6,102,138,36,216
626,22,23,23.01.2025,20,313,440,127,2540
182,15,24,19.01.2025,12,496,529,33,396
787,10,11,12.01.2025,13,439,474,35,455
438,27,18,03.01.2025,10,261,290,29,290
712,28,9,11.01.2025,17,231,297,66,1122
713,7,20,02.01.2025,4,312,430,118,472
645,17,3,16.01.2025,20,498,700,202,4040
724,10,14,20.01.2025,11,152,196,44,484
639,12,30,05.01.2025,20,308,392,84,1680
747,21,16,16.01.2025,6,472,625,153,918
726,10,7,01.01.2025,4,32,40,8,32
816,4,24,28.01.2025,7,429,569,140,980
425,14,2,11.01.2025,12,306,432,126,1512
218,1,21,07.01.2025,10,150,211,61,610
316,10,17,18.01.2025,11,412,434,22,242
703,11,11,13.01.2025,19,335,496,161,3059
853,6,7,11.01.2025,11,492,665,173,1903
939,16,26,02.01.2025,5,266,298,32,160
472,29,28,18.01.2025,11,256,359,103,1133
424,30,24,02.01.2025,17,173,226,53,901
695,11,18,18.01.2025,1,126,165,39,39
340,26,30,29.01.2025,12,53,79,26,312
288,27,1,11.01.2025,13,340,439,99,1287
170,19,20,13.01.2025,6,324,357,33,198
802,25,10,23.01.2025,11,383,408,25,275
424,3,16,29.01.2025,8,210,263,53,424
974,10,7,17.01.2025,10,109,120,11,110
804,2,25,07.01.2025,3,247,316,69,207
819,16,29,17.01.2025,5,117,141,24,120
496,24,28,17.01.2025,10,417,499,82,820
788,28,4,27.01.2025,17,366,548,182,3094
211,24,2,15.01.2025,13,385,554,169,2197
119,1,10,30.01.2025,2,371,531,160,320
893,3,11,15.01.2025,2,72,92,20,40
675,24,10,01.01.2025,19,408,486,78,1482
914,7,11,07.01.2025,7,166,195,29,203
327,25,15,22.01.2025,4,159,178,19,76
281,4,1,31.01.2025,20,306,392,86,1720
212,18,12,18.01.2025,11,158,176,18,198
722,26,10,19.01.2025,8,107,116,9,72
628,29,11,18.01.2025,15,45,50,5,75
483,29,22,02.01.2025,4,216,232,16,64
437,13,6,23.01.2025,20,476,627,151,3020
857,23,23,15.01.2025,20,202,241,39,780
838,7,23,25.01.2025,18,60,89,29,522
774,25,15,19.01.2025,5,67,95,28,140
942,23,15,04.01.2025,15,178,242,64,960
728,25,15,16.01.2025,8,134,149,15,120
918,20,9,30.01.2025,12,220,249,29,348
940,22,11,26.01.2025,11,252,320,68,748
67,16,4,12.01.2025,16,256,366,110,1760
290,25,12,20.01.2025,19,85,109,24,456
416,27,23,26.01.2025,4,186,242,56,224
73,26,10,18.01.2025,15,225,296,71,1065
245,20,8,18.01.2025,6,266,325,59,354
349,7,27,23.01.2025,19,240,337,97,1843
446,19,26,11.01.2025,18,375,434,59,1062
679,22,3,24.01.2025,19,448,569,121,2299
607,20,15,11.01.2025,18,69,98,29,522
181,10,13,03.01.2025,20,75,102,27,540
611,25,27,13.01.2025,11,273,366,93,1023
63,3,7,27.01.2025,5,474,622,148,740
774,21,26,01.01.2025,5,358,400,42,210
545,10,13,20.01.2025,19,248,282,34,646
698,29,11,10.01.2025,19,426,622,196,3724
312,30,30,14.01.2025,12,65,85,20,240
627,17,13,28.01.2025,5,456,539,83,415
379,29,18,31.01.2025,2,20,27,7,14
841,12,4,28.01.2025,10,463,493,30,300
443,23,19,13.01.2025,11,384,469,85,935
391,14,18,07.01.2025,6,263,293,30,180
569,13,27,30.01.2025,12,450,557,107,1284
296,28,22,05.01.2025,5,25,27,2,10
17,5,24,29.01.2025,16,356,444,88,1408
140,3,5,21.01.2025,14,460,577,117,1638
808,23,20,30.01.2025,14,339,383,44,616
522,14,18,27.01.2025,15,216,261,45,675
191,14,20,01.01.2025,19,275,394,119,2261
243,23,17,09.01.2025,14,494,640,146,2044
376,2,2,19.01.2025,16,380,462,82,1312
595,16,23,03.01.2025,5,393,542,149,745
880,25,25,09.01.2025,15,284,308,24,360
912,20,3,08.01.2025,16,342,473,131,2096
984,22,3,22.01.2025,18,428,561,133,2394
628,2,29,11.01.2025,18,418,441,23,414
465,17,29,16.01.2025,19,395,474,79,1501
362,26,10,10.01.2025,6,38,52,14,84
612,24,10,24.01.2025,19,153,165,12,228
485,19,6,19.01.2025,2,356,532,176,352
829,24,20,01.01.2025,10,268,291,23,230
518,3,28,26.01.2025,9,149,165,16,144
288,9,28,09.01.2025,1,399,439,40,40
179,30,19,24.01.2025,5,357,447,90,450
828,6,9,26.01.2025,8,268,303,35,280
541,28,2,11.01.2025,3,94,124,30,90
842,5,27,16.01.2025,14,414,506,92,1288
677,15,24,21.01.2025,6,127,166,39,234
863,12,2,21.01.2025,9,406,576,170,1530
54,6,15,13.01.2025,16,174,220,46,736
972,25,30,18.01.2025,8,214,291,77,616
400,16,9,05.01.2025,17,465,579,114,1938
296,30,26,15.01.2025,13,367,437,70,910
543,22,2,04.01.2025,18,346,418,72,1296
865,14,20,30.01.2025,9,191,224,33,297
822,4,9,21.01.2025,19,220,277,57,1083
692,24,8,24.01.2025,19,414,471,57,1083
346,22,23,06.01.2025,11,300,316,16,176
9,27,3,01.01.2025,14,70,90,20,280
702,15,12,08.01.2025,10,148,168,20,200
25,20,3,02.01.2025,20,356,517,161,3220
223,20,21,04.01.2025,4,64,92,28,112
134,13,22,25.01.2025,19,431,640,209,3971
918,4,23,06.01.2025,9,170,214,44,396
959,3,21,15.01.2025,9,413,513,100,900
926,22,25,25.01.2025,11,151,170,19,209
76,9,25,02.01.2025,13,218,262,44,572
62,9,27,09.01.2025,6,245,265,20,120
951,7,20,13.01.2025,6,350,445,95,570
148,18,25,14.01.2025,7,334,447,113,791
935,15,23,09.01.2025,4,37,40,3,12
586,24,9,25.01.2025,15,29,42,13,195
153,21,21,01.01.2025,2,360,441,81,162
156,23,11,29.01.2025,13,314,330,16,208
725,25,16,16.01.2025,14,226,323,97,1358
800,26,26,03.01.2025,18,135,142,7,126
978,23,27,25.01.2025,16,82,107,25,400
958,12,11,22.01.2025,10,225,242,17,170
982,21,3,12.01.2025,18,456,676,220,3960
83,27,15,25.01.2025,10,351,401,50,500
568,2,13,22.01.2025,7,173,236,63,441
918,4,21,23.01.2025,12,269,293,24,288
648,15,24,07.01.2025,5,38,43,5,25
738,19,8,16.01.2025,13,52,73,21,273
659,10,16,18.01.2025,15,28,30,2,30
58,11,26,24.01.2025,2,227,250,23,46
827,21,22,17.01.2025,15,367,529,162,2430
550,5,24,19.01.2025,8,493,534,41,328
754,5,16,21.01.2025,1,261,381,120,120
634,2,8,23.01.2025,5,27,30,3,15
52,29,10,27.01.2025,4,253,335,82,328
856,19,3,27.01.2025,4,78,99,21,84
819,20,8,03.01.2025,7,238,286,48,336
856,24,22,13.01.2025,11,81,121,40,440
590,18,5,11.01.2025,7,411,440,29,203
178,11,3,04.01.2025,9,92,128,36,324
173,23,12,18.01.2025,6,244,283,39,234
596,2,5,04.01.2025,20,212,297,85,1700
17,29,16,03.01.2025,1,23,26,3,3
92,23,21,19.01.2025,10,233,317,84,840
812,25,16,23.01.2025,5,125,139,14,70
278,17,15,14.01.2025,8,500,564,64,512
709,2,20,06.01.2025,16,333,492,159,2544
643,27,26,10.01.2025,12,234,246,12,144
242,7,4,17.01.2025,4,336,408,72,288
780,18,17,08.01.2025,15,414,551,137,2055
214,9,2,07.01.2025,4,427,477,50,200
865,30,16,16.01.2025,6,101,137,36,216
45,2,21,12.01.2025,10,127,158,31,310
343,20,26,29.01.2025,15,42,46,4,60
54,30,18,06.01.2025,6,422,449,27,162
528,4,3,29.01.2025,8,389,486,97,776
594,11,14,07.01.2025,11,137,192,55,605
334,8,4,08.01.2025,14,465,530,65,910
913,8,3,16.01.2025,19,268,288,20,380
447,5,7,30.01.2025,20,252,285,33,660
383,5,15,24.01.2025,7,343,415,72,504
277,7,11,05.01.2025,2,374,488,114,228
288,5,4,28.01.2025,15,254,315,61,915
779,11,8,29.01.2025,10,329,369,40,400
814,21,20,29.01.2025,6,315,468,153,918
876,8,3,14.01.2025,17,270,388,118,2006
222,19,16,27.01.2025,15,162,171,9,135
439,24,28,08.01.2025,8,187,233,46,368
228,29,30,19.01.2025,5,487,637,150,750
6,14,2,02.01.2025,16,395,551,156,2496
35,14,17,13.01.2025,16,434,612,178,2848
842,4,15,16.01.2025,8,62,81,19,152
13,23,24,14.01.2025,7,87,105,18,126
245,21,3,01.01.2025,16,362,430,68,1088
721,15,28,19.01.2025,19,32,48,16,304
475,25,5,28.01.2025,13,114,160,46,598
380,21,15,23.01.2025,1,460,613,153,153
395,29,23,11.01.2025,17,36,43,7,119
771,9,23,31.01.2025,20,297,389,92,1840
213,26,22,03.01.2025,20,470,564,94,1880
955,2,17,31.01.2025,12,474,509,35,420
393,12,15,20.01.2025,2,207,251,44,88
664,18,23,03.01.2025,18,383,535,152,2736
142,11,8,18.01.2025,4,352,445,93,372
962,25,19,28.01.2025,7,405,561,156,1092
231,11,12,29.01.2025,9,277,376,99,891
284,2,3,12.01.2025,12,251,318,67,804
540,27,4,16.01.2025,18,367,522,155,2790
922,10,15,20.01.2025,12,429,580,151,1812
710,26,29,03.01.2025,7,476,689,213,1491
90,3,13,29.01.2025,6,167,247,80,480
79,4,6,09.01.2025,4,376,420,44,176
155,28,7,17.01.2025,1,170,210,40,40
699,18,30,05.01.2025,16,197,244,47,752
756,21,1,10.01.2025,7,52,55,3,21
822,8,27,31.01.2025,17,350,420,70,1190
593,11,21,21.01.2025,11,268,353,85,935
714,17,27,18.01.2025,15,254,301,47,705
136,29,26,10.01.2025,6,424,495,71,426
496,12,10,25.01.2025,2,95,115,20,40
467,6,20,30.01.2025,6,384,496,112,672
187,6,27,23.01.2025,5,102,118,16,80
43,11,19,05.01.2025,15,153,186,33,495
211,18,23,02.01.2025,11,196,219,23,253
460,18,6,18.01.2025,10,82,120,38,380
415,30,16,25.01.2025,5,254,373,119,595
160,1,24,18.01.2025,17,189,253,64,1088
303,16,29,10.01.2025,19,361,403,42,798
579,24,30,30.01.2025,15,193,263,70,1050
750,16,29,02.01.2025,5,367,476,109,545
316,1,13,20.01.2025,8,248,300,52,416
335,2,20,21.01.2025,7,318,409,91,637
801,30,25,09.01.2025,7,31,34,3,21
870,15,22,22.01.2025,3,282,346,64,192
503,11,20,20.01.2025,17,48,70,22,374
370,13,5,23.01.2025,14,209,256,47,658
13,10,12,12.01.2025,10,248,358,110,1100
90,7,24,29.01.2025,15,399,597,198,2970
823,15,10,06.01.2025,14,393,571,178,2492
143,27,19,20.01.2025,3,93,106,13,39
487,28,17,11.01.2025,3,497,737,240,720
775,13,3,01.01.2025,14,347,507,160,2240
425,6,18,15.01.2025,19,406,593,187,3553
205,6,27,13.01.2025,10,303,385,82,820
843,27,10,27.01.2025,19,175,223,48,912
758,15,8,01.01.2025,1,98,114,16,16
979,21,27,21.01.2025,16,83,112,29,464
915,10,14,06.01.2025,16,484,658,174,2784
251,1,4,25.01.2025,9,272,407,135,1215
69,20,24,12.01.2025,19,266,347,81,1539
890,9,21,22.01.2025,16,375,532,157,2512
383,17,24,19.01.2025,1,452,527,75,75
596,2,5,11.01.2025,15,469,639,170,2550
366,6,2,09.01.2025,12,234,313,79,948
979,12,2,10.01.2025,10,291,389,98,980
79,17,7,25.01.2025,6,411,449,38,228
771,6,18,11.01.2025,11,443,634,191,2101
820,10,9,22.01.2025,12,69,89,20,240
361,27,5,01.01.2025,5,285,335,50,250
798,16,14,11.01.2025,6,72,83,11,66
516,8,27,07.01.2025,18,334,454,120,2160
976,17,28,18.01.2025,18,379,527,148,2664
117,14,15,30.01.2025,3,79,112,33,99
946,1,16,12.01.2025,10,373,453,80,800
837,15,29,20.01.2025,17,410,609,199,3383
177,23,10,01.01.2025,4,133,147,14,56
711,5,23,08.01.2025,10,84,96,12,120
81,14,23,25.01.2025,4,59,62,3,12
496,25,14,02.01.2025,7,75,80,5,35
676,17,19,02.01.2025,16,80,117,37,592
45,3,10,22.01.2025,1,406,444,38,38
127,30,20,07.01.2025,19,481,548,67,1273
687,12,1,03.01.2025,5,453,628,175,875
285,19,12,12.01.2025,6,457,583,126,756
747,20,8,17.01.2025,19,54,59,5,95
593,25,1,17.01.2025,7,386,439,53,371
289,6,29,25.01.2025,18,22,33,11,198
102,30,7,30.01.2025,17,455,623,168,2856
376,23,19,06.01.2025,15,364,539,175,2625
186,27,12,13.01.2025,14,129,165,36,504
418,4,25,11.01.2025,4,258,284,26,104
140,16,25,12.01.2025,10,305,419,114,1140
85,11,16,04.01.2025,13,165,207,42,546
754,10,22,27.01.2025,15,135,175,40,600
298,28,14,07.01.2025,3,478,683,205,615
488,22,12,06.01.2025,1,365,464,99,99
108,13,15,17.01.2025,3,81,90,9,27
411,23,19,04.01.2025,6,53,64,11,66
204,11,7,20.01.2025,13,82,95,13,169
435,24,16,09.01.2025,19,323,379,56,1064
809,26,21,31.01.2025,13,202,255,53,689
618,13,16,17.01.2025,9,95,133,38,342
111,4,9,16.01.2025,16,138,184,46,736
138,1,4,24.01.2025,2,445,481,36,72
695,1,6,13.01.2025,20,367,439,72,1440
311,20,20,04.01.2025,3,358,497,139,417
786,16,26,15.01.2025,7,170,229,59,413
503,17,9,18.01.2025,11,434,624,190,2090
560,1,25,02.01.2025,14,470,687,217,3038
393,15,11,28.01.2025,13,246,309,63,819
34,6,18,22.01.2025,10,472,646,174,1740
504,14,5,10.01.2025,13,269,375,106,1378
583,22,16,22.01.2025,18,370,478,108,1944
482,16,18,28.01.2025,6,279,300,21,126
270,16,19,13.01.2025,20,366,442,76,1520
292,11,2,01.01.2025,19,43,48,5,95
376,12,26,24.01.2025,19,33,46,13,247
641,11,13,04.01.2025,14,196,293,97,1358
422,12,2,22.01.2025,8,146,169,23,184
320,19,3,30.01.2025,3,464,551,87,261
346,6,1,18.01.2025,11,39,49,10,110
885,14,19,17.01.2025,14,156,165,9,126
481,19,1,11.01.2025,13,312,382,70,910
587,4,26,16.01.2025,4,373,505,132,528
345,16,17,26.01.2025,11,105,139,34,374
373,14,7,16.01.2025,3,450,645,195,585
220,10,9,02.01.2025,10,313,385,72,720
232,20,24,31.01.2025,3,387,553,166,498
98,19,11,09.01.2025,3,310,437,127,381
487,14,7,12.01.2025,3,353,502,149,447
517,26,10,14.01.2025,18,180,205,25,450
412,9,20,17.01.2025,15,363,506,143,2145
185,29,1,21.01.2025,17,461,523,62,1054
512,7,22,31.01.2025,15,157,231,74,1110
546,26,20,28.01.2025,14,498,650,152,2128
642,2,17,07.01.2025,12,256,286,30,360
155,24,22,25.01.2025,10,452,563,111,1110
327,28,27,30.01.2025,3,344,393,49,147
423,9,27,10.01.2025,6,151,205,54,324
242,13,8,04.01.2025,5,118,125,7,35
817,27,10,15.01.2025,16,306,458,152,2432
433,21,29,02.01.2025,7,101,118,17,119
30,9,26,26.01.2025,9,357,463,106,954
660,28,2,31.01.2025,16,420,445,25,400
881,29,3,11.01.2025,20,172,248,76,1520
923,14,29,12.01.2025,3,223,329,106,318
742,27,5,08.01.2025,4,312,431,119,476
956,4,17,22.01.2025,19,416,611,195,3705
258,16,29,03.01.2025,8,327,361,34,272
827,11,11,27.01.2025,19,397,487,90,1710
767,24,8,30.01.2025,14,131,146,15,210
180,7,9,15.01.2025,14,150,216,66,924
58,16,18,12.01.2025,4,182,236,54,216
487,22,8,31.01.2025,9,470,659,189,1701
149,12,16,23.01.2025,12,440,523,83,996
661,29,20,02.01.2025,2,373,546,173,346
688,8,9,18.01.2025,13,178,238,60,780
718,12,29,26.01.2025,4,293,422,129,516
879,15,13,01.01.2025,13,494,736,242,3146
262,10,3,30.01.2025,8,172,197,25,200
912,6,30,15.01.2025,11,470,665,195,2145
660,14,26,02.01.2025,9,463,503,40,360
799,16,16,24.01.2025,14,494,706,212,2968
735,14,29,30.01.2025,4,442,496,54,216
268,17,3,12.01.2025,14,328,452,124,1736
561,24,11,15.01.2025,1,410,440,30,30
657,6,21,15.01.2025,5,21,26,5,25
644,10,11,19.01.2025,3,76,85,9,27
529,23,25,27.01.2025,5,453,597,144,720
421,26,11,15.01.2025,16,467,645,178,2848
267,6,22,19.01.2025,11,429,505,76,836
87,14,12,06.01.2025,13,468,571,103,1339
855,29,19,08.01.2025,1,31,45,14,14
663,20,21,08.01.2025,3,256,292,36,108
719,28,6,02.01.2025,13,336,418,82,1066
267,5,3,31.01.2025,12,107,158,51,612
121,1,23,17.01.2025,14,415,608,193,2702
465,27,22,16.01.2025,4,134,184,50,200
196,28,27,26.01.2025,9,167,231,64,576
392,5,14,28.01.2025,7,327,375,48,336
844,10,24,22.01.2025,7,234,265,31,217
812,5,1,10.01.2025,9,140,186,46,414
930,8,12,19.01.2025,15,63,66,3,45
137,28,11,23.01.2025,13,371,425,54,702
393,23,14,24.01.2025,20,151,164,13,260
571,2,2,11.01.2025,8,261,381,120,960
621,22,26,20.01.2025,2,22,26,4,8
635,13,10,13.01.2025,12,87,129,42,504
573,2,19,06.01.2025,9,106,135,29,261
953,11,29,15.01.2025,5,65,78,13,65
544,14,5,09.01.2025,4,180,193,13,52
131,16,28,27.01.2025,9,402,487,85,765
441,10,29,29.01.2025,9,333,474,141,1269
949,9,17,11.01.2025,14,477,536,59,826
755,16,25,31.01.2025,5,304,436,132,660
674,21,26,15.01.2025,2,116,130,14,28
236,6,2,16.01.2025,9,103,141,38,342
447,4,29,30.01.2025,16,40,50,10,160
727,18,16,15.01.2025,16,77,110,33,528
888,5,4,12.01.2025,3,124,179,55,165
185,27,6,24.01.2025,17,441,517,76,1292
913,22,19,07.01.2025,19,22,28,6,114
585,6,14,30.01.2025,3,146,204,58,174
694,4,29,11.01.2025,1,165,224,59,59
697,4,13,12.01.2025,19,495,732,237,4503
858,11,5,01.01.2025,3,255,363,108,324
676,16,15,21.01.2025,9,324,436,112,1008
338,2,21,20.01.2025,15,186,275,89,1335
752,30,26,19.01.2025,5,128,184,56,280
821,21,10,11.01.2025,2,400,433,33,66
975,20,13,03.01.2025,13,150,170,20,260
989,25,28,13.01.2025,3,30,43,13,39
167,13,25,13.01.2025,10,351,487,136,1360
670,5,4,10.01.2025,16,430,535,105,1680
826,30,10,29.01.2025,20,87,105,18,360
99,27,12,17.01.2025,7,270,338,68,476
398,16,9,19.01.2025,20,236,257,21,420
433,26,12,20.01.2025,6,242,323,81,486
96,2,17,11.01.2025,15,366,421,55,825
703,23,5,30.01.2025,16,289,385,96,1536
538,3,10,15.01.2025,14,60,87,27,378
490,10,5,05.01.2025,10,450,523,73,730
438,10,19,02.01.2025,18,59,86,27,486
526,4,17,14.01.2025,14,68,86,18,252
738,19,27,09.01.2025,12,150,197,47,564
788,17,1,04.01.2025,15,111,156,45,675
864,13,2,03.01.2025,14,468,640,172,2408
322,19,24,15.01.2025,15,339,479,140,2100
350,30,28,26.01.2025,6,128,145,17,102
765,20,9,28.01.2025,4,242,312,70,280
6,13,4,01.01.2025,6,355,449,94,564
709,13,28,22.01.2025,20,391,496,105,2100
634,27,20,12.01.2025,13,431,511,80,1040
129,5,1,07.01.2025,4,437,462,25,100
994,7,28,01.01.2025,7,266,357,91,637
666,8,14,27.01.2025,18,117,127,10,180
789,15,5,16.01.2025,14,31,34,3,42
925,5,24,23.01.2025,15,268,338,70,1050
881,15,19,08.01.2025,7,170,222,52,364
854,13,2,11.01.2025,1,72,96,24,24
731,14,14,28.01.2025,16,397,520,123,1968
749,18,10,02.01.2025,16,224,284,60,960
606,24,20,30.01.2025,16,138,189,51,816
541,1,14,19.01.2025,11,303,327,24,264
915,21,14,29.01.2025,16,79,101,22,352
962,21,12,15.01.2025,14,30,34,4,56
744,7,16,12.01.2025,15,138,176,38,570
602,30,22,11.01.2025,20,456,652,196,3920
673,15,5,29.01.2025,10,390,534,144,1440
983,14,27,31.01.2025,12,427,539,112,1344
995,28,6,20.01.2025,7,164,223,59,413
89,22,16,05.01.2025,6,122,137,15,90
504,4,26,14.01.2025,16,175,202,27,432
571,2,1,12.01.2025,9,202,274,72,648
179,27,28,29.01.2025,17,36,51,15,255
346,14,4,20.01.2025,8,81,106,25,200
499,9,11,26.01.2025,12,413,442,29,348
899,18,9,29.01.2025,5,456,620,164,820
528,20,22,04.01.2025,2,494,729,235,470
819,15,27,25.01.2025,4,74,104,30,120
625,26,28,31.01.2025,4,441,575,134,536
520,4,6,21.01.2025,4,465,531,66,264
371,6,24,10.01.2025,15,410,524,114,1710
751,28,4,05.01.2025,12,191,271,80,960
126,28,7,15.01.2025,14,413,577,164,2296
252,27,26,16.01.2025,11,166,212,46,506
88,9,12,23.01.2025,14,204,272,68,952
252,5,25,25.01.2025,17,235,330,95,1615
142,26,14,14.01.2025,14,479,602,123,1722
873,17,26,22.01.2025,12,35,44,9,108
789,1,23,26.01.2025,17,55,60,5,85
323,13,25,06.01.2025,14,51,63,12,168
38,22,30,21.01.2025,5,482,631,149,745
647,23,26,22.01.2025,17,171,212,41,697
908,22,23,18.01.2025,10,389,538,149,1490
932,12,1,27.01.2025,9,480,618,138,1242
943,5,23,13.01.2025,15,349,399,50,750
558,20,26,20.01.2025,15,377,454,77,1155
832,26,21,13.01.2025,7,471,558,87,609
38,18,11,13.01.2025,5,286,428,142,710
291,7,3,17.01.2025,18,179,230,51,918
776,21,6,01.01.2025,1,475,669,194,194
607,9,8,27.01.2025,10,391,485,94,940
518,4,24,02.01.2025,12,152,202,50,600
363,4,2,25.01.2025,4,249,295,46,184
755,1,15,11.01.2025,8,432,599,167,1336
596,19,23,29.01.2025,18,452,596,144,2592
359,10,10,22.01.2025,19,364,405,41,779
387,17,24,08.01.2025,4,187,240,53,212
198,27,25,12.01.2025,15,70,78,8,120
436,27,14,03.01.2025,3,51,63,12,36
134,16,7,15.01.2025,3,209,283,74,222
413,19,18,17.01.2025,13,466,545,79,1027
511,21,14,15.01.2025,16,394,586,192,3072
844,6,5,17.01.2025,5,268,367,99,495
133,23,17,28.01.2025,17,80,109,29,493
467,16,2,24.01.2025,6,306,372,66,396
975,4,20,28.01.2025,14,76,84,8,112
586,10,2,17.01.2025,5,80,97,17,85
384,10,10,16.01.2025,1,425,474,49,49
803,19,14,02.01.2025,10,475,559,84,840
188,27,24,16.01.2025,1,82,106,24,24
70,28,2,14.01.2025,16,313,372,59,944
464,29,11,26.01.2025,13,263,375,112,1456
854,20,5,25.01.2025,5,278,372,94,470
780,15,22,15.01.2025,5,463,638,175,875
92,26,20,22.01.2025,20,229,280,51,1020
922,13,11,18.01.2025,2,363,527,164,328
754,9,21,03.01.2025,6,382,405,23,138
646,26,25,23.01.2025,10,307,411,104,1040
660,18,3,07.01.2025,20,297,389,92,1840
55,19,17,07.01.2025,16,277,403,126,2016
124,22,30,18.01.2025,6,29,34,5,30
211,8,27,23.01.2025,19,247,269,22,418
547,20,11,13.01.2025,19,43,55,12,228
957,1,11,14.01.2025,6,232,246,14,84
541,11,13,09.01.2025,3,78,116,38,114
555,6,10,05.01.2025,6,150,209,59,354
158,10,14,22.01.2025,6,50,66,16,96
334,6,1,23.01.2025,2,172,211,39,78
328,5,14,29.01.2025,11,152,185,33,363
848,29,4,02.01.2025,7,142,197,55,385
601,8,16,17.01.2025,17,217,321,104,1768
276,2,11,15.01.2025,18,228,246,18,324
30,14,21,08.01.2025,1,157,204,47,47
601,22,4,08.01.2025,18,353,495,142,2556
312,19,14,15.01.2025,3,453,605,152,456
209,26,5,12.01.2025,18,106,149,43,774
551,14,30,18.01.2025,15,41,43,2,30
476,27,20,10.01.2025,6,20,22,2,12
944,16,9,20.01.2025,9,449,609,160,1440
360,27,21,07.01.2025,19,450,576,126,2394
47,6,24,18.01.2025,19,55,65,10,190
405,23,4,27.01.2025,5,391,508,117,585
287,29,14,07.01.2025,20,278,412,134,2680
326,29,22,31.01.2025,11,345,403,58,638
771,23,15,09.01.2025,8,359,536,177,1416
350,7,15,31.01.2025,20,188,199,11,220
709,5,21,30.01.2025,1,331,419,88,88
924,1,22,06.01.2025,14,304,442,138,1932
721,16,25,13.01.2025,18,61,86,25,450
665,21,3,18.01.2025,1,476,678,202,202
688,15,22,04.01.2025,12,436,532,96,1152
616,12,13,06.01.2025,1,83,104,21,21
959,7,15,01.01.2025,8,400,424,24,192
288,22,30,23.01.2025,12,118,129,11,132
629,21,10,26.01.2025,8,139,207,68,544
991,12,2,09.01.2025,16,483,660,177,2832
621,7,1,07.01.2025,13,76,110,34,442
583,17,16,06.01.2025,18,119,160,41,738
580,22,22,20.01.2025,19,109,118,9,171
132,24,3,05.01.2025,9,497,649,152,1368
234,29,17,24.01.2025,9,118,169,51,459
24,23,22,18.01.2025,20,149,202,53,1060
905,15,1,31.01.2025,14,348,471,123,1722
666,2,28,31.01.2025,11,241,345,104,1144
417,9,4,22.01.2025,17,258,328,70,1190
530,25,2,29.01.2025,8,44,52,8,64
431,18,15,11.01.2025,1,220,250,30,30
84,29,19,26.01.2025,1,397,457,60,60
707,14,3,30.01.2025,8,120,135,15,120
319,3,21,21.01.2025,4,34,43,9,36
828,1,19,26.01.2025,11,450,523,73,803
111,16,8,31.01.2025,11,446,479,33,363
342,17,26,08.01.2025,3,417,550,133,399
450,25,4,21.01.2025,15,316,350,34,510
998,2,30,02.01.2025,13,180,261,81,1053
711,3,26,05.01.2025,2,490,691,201,402
57,10,20,21.01.2025,14,53,58,5,70
58,18,2,10.01.2025,13,225,246,21,273
771,14,8,28.01.2025,20,423,570,147,2940
11,15,13,15.01.2025,14,470,625,155,2170
104,11,21,31.01.2025,1,252,323,71,71
602,7,4,04.01.2025,1,324,444,120,120
608,26,27,07.01.2025,19,84,112,28,532
263,12,14,16.01.2025,20,247,280,33,660
141,26,2,02.01.2025,5,179,235,56,280
526,21,25,12.01.2025,10,318,461,143,1430
795,5,5,16.01.2025,10,328,395,67,670
378,1,17,19.01.2025,5,49,57,8,40
839,27,18,28.01.2025,2,236,284,48,96
1000,7,21,30.01.2025,7,422,456,34,238
194,22,16,23.01.2025,15,327,445,118,1770
873,19,19,31.01.2025,11,335,397,62,682
337,6,4,15.01.2025,2,273,314,41,82
4,21,8,23.01.2025,8,258,343,85,680
245,16,24,25.01.2025,11,433,599,166,1826
211,13,6,27.01.2025,1,205,216,11,11
367,1,18,04.01.2025,5,168,210,42,210
647,19,30,25.01.2025,12,42,63,21,252
204,7,10,06.01.2025,8,473,552,79,632
179,11,28,18.01.2025,8,111,126,15,120
181,27,9,30.01.2025,4,30,43,13,52
141,13,21,26.01.2025,4,193,284,91,364
313,15,8,12.01.2025,12,358,404,46,552
540,26,20,29.01.2025,14,469,642,173,2422
122,5,29,30.01.2025,5,426,484,58,290
546,13,23,12.01.2025,11,326,405,79,869
652,8,30,02.01.2025,20,320,363,43,860
549,10,26,05.01.2025,11,146,157,11,121
815,9,28,05.01.2025,17,319,462,143,2431
215,24,3,26.01.2025,16,424,572,148,2368
67,6,17,13.01.2025,17,211,269,58,986
476,6,11,23.01.2025,12,289,394,105,1260
733,16,16,09.01.2025,19,225,301,76,1444
810,19,21,02.01.2025,7,132,192,60,420
463,28,8,13.01.2025,7,176,218,42,294
387,19,6,30.01.2025,12,150,195,45,540
138,25,3,10.01.2025,15,285,344,59,885
598,2,15,17.01.2025,20,192,238,46,920
479,14,14,12.01.2025,16,182,213,31,496
26,6,15,08.01.2025,9,350,379,29,261
924,3,10,27.01.2025,17,282,365,83,1411
81,26,9,30.01.2025,8,70,77,7,56
369,2,18,07.01.2025,11,120,162,42,462
257,10,24,27.01.2025,9,117,160,43,387
142,28,25,23.01.2025,18,487,569,82,1476
789,10,10,27.01.2025,12,420,629,209,2508
969,13,27,19.01.2025,1,261,351,90,90
780,5,28,13.01.2025,8,136,187,51,408
215,16,8,17.01.2025,19,422,548,126,2394
480,24,27,15.01.2025,11,425,463,38,418
867,7,14,25.01.2025,14,127,158,31,434
874,18,1,12.01.2025,5,315,455,140,700
313,24,1,16.01.2025,12,193,222,29,348
436,22,25,13.01.2025,18,173,207,34,612
24,19,26,02.01.2025,5,98,146,48,240
339,19,21,26.01.2025,20,487,645,158,3160
888,13,13,07.01.2025,13,52,67,15,195
193,16,4,11.01.2025,19,251,336,85,1615
312,3,6,04.01.2025,18,110,117,7,126
706,20,16,01.01.2025,6,121,131,10,60
987,13,10,07.01.2025,8,169,228,59,472
72,15,2,12.01.2025,17,25,28,3,51
881,30,14,13.01.2025,6,76,84,8,48
429,16,24,03.01.2025,13,482,694,212,2756
134,28,7,10.01.2025,14,438,600,162,2268
487,6,20,19.01.2025,10,320,365,45,450
734,22,15,09.01.2025,7,23,34,11,77
457,3,27,13.01.2025,20,433,503,70,1400
337,30,19,29.01.2025,16,255,321,66,1056
41,24,3,10.01.2025,15,197,269,72,1080
729,26,10,13.01.2025,20,441,624,183,3660
180,14,8,06.01.2025,20,395,492,97,1940
394,30,22,06.01.2025,19,68,83,15,285
969,2,8,29.01.2025,6,160,232,72,432
551,10,22,30.01.2025,3,377,519,142,426
924,7,30,16.01.2025,14,410,532,122,1708
378,3,25,04.01.2025,17,412,577,165,2805
420,15,6,09.01.2025,7,279,299,20,140
28,3,21,23.01.2025,15,215,259,44,660
409,28,7,13.01.2025,2,25,29,4,8
727,30,5,11.01.2025,15,268,337,69,1035
85,18,22,08.01.2025,15,91,115,24,360
286,27,6,06.01.2025,1,330,361,31,31
302,4,18,24.01.2025,13,106,115,9,117
782,1,22,09.01.2025,5,245,297,52,260
222,23,2,29.01.2025,18,130,162,32,576
49,27,21,26.01.2025,17,348,469,121,2057
676,29,4,13.01.2025,10,247,265,18,180
5,2,25,13.01.2025,7,495,575,80,560
931,8,7,03.01.2025,1,235,250,15,15
15,11,27,07.01.2025,3,132,196,64,192
99,26,27,27.01.2025,6,390,439,49,294
426,17,4,27.01.2025,11,185,241,56,616
195,20,7,30.01.2025,18,222,327,105,1890
124,8,7,04.01.2025,12,185,209,24,288
412,21,11,01.01.2025,13,128,161,33,429
68,22,27,09.01.2025,20,208,223,15,300
907,7,14,10.01.2025,20,275,410,135,2700
105,23,18,26.01.2025,19,107,124,17,323
98,20,11,21.01.2025,13,367,538,171,2223
790,23,5,11.01.2025,6,345,481,136,816
705,11,28,22.01.2025,16,54,65,11,176
624,30,19,15.01.2025,13,281,376,95,1235
239,17,19,23.01.2025,1,139,147,8,8
778,29,4,10.01.2025,8,397,493,96,768
250,20,3,02.01.2025,5,211,269,58,290
207,5,13,07.01.2025,2,141,207,66,132
613,15,24,29.01.2025,11,88,103,15,165
660,26,25,02.01.2025,17,425,633,208,3536
664,27,10,25.01.2025,1,137,196,59,59
340,11,8,07.01.2025,18,47,69,22,396
681,8,26,22.01.2025,8,331,478,147,1176
534,11,6,15.01.2025,1,53,76,23,23
72,7,2,21.01.2025,5,500,571,71,355
94,6,19,18.01.2025,7,140,179,39,273
437,24,15,10.01.2025,6,389,443,54,324
435,6,20,08.01.2025,10,166,217,51,510
991,21,7,09.01.2025,16,60,89,29,464
369,13,13,06.01.2025,16,245,304,59,944
625,24,14,25.01.2025,5,439,649,210,1050
494,1,25,13.01.2025,14,457,497,40,560
929,30,10,20.01.2025,18,98,127,29,522
180,9,13,15.01.2025,10,252,297,45,450
576,20,16,03.01.2025,11,89,122,33,363
201,5,30,07.01.2025,1,26,37,11,11
748,24,12,16.01.2025,13,493,610,117,1521
405,24,12,13.01.2025,16,177,237,60,960
603,3,14,29.01.2025,2,491,543,52,104
955,19,6,07.01.2025,14,150,210,60,840
770,24,12,17.01.2025,16,345,469,124,1984
714,2,21,13.01.2025,14,396,460,64,896
490,2,30,27.01.2025,12,343,469,126,1512
29,23,22,21.01.2025,5,153,202,49,245
967,22,5,09.01.2025,8,328,430,102,816
679,27,6,01.01.2025,4,414,452,38,152
729,30,13,13.01.2025,19,481,522,41,779
932,7,29,14.01.2025,6,444,551,107,642
709,10,17,31.01.2025,18,357,517,160,2880
601,10,24,14.01.2025,3,75,100,25,75
796,26,12,27.01.2025,5,157,218,61,305
953,24,13,23.01.2025,10,23,34,11,110
836,16,1,04.01.2025,3,416,567,151,453
538,14,21,10.01.2025,14,107,121,14,196
191,23,5,07.01.2025,16,113,144,31,496
113,15,19,27.01.2025,7,115,131,16,112
768,6,26,25.01.2025,7,152,227,75,525
893,14,15,21.01.2025,20,75,108,33,660
171,3,10,03.01.2025,13,83,97,14,182
351,1,19,08.01.2025,16,268,363,95,1520
104,1,2,09.01.2025,1,360,472,112,112
43,4,7,17.01.2025,1,212,280,68,68
986,25,9,30.01.2025,16,262,364,102,1632
619,14,11,12.01.2025,11,181,257,76,836
964,12,22,13.01.2025,13,332,357,25,325
365,28,11,26.01.2025,4,21,26,5,20
716,13,24,27.01.2025,5,33,44,11,55
890,17,9,31.01.2025,8,208,261,53,424
703,22,28,16.01.2025,17,231,311,80,1360
4,21,27,11.01.2025,1,344,417,73,73
47,26,24,11.01.2025,15,139,184,45,675
410,24,20,26.01.2025,3,198,246,48,144
954,30,16,22.01.2025,4,395,483,88,352
622,7,23,05.01.2025,17,468,612,144,2448
878,23,17,02.01.2025,5,274,386,112,560
309,27,22,18.01.2025,15,106,154,48,720
978,4,16,22.01.2025,18,143,166,23,414
175,25,22,23.01.2025,3,74,92,18,54
733,1,6,30.01.2025,11,482,589,107,1177
288,8,24,09.01.2025,16,479,647,168,2688
682,5,30,18.01.2025,16,66,93,27,432
341,28,8,30.01.2025,19,412,604,192,3648
67,21,11,13.01.2025,13,354,474,120,1560
576,28,14,26.01.2025,8,134,156,22,176
298,3,4,03.01.2025,11,399,525,126,1386
193,24,4,19.01.2025,12,85,122,37,444
977,13,19,24.01.2025,1,179,193,14,14
549,7,28,13.01.2025,14,183,256,73,1022
817,22,30,26.01.2025,5,286,386,100,500
605,8,4,13.01.2025,1,295,423,128,128
324,5,27,31.01.2025,10,448,515,67,670
697,15,5,20.01.2025,10,94,130,36,360
870,26,27,23.01.2025,2,326,389,63,126
515,23,4,09.01.2025,19,264,352,88,1672
221,16,10,23.01.2025,13,50,75,25,325
342,5,27,23.01.2025,7,454,626,172,1204
830,8,23,24.01.2025,2,492,708,216,432
184,28,16,24.01.2025,13,173,258,85,1105
676,30,28,06.01.2025,1,300,368,68,68
433,22,16,12.01.2025,13,220,238,18,234
745,10,10,23.01.2025,7,378,543,165,1155
404,4,5,11.01.2025,19,463,654,191,3629
871,30,23,10.01.2025,15,355,399,44,660
141,15,23,16.01.2025,10,479,534,55,550
224,26,24,07.01.2025,1,205,282,77,77
590,4,22,26.01.2025,5,212,313,101,505
438,22,27,06.01.2025,2,69,83,14,28
486,6,2,04.01.2025,17,352,423,71,1207
445,5,21,24.01.2025,13,145,154,9,117
247,13,16,10.01.2025,20,108,145,37,740
385,25,23,26.01.2025,3,418,526,108,324
838,21,13,09.01.2025,15,208,219,11,165
120,3,4,16.01.2025,17,135,143,8,136
587,19,16,09.01.2025,4,426,561,135,540
394,16,21,23.01.2025,14,172,225,53,742
102,11,3,23.01.2025,18,114,140,26,468
718,1,13,18.01.2025,18,421,596,175,3150
501,3,17,27.01.2025,19,295,405,110,2090
810,21,4,25.01.2025,7,357,519,162,1134
186,28,20,23.01.2025,6,22,29,7,42
820,11,4,02.01.2025,5,314,359,45,225
166,3,18,09.01.2025,2,63,94,31,62
519,10,12,31.01.2025,18,107,133,26,468
968,22,1,08.01.2025,10,43,63,20,200
532,29,26,10.01.2025,18,247,275,28,504
503,23,11,17.01.2025,12,330,426,96,1152
215,23,4,22.01.2025,2,141,150,9,18
146,10,28,27.01.2025,7,88,116,28,196
222,19,12,09.01.2025,5,393,523,130,650
77,18,9,09.01.2025,13,352,513,161,2093
410,15,3,31.01.2025,9,366,454,88,792
712,5,18,07.01.2025,3,342,472,130,390
649,23,21,07.01.2025,12,308,415,107,1284
841,17,20,06.01.2025,14,440,492,52,728
807,14,13,01.01.2025,20,146,158,12,240
128,18,4,22.01.2025,18,228,246,18,324
656,3,12,30.01.2025,11,418,490,72,792
890,26,8,09.01.2025,1,70,85,15,15
993,8,13,31.01.2025,4,420,616,196,784
180,17,24,29.01.2025,10,321,456,135,1350
502,4,17,12.01.2025,19,463,545,82,1558
278,20,4,29.01.2025,2,107,128,21,42
770,13,6,12.01.2025,18,302,398,96,1728
871,13,16,19.01.2025,5,152,160,8,40
526,23,5,22.01.2025,5,93,114,21,105
754,9,2,30.01.2025,12,382,535,153,1836
695,20,14,23.01.2025,15,113,141,28,420
363,26,15,17.01.2025,10,161,238,77,770
534,23,29,30.01.2025,8,176,235,59,472
90,10,14,25.01.2025,11,452,493,41,451
82,3,24,08.01.2025,3,104,136,32,96
87,24,10,18.01.2025,16,433,625,192,3072
986,14,22,17.01.2025,5,265,338,73,365
702,22,29,18.01.2025,4,227,240,13,52
195,30,27,24.01.2025,1,385,478,93,93
548,24,12,08.01.2025,17,370,490,120,2040
622,15,6,22.01.2025,17,482,555,73,1241
77,12,27,05.01.2025,17,200,296,96,1632
433,16,13,06.01.2025,12,77,93,16,192
696,8,27,18.01.2025,4,168,199,31,124
301,9,7,01.01.2025,19,221,254,33,627
313,30,30,31.01.2025,17,442,642,200,3400
958,15,29,20.01.2025,16,49,59,10,160
631,15,11,10.01.2025,12,74,78,4,48
912,24,6,13.01.2025,12,24,26,2,24
504,7,3,17.01.2025,17,480,537,57,969
127,30,16,01.01.2025,5,413,556,143,715
232,16,13,12.01.2025,10,206,256,50,500
187,18,26,09.01.2025,4,244,328,84,336
450,6,5,12.01.2025,14,22,27,5,70
892,23,7,04.01.2025,7,165,176,11,77
405,14,24,11.01.2025,2,102,138,36,72
972,16,22,09.01.2025,4,235,298,63,252
508,26,22,23.01.2025,5,186,258,72,360
800,29,13,17.01.2025,13,87,96,9,117
111,26,1,05.01.2025,5,196,250,54,270
786,22,8,02.01.2025,11,239,356,117,1287
756,1,14,16.01.2025,10,164,208,44,440
780,14,8,20.01.2025,5,393,503,110,550
256,9,25,04.01.2025,9,378,439,61,549
841,14,7,16.01.2025,4,378,521,143,572
626,6,7,28.01.2025,19,342,457,115,2185
235,4,5,13.01.2025,2,160,239,79,158
952,5,14,01.01.2025,20,122,133,11,220
53,13,14,17.01.2025,10,378,505,127,1270
237,8,11,14.01.2025,16,51,65,14,224
660,2,10,04.01.2025,9,206,242,36,324
360,23,14,08.01.2025,11,478,512,34,374
42,1,2,22.01.2025,11,128,151,23,253
287,30,20,04.01.2025,14,114,133,19,266
504,12,11,10.01.2025,4,69,93,24,96
700,18,25,28.01.2025,5,189,229,40,200
830,12,24,25.01.2025,19,290,383,93,1767
244,21,9,07.01.2025,19,216,235,19,361
109,5,21,24.01.2025,20,81,87,6,120
992,30,29,21.01.2025,7,118,161,43,301
948,4,3,31.01.2025,18,336,405,69,1242
743,16,25,07.01.2025,18,389,435,46,828
131,7,14,18.01.2025,9,476,688,212,1908
874,28,30,18.01.2025,12,478,581,103,1236
645,23,4,30.01.2025,14,54,68,14,196
537,30,17,26.01.2025,1,105,139,34,34
714,5,10,02.01.2025,19,51,72,21,399
711,7,24,27.01.2025,13,273,371,98,1274
892,17,3,06.01.2025,15,404,517,113,1695
576,25,13,13.01.2025,20,159,182,23,460
4,6,19,07.01.2025,19,376,396,20,380
951,26,17,15.01.2025,17,382,525,143,2431
266,10,28,08.01.2025,10,382,447,65,650
122,6,8,02.01.2025,18,141,167,26,468
655,5,29,09.01.2025,5,158,228,70,350
53,21,8,27.01.2025,7,293,323,30,210
665,12,21,20.01.2025,12,186,202,16,192
723,29,18,09.01.2025,5,229,333,104,520
302,11,2,21.01.2025,1,441,534,93,93
749,9,6,09.01.2025,1,295,397,102,102
889,25,25,19.01.2025,4,389,539,150,600
392,21,9,28.01.2025,20,302,345,43,860
453,8,11,09.01.2025,7,317,423,106,742
879,25,13,05.01.2025,15,138,190,52,780
445,12,5,29.01.2025,16,67,85,18,288
471,6,27,28.01.2025,6,116,152,36,216
966,24,6,21.01.2025,10,30,36,6,60
907,6,27,13.01.2025,20,116,125,9,180
74,14,8,15.01.2025,13,71,98,27,351
141,24,25,26.01.2025,1,328,359,31,31
394,1,4,27.01.2025,1,410,584,174,174
958,2,5,08.01.2025,3,157,175,18,54
643,20,1,26.01.2025,1,425,467,42,42
754,27,11,28.01.2025,3,123,137,14,42
778,19,29,15.01.2025,6,177,212,35,210
159,8,2,18.01.2025,9,341,441,100,900
22,27,2,04.01.2025,18,171,187,16,288
908,27,14,05.01.2025,1,487,561,74,74
233,14,13,05.01.2025,12,355,419,64,768
944,29,22,13.01.2025,4,271,305,34,136
113,8,4,31.01.2025,10,202,219,17,170
342,4,12,30.01.2025,3,478,511,33,99
155,6,14,17.01.2025,11,327,370,43,473
436,5,29,22.01.2025,10,339,481,142,1420
357,29,4,09.01.2025,16,358,435,77,1232
272,26,30,23.01.2025,3,423,445,22,66
956,5,25,21.01.2025,5,183,204,21,105
458,24,26,26.01.2025,16,437,472,35,560
592,14,24,09.01.2025,5,66,79,13,65
131,6,25,13.01.2025,12,183,233,50,600
493,23,14,20.01.2025,11,90,127,37,407
670,30,8,13.01.2025,14,301,383,82,1148
547,16,18,18.01.2025,8,216,235,19,152
733,14,17,19.01.2025,8,379,413,34,272
371,1,7,28.01.2025,1,205,267,62,62
981,5,30,04.01.2025,2,486,587,101,202
870,28,28,25.01.2025,5,170,214,44,220
856,28,18,30.01.2025,14,144,165,21,294
230,2,24,05.01.2025,4,376,514,138,552
387,24,1,23.01.2025,14,210,226,16,224
109,22,19,03.01.2025,16,448,590,142,2272
162,1,5,12.01.2025,5,60,70,10,50
13,19,27,27.01.2025,14,96,134,38,532
482,24,5,24.01.2025,17,377,557,180,3060
482,14,24,11.01.2025,15,420,563,143,2145
14,10,4,05.01.2025,2,471,631,160,320
619,25,6,17.01.2025,6,25,31,6,36
434,22,29,15.01.2025,18,384,547,163,2934
942,19,17,10.01.2025,8,236,347,111,888
279,3,17,13.01.2025,5,400,458,58,290
634,2,8,13.01.2025,6,441,611,170,1020
573,20,27,03.01.2025,15,264,314,50,750
658,13,27,13.01.2025,6,47,66,19,114
663,14,7,09.01.2025,4,73,79,6,24
618,25,28,11.01.2025,1,142,167,25,25
555,4,3,07.01.2025,20,25,35,10,200
317,7,18,07.01.2025,2,143,167,24,48
584,19,2,19.01.2025,16,43,46,3,48
96,10,1,12.01.2025,10,223,284,61,610
323,25,13,24.01.2025,12,86,117,31,372
100,11,14,29.01.2025,17,71,91,20,340
794,5,1,19.01.2025,13,264,347,83,1079
873,2,10,06.01.2025,5,369,464,95,475
907,21,3,31.01.2025,8,472,541,69,552
698,21,5,25.01.2025,6,276,354,78,468
747,20,21,17.01.2025,11,249,349,100,1100
348,10,12,20.01.2025,14,40,58,18,252
793,22,13,08.01.2025,7,332,439,107,749
982,5,19,21.01.2025,16,69,97,28,448
147,25,28,10.01.2025,18,464,690,226,4068
801,29,3,16.01.2025,4,252,300,48,192
957,10,6,03.01.2025,9,315,382,67,603
92,3,6,23.01.2025,15,152,227,75,1125
263,25,29,15.01.2025,5,83,123,40,200
500,2,12,28.01.2025,10,225,278,53,530
635,30,22,05.01.2025,15,207,265,58,870
640,11,12,03.01.2025,14,279,349,70,980
899,29,22,02.01.2025,20,349,375,26,520
810,8,23,27.01.2025,18,24,27,3,54
108,10,13,06.01.2025,19,224,321,97,1843
229,13,28,15.01.2025,3,198,249,51,153
658,18,29,27.01.2025,15,75,82,7,105
750,4,30,31.01.2025,13,413,514,101,1313
412,11,3,11.01.2025,11,329,417,88,968
720,24,16,04.01.2025,9,252,269,17,153
160,16,5,21.01.2025,7,183,239,56,392
616,25,13,02.01.2025,12,424,527,103,1236
485,7,2,07.01.2025,1,408,554,146,146
277,9,21,06.01.2025,3,92,99,7,21
415,3,10,28.01.2025,15,466,577,111,1665
220,22,29,09.01.2025,6,445,478,33,198
917,29,14,11.01.2025,10,104,118,14,140
965,14,16,16.01.2025,18,372,522,150,2700
989,23,14,12.01.2025,19,219,311,92,1748
575,26,29,20.01.2025,7,59,81,22,154
593,20,5,11.01.2025,11,27,30,3,33
470,30,5,16.01.2025,11,78,110,32,352
691,14,9,17.01.2025,1,250,369,119,119
878,5,21,15.01.2025,19,69,74,5,95
764,7,14,23.01.2025,18,416,468,52,936
387,7,12,07.01.2025,7,367,481,114,798
15,12,27,12.01.2025,1,174,253,79,79
515,27,28,04.01.2025,16,352,528,176,2816
424,14,12,12.01.2025,18,238,306,68,1224
784,11,4,30.01.2025,6,254,316,62,372
182,18,20,06.01.2025,18,243,297,54,972
866,22,23,22.01.2025,14,344,405,61,854
636,30,29,28.01.2025,4,64,90,26,104
107,3,21,01.01.2025,20,497,614,117,2340
509,24,25,20.01.2025,18,71,95,24,432
516,19,26,02.01.2025,10,456,565,109,1090
229,25,15,18.01.2025,13,78,89,11,143
481,4,12,31.01.2025,15,231,337,106,1590
661,23,26,24.01.2025,13,23,34,11,143
801,8,17,10.01.2025,9,470,633,163,1467
315,27,29,26.01.2025,14,364,422,58,812
922,30,14,02.01.2025,1,33,37,4,4
384,27,27,17.01.2025,20,182,219,37,740
983,19,14,08.01.2025,18,220,250,30,540
660,13,27,02.01.2025,19,239,265,26,494
652,13,24,06.01.2025,13,482,575,93,1209
163,14,8,04.01.2025,5,278,307,29,145
591,26,13,27.01.2025,9,448,582,134,1206
972,11,7,03.01.2025,3,33,41,8,24
644,25,19,05.01.2025,1,336,460,124,124
943,3,19,13.01.2025,1,400,552,152,152
465,21,21,25.01.2025,12,115,133,18,216
920,8,10,07.01.2025,18,450,522,72,1296
799,26,26,13.01.2025,9,357,383,26,234
85,30,5,21.01.2025,1,346,517,171,171
888,4,4,15.01.2025,20,82,90,8,160
290,9,29,06.01.2025,3,59,75,16,48
371,30,27,07.01.2025,13,71,90,19,247
23,14,3,16.01.2025,3,127,173,46,138
385,29,11,21.01.2025,15,433,486,53,795
306,1,29,06.01.2025,19,343,454,111,2109
33,4,11,12.01.2025,16,334,441,107,1712
6,6,17,24.01.2025,9,494,546,52,468
621,1,18,01.01.2025,17,282,393,111,1887
222,28,12,04.01.2025,7,35,42,7,49
226,3,24,23.01.2025,5,157,184,27,135
205,3,12,23.01.2025,18,353,417,64,1152
764,26,16,14.01.2025,17,224,328,104,1768
257,6,7,22.01.2025,9,221,242,21,189
813,25,19,10.01.2025,6,426,487,61,366
740,16,14,29.01.2025,15,236,311,75,1125
279,27,11,20.01.2025,4,330,403,73,292
205,19,12,12.01.2025,3,250,281,31,93
35,17,9,19.01.2025,14,170,225,55,770
899,21,17,12.01.2025,13,35,39,4,52
829,11,14,26.01.2025,6,203,236,33,198
221,22,12,12.01.2025,5,419,499,80,400
10,11,23,01.01.2025,11,129,162,33,363
815,11,29,08.01.2025,18,53,65,12,216
617,7,17,07.01.2025,4,307,361,54,216
623,29,26,28.01.2025,3,313,454,141,423
432,22,25,14.01.2025,11,436,521,85,935
202,2,26,16.01.2025,16,43,64,21,336
432,4,4,15.01.2025,6,327,391,64,384
393,8,19,01.01.2025,10,29,39,10,100
877,19,1,30.01.2025,15,165,183,18,270
991,13,2,29.01.2025,18,490,631,141,2538
346,21,1,03.01.2025,16,68,97,29,464
426,24,10,09.01.2025,11,405,488,83,913
82,18,25,11.01.2025,16,333,357,24,384
306,23,15,16.01.2025,4,451,549,98,392
633,4,1,08.01.2025,2,442,466,24,48
108,11,28,23.01.2025,14,135,152,17,238
196,24,29,26.01.2025,12,437,636,199,2388
6,30,23,28.01.2025,2,152,220,68,136
45,4,2,31.01.2025,10,58,68,10,100
705,20,26,26.01.2025,13,158,216,58,754
948,5,19,15.01.2025,4,84,100,16,64
152,25,19,29.01.2025,14,346,433,87,1218
126,17,17,08.01.2025,19,264,356,92,1748
1000,9,11,25.01.2025,16,135,147,12,192
785,10,23,03.01.2025,12,305,435,130,1560
249,22,21,24.01.2025,7,375,407,32,224
996,16,2,07.01.2025,1,363,416,53,53
839,13,7,16.01.2025,4,194,222,28,112
605,25,17,17.01.2025,11,409,603,194,2134
726,15,21,05.01.2025,17,74,108,34,578
225,30,12,13.01.2025,15,464,617,153,2295
208,25,13,07.01.2025,3,162,201,39,117
703,10,28,19.01.2025,4,95,119,24,96
110,24,4,08.01.2025,1,477,600,123,123
274,1,16,22.01.2025,17,251,303,52,884
122,30,18,03.01.2025,12,240,275,35,420
407,17,14,17.01.2025,11,47,59,12,132
379,4,2,21.01.2025,13,394,578,184,2392
199,10,7,13.01.2025,6,324,380,56,336
623,16,17,14.01.2025,4,368,395,27,108
255,4,8,04.01.2025,2,478,510,32,64
273,8,3,18.01.2025,4,161,185,24,96
636,23,23,13.01.2025,13,221,242,21,273
752,27,29,23.01.2025,9,273,312,39,351
805,7,12,21.01.2025,10,381,502,121,1210
752,1,4,06.01.2025,17,484,661,177,3009
489,24,10,28.01.2025,8,107,128,21,168
72,6,6,11.01.2025,15,92,136,44,660
683,16,14,11.01.2025,1,110,164,54,54
903,3,6,22.01.2025,1,324,392,68,68
486,19,1,16.01.2025,8,261,287,26,208
839,1,19,22.01.2025,10,447,515,68,680
516,6,25,05.01.2025,4,71,84,13,52
754,11,15,16.01.2025,12,299,349,50,600
499,9,12,15.01.2025,1,443,535,92,92
728,11,29,17.01.2025,20,267,294,27,540
703,17,24,21.01.2025,1,95,142,47,47
877,8,22,05.01.2025,12,274,292,18,216
592,24,23,14.01.2025,12,125,173,48,576
199,30,13,21.01.2025,4,160,231,71,284
696,18,29,30.01.2025,15,468,602,134,2010
272,30,22,12.01.2025,11,220,289,69,759
968,9,10,07.01.2025,2,316,406,90,180
352,27,20,04.01.2025,14,427,536,109,1526
992,26,26,12.01.2025,10,76,113,37,370
511,30,22,05.01.2025,15,368,411,43,645
990,10,20,18.01.2025,6,175,222,47,282
67,26,10,01.01.2025,15,40,46,6,90
846,19,4,02.01.2025,16,176,185,9,144
361,22,27,01.01.2025,2,148,165,17,34
900,10,26,28.01.2025,17,360,533,173,2941
575,5,3,23.01.2025,9,93,139,46,414
202,14,19,30.01.2025,3,168,193,25,75
485,30,12,08.01.2025,13,236,290,54,702
926,4,29,09.01.2025,10,325,387,62,620
578,14,22,29.01.2025,11,431,565,134,1474
700,25,7,09.01.2025,5,233,303,70,350
309,10,3,10.01.2025,19,494,658,164,3116
559,6,13,26.01.2025,14,69,77,8,112
453,23,11,17.01.2025,12,259,313,54,648
478,14,14,15.01.2025,1,487,634,147,147
981,25,14,03.01.2025,5,334,487,153,765
806,8,19,17.01.2025,12,85,113,28,336
922,19,29,10.01.2025,2,406,581,175,350
129,13,22,01.01.2025,15,433,603,170,2550
531,15,27,02.01.2025,3,48,56,8,24
666,4,11,20.01.2025,4,440,520,80,320
494,23,11,28.01.2025,2,82,113,31,62
691,17,24,23.01.2025,2,379,433,54,108
148,18,24,31.01.2025,16,89,102,13,208
692,21,28,05.01.2025,10,341,406,65,650
960,1,26,16.01.2025,20,372,424,52,1040
69,1,5,20.01.2025,4,286,313,27,108
210,4,16,01.01.2025,17,247,303,56,952
949,4,10,13.01.2025,16,114,162,48,768
862,28,18,09.01.2025,20,368,459,91,1820
674,20,4,14.01.2025,5,345,366,21,105
146,27,24,22.01.2025,8,107,137,30,240
717,18,7,16.01.2025,16,168,198,30,480
103,19,16,12.01.2025,9,220,269,49,441
820,4,15,14.01.2025,14,95,101,6,84
469,4,19,13.01.2025,1,317,376,59,59
661,21,29,22.01.2025,20,247,264,17,340
929,12,5,15.01.2025,15,161,170,9,135
163,12,17,28.01.2025,17,127,153,26,442
724,17,13,17.01.2025,3,109,147,38,114
361,21,24,19.01.2025,11,255,350,95,1045
806,5,9,26.01.2025,10,492,604,112,1120
939,27,21,16.01.2025,13,261,345,84,1092
185,19,23,30.01.2025,17,417,561,144,2448
266,5,23,11.01.2025,19,317,383,66,1254
633,27,13,03.01.2025,2,35,50,15,30
163,8,4,22.01.2025,4,275,404,129,516
488,11,25,08.01.2025,8,73,106,33,264
179,24,29,13.01.2025,14,492,531,39,546
627,9,4,02.01.2025,3,246,343,97,291
622,21,27,01.01.2025,6,184,202,18,108
461,13,5,21.01.2025,19,304,347,43,817
259,16,15,22.01.2025,10,135,154,19,190
166,14,27,17.01.2025,7,64,84,20,140
645,22,4,07.01.2025,2,434,483,49,98
6,12,25,14.01.2025,19,299,430,131,2489
349,6,22,24.01.2025,17,274,311,37,629
213,19,27,16.01.2025,17,200,242,42,714
922,18,28,05.01.2025,3,244,303,59,177
386,28,3,19.01.2025,3,85,119,34,102
306,4,4,16.01.2025,8,46,61,15,120
339,1,8,27.01.2025,10,492,700,208,2080
400,23,12,03.01.2025,6,167,181,14,84
590,8,28,17.01.2025,20,276,329,53,1060
634,2,18,23.01.2025,4,318,401,83,332
940,9,21,01.01.2025,2,193,239,46,92
206,11,29,25.01.2025,2,91,104,13,26
837,24,11,30.01.2025,2,140,178,38,76
825,19,29,20.01.2025,2,197,294,97,194
973,14,20,24.01.2025,20,495,538,43,860
565,16,5,09.01.2025,2,73,78,5,10
520,8,21,12.01.2025,14,264,313,49,686
871,29,8,01.01.2025,2,33,46,13,26
831,7,18,20.01.2025,13,369,501,132,1716
19,18,16,02.01.2025,13,412,503,91,1183
129,14,23,14.01.2025,18,90,99,9,162
121,29,20,29.01.2025,12,200,227,27,324
448,30,2,08.01.2025,8,67,88,21,168
233,14,24,25.01.2025,18,310,332,22,396
822,1,28,24.01.2025,8,436,469,33,264
59,5,15,06.01.2025,10,42,50,8,80
617,21,29,08.01.2025,10,86,114,28,280
491,22,4,22.01.2025,3,59,69,10,30
557,7,16,23.01.2025,12,479,700,221,2652
226,15,23,10.01.2025,12,419,544,125,1500
890,21,8,17.01.2025,9,183,250,67,603
516,4,2,12.01.2025,14,381,563,182,2548
498,9,3,07.01.2025,5,450,670,220,1100
237,10,24,18.01.2025,7,82,100,18,126
836,26,5,02.01.2025,8,377,471,94,752
783,15,4,01.01.2025,16,448,477,29,464
285,19,13,10.01.2025,3,50,59,9,27
625,13,16,01.01.2025,13,216,270,54,702
230,7,13,06.01.2025,14,292,313,21,294
313,2,18,25.01.2025,12,499,530,31,372
624,25,29,11.01.2025,9,434,603,169,1521
222,25,1,11.01.2025,20,242,348,106,2120
802,24,30,24.01.2025,2,433,476,43,86
398,24,30,22.01.2025,10,459,687,228,2280
548,15,14,19.01.2025,19,413,530,117,2223
167,13,15,24.01.2025,8,87,127,40,320
288,26,22,31.01.2025,9,63,94,31,279
790,18,10,11.01.2025,19,222,237,15,285
281,12,9,22.01.2025,9,420,564,144,1296
791,20,1,04.01.2025,10,311,419,108,1080
857,9,28,06.01.2025,15,256,271,15,225
10,15,2,31.01.2025,12,265,354,89,1068
570,7,14,02.01.2025,19,500,543,43,817
919,20,18,11.01.2025,3,245,277,32,96
785,26,9,09.01.2025,16,85,98,13,208
179,5,28,20.01.2025,2,139,153,14,28
40,6,22,17.01.2025,15,316,377,61,915
567,23,8,02.01.2025,9,151,160,9,81
866,28,28,12.01.2025,18,387,414,27,486
241,12,4,03.01.2025,17,247,272,25,425
80,8,7,11.01.2025,19,210,299,89,1691
698,14,3,21.01.2025,14,468,551,83,1162
26,11,20,26.01.2025,12,191,284,93,1116
919,21,12,16.01.2025,10,338,360,22,220
378,2,10,30.01.2025,5,486,640,154,770
109,20,7,26.01.2025,11,281,386,105,1155
760,17,26,19.01.2025,12,130,159,29,348
597,2,22,24.01.2025,5,215,300,85,425
665,3,3,31.01.2025,8,309,394,85,680
589,21,18,24.01.2025,14,295,407,112,1568
868,29,17,26.01.2025,2,330,417,87,174
538,17,15,11.01.2025,9,119,170,51,459
301,30,8,11.01.2025,8,429,599,170,1360
371,8,15,11.01.2025,4,374,433,59,236
751,29,14,12.01.2025,3,200,260,60,180
79,30,12,21.01.2025,16,329,380,51,816
806,14,8,19.01.2025,5,493,637,144,720
796,30,14,22.01.2025,19,360,400,40,760
267,26,10,11.01.2025,11,80,87,7,77
432,17,5,19.01.2025,16,343,496,153,2448
203,29,6,29.01.2025,15,27,30,3,45
429,9,25,18.01.2025,16,400,438,38,608
891,2,27,14.01.2025,1,373,420,47,47
75,5,17,28.01.2025,17,490,600,110,1870
433,12,5,13.01.2025,18,143,196,53,954
122,11,29,27.01.2025,11,322,426,104,1144
111,24,2,03.01.2025,12,249,363,114,1368
646,15,24,27.01.2025,14,168,234,66,924
717,5,24,06.01.2025,19,489,694,205,3895
522,3,5,29.01.2025,1,323,425,102,102
691,21,15,13.01.2025,11,244,276,32,352
740,19,9,31.01.2025,4,138,163,25,100
350,2,19,17.01.2025,17,316,404,88,1496
951,14,10,11.01.2025,13,183,255,72,936
977,5,2,27.01.2025,7,240,308,68,476
589,29,20,11.01.2025,4,197,232,35,140
122,10,9,16.01.2025,15,134,194,60,900
296,30,9,20.01.2025,4,493,569,76,304
286,5,4,07.01.2025,18,449,574,125,2250
173,1,20,29.01.2025,2,476,615,139,278
819,7,1,16.01.2025,1,209,239,30,30
965,19,14,24.01.2025,15,286,317,31,465
465,10,30,04.01.2025,4,247,358,111,444
506,9,3,28.01.2025,5,162,223,61,305
120,12,26,03.01.2025,8,392,425,33,264
161,17,11,09.01.2025,15,342,472,130,1950
689,25,3,23.01.2025,11,476,698,222,2442
444,4,30,23.01.2025,17,182,207,25,425
572,22,27,29.01.2025,2,344,458,114,228
252,5,19,13.01.2025,8,364,414,50,400
482,5,16,27.01.2025,6,395,503,108,648
135,7,21,29.01.2025,3,284,408,124,372
768,7,1,14.01.2025,3,271,353,82,246
214,23,6,02.01.2025,14,372,435,63,882
390,21,19,08.01.2025,12,267,344,77,924
978,6,29,10.01.2025,8,468,553,85,680
497,16,26,21.01.2025,13,326,395,69,897
493,10,4,08.01.2025,4,471,685,214,856
783,10,14,15.01.2025,11,146,197,51,561
119,6,15,31.01.2025,11,358,394,36,396
714,13,23,05.01.2025,16,450,635,185,2960
501,20,14,22.01.2025,8,34,40,6,48
520,7,29,28.01.2025,14,51,66,15,210
331,9,22,11.01.2025,14,220,311,91,1274
436,13,9,30.01.2025,2,157,199,42,84
225,11,21,27.01.2025,2,177,222,45,90
227,19,29,06.01.2025,18,125,175,50,900
113,20,20,11.01.2025,5,329,425,96,480
974,24,1,26.01.2025,13,66,92,26,338
342,30,12,25.01.2025,18,52,70,18,324
532,7,12,18.01.2025,7,100,143,43,301
406,28,23,08.01.2025,10,430,483,53,530
383,11,14,07.01.2025,18,395,459,64,1152
14,2,28,01.01.2025,17,72,92,20,340
811,16,2,06.01.2025,10,174,185,11,110
647,25,23,08.01.2025,2,159,221,62,124
833,26,13,21.01.2025,13,87,123,36,468
898,9,28,03.01.2025,3,57,73,16,48
721,25,24,14.01.2025,1,27,37,10,10
555,20,30,05.01.2025,4,396,521,125,500
401,7,27,20.01.2025,10,421,503,82,820
525,24,1,10.01.2025,9,254,290,36,324
271,21,19,16.01.2025,13,169,210,41,533
228,14,18,09.01.2025,16,165,241,76,1216
547,17,8,13.01.2025,1,274,377,103,103
975,12,25,18.01.2025,4,251,289,38,152
999,1,13,25.01.2025,8,248,302,54,432
577,4,21,10.01.2025,11,93,132,39,429
1000,3,4,18.01.2025,6,126,181,55,330
502,19,8,03.01.2025,5,226,300,74,370
485,17,24,27.01.2025,19,409,472,63,1197
786,16,9,14.01.2025,10,399,480,81,810
155,2,11,23.01.2025,19,326,402,76,1444
6,9,23,07.01.2025,18,426,541,115,2070
512,11,21,08.01.2025,11,256,350,94,1034
527,18,28,24.01.2025,3,491,539,48,144
717,3,13,05.01.2025,1,102,131,29,29
125,6,7,15.01.2025,4,39,56,17,68
508,6,21,26.01.2025,17,269,299,30,510
896,18,14,13.01.2025,1,171,189,18,18
302,24,30,29.01.2025,9,287,343,56,504
911,12,19,21.01.2025,6,92,109,17,102
702,7,26,20.01.2025,12,285,377,92,1104
484,15,7,30.01.2025,11,494,685,191,2101
873,30,5,06.01.2025,17,386,549,163,2771
11,11,14,06.01.2025,5,260,281,21,105
6,10,23,07.01.2025,7,375,410,35,245
470,11,4,02.01.2025,20,259,341,82,1640
69,12,21,18.01.2025,8,196,261,65,520
951,7,9,10.01.2025,14,319,440,121,1694
377,20,25,13.01.2025,9,307,397,90,810
676,7,3,19.01.2025,5,72,99,27,135
287,6,9,19.01.2025,4,84,118,34,136
602,21,25,13.01.2025,11,314,439,125,1375
607,20,9,31.01.2025,20,362,528,166,3320
215,6,1,26.01.2025,8,130,142,12,96
823,20,5,05.01.2025,6,263,380,117,702
332,3,29,02.01.2025,5,281,397,116,580
436,22,16,11.01.2025,10,276,384,108,1080
247,18,13,13.01.2025,13,381,481,100,1300
320,27,17,11.01.2025,17,60,87,27,459
863,7,6,31.01.2025,9,384,428,44,396
448,18,15,16.01.2025,9,370,409,39,351
922,14,21,12.01.2025,6,32,46,14,84
876,15,25,22.01.2025,12,392,486,94,1128
632,18,29,30.01.2025,7,215,262,47,329
956,24,1,07.01.2025,15,204,262,58,870
6,19,10,11.01.2025,4,486,591,105,420
260,17,30,01.01.2025,20,159,169,10,200
282,21,16,13.01.2025,2,376,514,138,276
281,21,2,19.01.2025,1,461,633,172,172
483,20,21,15.01.2025,16,108,136,28,448
896,21,25,18.01.2025,4,39,47,8,32
628,29,23,05.01.2025,6,465,666,201,1206
85,14,27,28.01.2025,4,48,60,12,48
728,2,11,04.01.2025,18,162,242,80,1440
199,21,20,24.01.2025,1,190,271,81,81
869,29,11,29.01.2025,6,483,722,239,1434
740,12,17,01.01.2025,13,233,332,99,1287
686,2,3,07.01.2025,17,95,131,36,612
86,6,15,02.01.2025,9,331,377,46,414
518,14,6,21.01.2025,1,179,210,31,31
360,4,11,15.01.2025,19,448,611,163,3097
580,30,15,03.01.2025,4,490,534,44,176
748,3,6,11.01.2025,19,340,505,165,3135
786,6,26,01.01.2025,7,346,422,76,532
84,29,24,31.01.2025,8,177,253,76,608
658,29,28,07.01.2025,5,178,191,13,65
723,10,6,09.01.2025,5,309,368,59,295
232,27,7,09.01.2025,7,110,164,54,378
266,23,15,09.01.2025,3,270,327,57,171
373,12,25,21.01.2025,17,250,356,106,1802
704,27,6,02.01.2025,19,217,243,26,494
583,7,23,14.01.2025,12,350,495,145,1740
816,10,7,11.01.2025,17,302,430,128,2176
814,9,3,17.01.2025,7,152,175,23,161
268,2,30,04.01.2025,17,357,476,119,2023
487,5,15,19.01.2025,11,210,274,64,704
675,19,29,02.01.2025,11,379,416,37,407
368,28,29,01.01.2025,6,235,297,62,372
345,21,29,04.01.2025,6,487,590,103,618
167,15,18,06.01.2025,1,244,345,101,101
468,19,19,23.01.2025,14,394,485,91,1274
855,8,9,24.01.2025,12,327,393,66,792
695,13,10,02.01.2025,8,410,603,193,1544
950,17,4,14.01.2025,14,416,487,71,994
592,13,19,01.01.2025,6,282,317,35,210
308,29,20,31.01.2025,17,121,179,58,986
582,25,5,05.01.2025,11,423,627,204,2244
994,3,10,26.01.2025,5,430,518,88,440
406,6,15,01.01.2025,5,122,177,55,275
309,10,3,06.01.2025,8,459,524,65,520
93,24,8,05.01.2025,18,452,632,180,3240
6,16,6,12.01.2025,4,261,339,78,312
404,23,7,30.01.2025,16,362,441,79,1264
475,23,8,25.01.2025,4,218,242,24,96
782,30,5,13.01.2025,11,479,564,85,935
691,24,28,14.01.2025,20,221,285,64,1280
356,16,22,24.01.2025,19,33,38,5,95
624,6,25,08.01.2025,12,205,247,42,504
843,1,20,20.01.2025,13,488,529,41,533
236,5,16,07.01.2025,2,128,152,24,48
96,11,13,21.01.2025,6,237,265,28,168
319,13,22,27.01.2025,16,37,43,6,96
978,14,6,06.01.2025,13,369,473,104,1352
109,15,26,03.01.2025,12,371,512,141,1692
672,28,13,26.01.2025,1,102,122,20,20
589,17,13,22.01.2025,15,25,32,7,105
983,22,13,14.01.2025,2,175,217,42,84
760,21,4,20.01.2025,15,277,337,60,900
485,23,11,28.01.2025,18,206,227,21,378
184,14,18,25.01.2025,13,465,629,164,2132
154,1,11,31.01.2025,19,152,173,21,399
833,20,24,28.01.2025,15,242,259,17,255
289,2,4,28.01.2025,16,255,310,55,880
911,20,22,12.01.2025,9,237,285,48,432
304,25,27,01.01.2025,18,156,176,20,360
366,14,1,15.01.2025,11,172,230,58,638
611,4,12,24.01.2025,2,292,404,112,224
255,6,3,18.01.2025,4,84,116,32,128
649,16,14,29.01.2025,9,196,292,96,864
706,20,8,30.01.2025,17,311,391,80,1360
79,11,12,02.01.2025,5,331,493,162,810
654,26,29,04.01.2025,13,282,420,138,1794
81,11,30,21.01.2025,10,236,290,54,540
189,24,9,24.01.2025,3,448,654,206,618
989,4,26,07.01.2025,19,153,229,76,1444
631,17,18,28.01.2025,8,375,529,154,1232
384,19,16,07.01.2025,14,160,222,62,868
797,6,9,17.01.2025,2,329,404,75,150
186,22,10,09.01.2025,1,228,261,33,33
801,14,22,05.01.2025,9,156,196,40,360
810,21,11,04.01.2025,8,135,143,8,64
333,8,3,20.01.2025,10,392,537,145,1450
847,15,19,14.01.2025,20,188,243,55,1100
488,30,18,01.01.2025,11,194,232,38,418
843,15,5,15.01.2025,16,127,164,37,592
175,22,13,09.01.2025,13,36,49,13,169
586,3,21,16.01.2025,18,196,213,17,306
766,17,12,10.01.2025,10,404,482,78,780
691,15,1,05.01.2025,20,319,359,40,800
361,19,14,14.01.2025,1,404,601,197,197
570,24,16,08.01.2025,13,491,634,143,1859
388,20,28,04.01.2025,4,222,255,33,132
114,19,10,06.01.2025,6,412,577,165,990
753,13,18,14.01.2025,12,404,464,60,720
923,20,9,11.01.2025,12,342,375,33,396
906,22,21,25.01.2025,11,277,358,81,891
402,8,28,13.01.2025,16,407,512,105,1680
846,30,15,06.01.2025,6,224,264,40,240
546,27,11,25.01.2025,15,355,400,45,675
930,4,13,19.01.2025,14,234,289,55,770
652,1,20,08.01.2025,5,332,441,109,545
83,20,19,24.01.2025,14,31,37,6,84
256,6,19,21.01.2025,16,370,404,34,544
380,1,24,20.01.2025,13,302,387,85,1105
198,28,30,06.01.2025,15,208,286,78,1170
246,6,16,30.01.2025,7,185,205,20,140
67,29,1,07.01.2025,19,256,322,66,1254
701,20,15,08.01.2025,6,256,326,70,420
114,26,20,27.01.2025,11,466,682,216,2376
164,8,15,24.01.2025,3,23,32,9,27
699,22,14,28.01.2025,17,260,374,114,1938
73,26,14,31.01.2025,9,472,648,176,1584
124,23,25,20.01.2025,18,385,408,23,414
493,27,24,02.01.2025,10,435,535,100,1000
843,24,25,02.01.2025,12,224,307,83,996
524,21,21,15.01.2025,14,423,468,45,630
150,28,9,25.01.2025,19,405,570,165,3135
740,6,12,14.01.2025,11,92,134,42,462
815,16,7,09.01.2025,4,188,252,64,256
76,15,29,23.01.2025,16,405,470,65,1040
267,11,10,23.01.2025,15,189,265,76,1140
717,9,19,09.01.2025,20,38,53,15,300
152,17,10,01.01.2025,8,470,572,102,816
372,23,10,10.01.2025,6,310,414,104,624
487,23,15,22.01.2025,10,99,137,38,380
712,5,5,20.01.2025,10,459,561,102,1020
653,8,1,28.01.2025,7,318,377,59,413
599,1,9,12.01.2025,17,401,578,177,3009
530,13,16,20.01.2025,6,196,263,67,402
602,28,17,11.01.2025,17,211,257,46,782
949,16,21,06.01.2025,17,266,300,34,578
919,13,1,22.01.2025,3,195,224,29,87
212,8,5,09.01.2025,20,418,576,158,3160
123,21,7,12.01.2025,16,255,333,78,1248
654,30,1,27.01.2025,17,479,552,73,1241
208,12,22,02.01.2025,13,340,372,32,416
338,17,3,09.01.2025,18,293,419,126,2268
551,28,3,26.01.2025,2,248,324,76,152
254,8,9,26.01.2025,6,373,549,176,1056
879,8,8,23.01.2025,15,110,117,7,105
624,9,18,09.01.2025,3,400,454,54,162
851,30,3,29.01.2025,5,287,340,53,265
213,8,8,19.01.2025,19,264,332,68,1292
550,29,26,02.01.2025,11,424,566,142,1562
202,16,4,15.01.2025,3,263,300,37,111
556,19,7,20.01.2025,16,173,226,53,848
596,14,28,29.01.2025,4,388,562,174,696
797,21,7,19.01.2025,20,406,510,104,2080
1,9,25,14.01.2025,20,158,201,43,860
181,11,17,16.01.2025,17,165,244,79,1343
307,9,28,18.01.2025,8,194,228,34,272
575,17,10,21.01.2025,15,77,115,38,570
969,6,16,01.01.2025,11,477,710,233,2563
482,16,6,06.01.2025,3,409,509,100,300
312,4,30,28.01.2025,15,195,261,66,990
552,27,6,07.01.2025,4,410,473,63,252
315,17,10,11.01.2025,17,261,286,25,425
308,30,20,07.01.2025,19,364,408,44,836
161,7,25,13.01.2025,6,456,511,55,330
679,6,11,31.01.2025,17,262,352,90,1530
808,14,25,24.01.2025,9,137,201,64,576
484,30,28,27.01.2025,10,209,233,24,240
342,24,12,27.01.2025,11,250,297,47,517
577,13,25,14.01.2025,1,410,604,194,194
57,14,12,21.01.2025,5,253,353,100,500
20,27,23,07.01.2025,7,358,491,133,931
302,27,12,01.01.2025,11,238,335,97,1067
334,18,18,24.01.2025,7,428,491,63,441
516,15,28,09.01.2025,4,58,67,9,36
334,24,16,31.01.2025,19,260,384,124,2356
970,2,25,22.01.2025,13,372,551,179,2327
724,16,8,09.01.2025,20,320,390,70,1400
104,2,21,11.01.2025,9,295,359,64,576
946,10,4,16.01.2025,5,470,652,182,910
333,25,24,14.01.2025,5,467,522,55,275
307,19,7,18.01.2025,3,244,283,39,117
587,18,25,22.01.2025,9,305,393,88,792
299,23,1,05.01.2025,3,465,653,188,564
729,24,11,31.01.2025,12,483,675,192,2304
766,29,7,06.01.2025,11,259,298,39,429
371,11,7,22.01.2025,9,150,198,48,432
956,1,5,04.01.2025,14,238,292,54,756
499,26,2,27.01.2025,17,50,73,23,391
525,12,1,19.01.2025,14,36,53,17,238
895,26,11,26.01.2025,18,271,319,48,864
342,21,3,24.01.2025,3,309,337,28,84
572,25,4,18.01.2025,6,428,548,120,720
872,3,19,30.01.2025,15,332,446,114,1710
196,25,3,25.01.2025,14,438,514,76,1064
463,29,29,24.01.2025,5,353,423,70,350
187,21,19,11.01.2025,15,290,406,116,1740
758,27,14,29.01.2025,1,225,294,69,69
7,20,27,13.01.2025,1,24,28,4,4
438,5,9,28.01.2025,8,319,432,113,904
335,18,15,21.01.2025,7,414,588,174,1218
948,12,29,29.01.2025,19,98,111,13,247
152,7,10,06.01.2025,4,33,43,10,40
968,28,2,25.01.2025,5,296,357,61,305
71,11,28,11.01.2025,8,356,407,51,408
311,6,14,09.01.2025,8,499,731,232,1856
791,12,1,05.01.2025,15,83,118,35,525
385,1,15,28.01.2025,7,214,229,15,105
450,13,7,07.01.2025,13,322,456,134,1742
96,6,17,30.01.2025,19,390,500,110,2090
167,25,7,04.01.2025,16,399,528,129,2064
768,11,14,07.01.2025,7,66,93,27,189
369,16,9,17.01.2025,4,253,267,14,56
390,26,14,13.01.2025,4,201,244,43,172
318,27,3,14.01.2025,10,137,205,68,680
87,21,21,26.01.2025,13,468,591,123,1599
975,9,24,21.01.2025,11,43,48,5,55
255,6,19,01.01.2025,5,285,319,34,170
712,16,25,02.01.2025,2,325,459,134,268
888,24,22,10.01.2025,12,336,416,80,960
162,14,6,06.01.2025,17,97,134,37,629
830,22,6,12.01.2025,4,422,474,52,208
510,7,10,13.01.2025,12,485,693,208,2496
637,11,1,26.01.2025,1,189,201,12,12
482,2,24,28.01.2025,5,487,601,114,570
553,13,25,20.01.2025,17,106,119,13,221
16,12,29,08.01.2025,3,234,350,116,348
116,16,15,14.01.2025,18,245,272,27,486
618,26,21,01.01.2025,10,263,332,69,690
925,9,5,11.01.2025,18,207,306,99,1782
685,23,4,16.01.2025,16,403,574,171,2736
585,7,5,08.01.2025,17,86,121,35,595
147,8,22,03.01.2025,4,387,477,90,360
909,20,4,08.01.2025,8,148,168,20,160
676,10,11,23.01.2025,15,362,476,114,1710
530,19,29,09.01.2025,5,187,232,45,225
678,5,19,24.01.2025,2,402,586,184,368
395,21,2,26.01.2025,7,113,119,6,42
650,2,27,26.01.2025,8,102,125,23,184
12,19,16,16.01.2025,12,116,155,39,468
837,19,13,15.01.2025,7,252,335,83,581
559,15,4,24.01.2025,9,355,496,141,1269
947,11,11,29.01.2025,6,150,181,31,186
893,16,25,18.01.2025,15,359,393,34,510
877,11,25,17.01.2025,9,52,73,21,189
437,21,1,31.01.2025,18,84,92,8,144
999,15,27,04.01.2025,4,301,413,112,448
130,28,12,10.01.2025,15,243,316,73,1095
963,3,28,17.01.2025,6,223,316,93,558
907,17,7,05.01.2025,8,417,441,24,192
752,24,12,17.01.2025,20,419,469,50,1000
881,17,17,02.01.2025,18,205,265,60,1080
711,17,6,12.01.2025,6,71,96,25,150
651,21,28,20.01.2025,8,451,662,211,1688
734,5,18,31.01.2025,20,237,340,103,2060
286,2,13,10.01.2025,13,481,618,137,1781
432,29,16,15.01.2025,11,89,122,33,363
308,1,3,09.01.2025,18,362,431,69,1242
946,24,20,20.01.2025,3,50,69,19,57
144,5,16,27.01.2025,6,411,611,200,1200
1000,8,13,26.01.2025,6,350,433,83,498
606,7,8,27.01.2025,12,56,65,9,108
972,9,5,29.01.2025,13,83,114,31,403
600,22,5,07.01.2025,15,92,124,32,480
779,11,1,21.01.2025,4,286,340,54,216
106,25,21,20.01.2025,16,138,186,48,768
306,27,4,18.01.2025,20,252,282,30,600
902,25,30,24.01.2025,11,468,549,81,891
42,13,27,29.01.2025,9,77,103,26,234
437,19,6,29.01.2025,16,408,482,74,1184
536,4,3,24.01.2025,20,326,469,143,2860
248,28,28,22.01.2025,16,448,612,164,2624
443,14,2,21.01.2025,4,462,645,183,732
863,24,24,09.01.2025,9,347,444,97,873
430,22,27,09.01.2025,12,62,65,3,36
731,26,16,08.01.2025,19,273,314,41,779
445,22,9,04.01.2025,16,307,406,99,1584
580,13,20,17.01.2025,13,41,54,13,169
605,27,26,21.01.2025,4,314,343,29,116
990,25,8,12.01.2025,19,364,498,134,2546
619,14,27,13.01.2025,2,197,264,67,134
451,28,15,19.01.2025,17,39,57,18,306
833,26,21,24.01.2025,14,362,528,166,2324
222,19,6,01.01.2025,11,70,83,13,143
423,26,1,24.01.2025,15,454,659,205,3075
368,27,22,12.01.2025,12,147,173,26,312
803,2,11,15.01.2025,9,413,581,168,1512
215,18,25,28.01.2025,18,351,419,68,1224
411,25,12,25.01.2025,6,452,576,124,744
92,11,12,20.01.2025,18,398,562,164,2952
990,8,11,27.01.2025,10,71,104,33,330
93,21,13,11.01.2025,20,274,367,93,1860
775,13,7,09.01.2025,16,199,239,40,640
449,29,12,25.01.2025,6,106,127,21,126
115,7,19,10.01.2025,17,378,506,128,2176
304,25,18,18.01.2025,6,223,296,73,438
78,7,3,03.01.2025,20,488,705,217,4340
415,28,9,05.01.2025,11,292,353,61,671
137,30,13,04.01.2025,10,334,436,102,1020
85,11,8,15.01.2025,2,145,188,43,86
684,9,1,16.01.2025,8,446,608,162,1296
225,8,29,08.01.2025,15,351,497,146,2190
149,1,10,08.01.2025,1,459,608,149,149
859,15,14,18.01.2025,18,310,352,42,756
191,28,17,19.01.2025,13,341,446,105,1365
924,13,24,09.01.2025,12,431,608,177,2124
442,12,12,29.01.2025,8,183,237,54,432
79,23,5,11.01.2025,8,427,552,125,1000
132,4,30,26.01.2025,17,382,483,101,1717
322,4,26,27.01.2025,20,136,187,51,1020
735,23,21,18.01.2025,8,258,302,44,352
857,2,15,20.01.2025,15,274,361,87,1305
67,6,1,18.01.2025,15,306,411,105,1575
918,12,16,28.01.2025,5,52,71,19,95
67,24,9,19.01.2025,9,479,660,181,1629
731,20,16,14.01.2025,5,222,255,33,165
463,10,18,23.01.2025,10,189,218,29,290
818,29,17,31.01.2025,14,93,130,37,518
698,19,11,28.01.2025,1,332,357,25,25
773,12,19,04.01.2025,3,334,360,26,78
424,24,6,24.01.2025,7,147,219,72,504
793,25,6,27.01.2025,6,35,47,12,72
507,24,4,11.01.2025,3,68,100,32,96
588,23,22,13.01.2025,14,215,293,78,1092
142,28,11,06.01.2025,4,179,217,38,152
725,14,29,09.01.2025,16,66,75,9,144
412,7,8,12.01.2025,3,193,242,49,147
97,17,9,01.01.2025,20,51,76,25,500
61,22,12,04.01.2025,6,20,30,10,60
542,1,1,11.01.2025,13,176,187,11,143
927,19,19,12.01.2025,3,108,123,15,45
636,16,6,18.01.2025,7,196,214,18,126
700,30,5,20.01.2025,12,313,354,41,492
452,23,28,29.01.2025,6,279,312,33,198
839,15,1,20.01.2025,2,498,643,145,290
982,26,4,26.01.2025,10,498,588,90,900
358,22,6,19.01.2025,17,105,153,48,816
510,7,20,05.01.2025,20,491,590,99,1980
466,30,22,18.01.2025,13,421,527,106,1378
120,22,18,03.01.2025,11,146,177,31,341
246,27,16,07.01.2025,13,41,50,9,117
939,30,16,26.01.2025,19,70,100,30,570
94,22,21,11.01.2025,17,308,403,95,1615
545,17,13,25.01.2025,18,349,398,49,882
329,5,15,25.01.2025,7,169,249,80,560
437,13,14,13.01.2025,3,271,287,16,48
107,11,18,16.01.2025,20,219,260,41,820
806,25,10,25.01.2025,2,290,413,123,246
193,3,10,29.01.2025,19,402,585,183,3477
556,6,21,11.01.2025,2,293,311,18,36
990,10,13,07.01.2025,12,295,317,22,264
846,22,28,14.01.2025,17,288,412,124,2108
521,12,22,23.01.2025,2,486,557,71,142
469,6,29,08.01.2025,11,57,78,21,231
508,7,19,21.01.2025,20,27,29,2,40
391,7,29,23.01.2025,4,493,582,89,356
927,8,22,27.01.2025,11,110,164,54,594
847,8,12,30.01.2025,13,42,47,5,65
614,8,20,22.01.2025,9,471,690,219,1971
697,19,23,28.01.2025,10,124,183,59,590
670,24,30,09.01.2025,14,373,393,20,280
844,14,13,09.01.2025,7,438,613,175,1225
260,20,1,21.01.2025,13,41,56,15,195
460,5,22,23.01.2025,8,56,75,19,152
119,6,29,26.01.2025,16,54,61,7,112
336,6,24,09.01.2025,13,165,213,48,624
292,28,19,09.01.2025,4,409,451,42,168
843,29,29,07.01.2025,3,304,435,131,393
206,5,17,02.01.2025,16,265,291,26,416
235,2,27,13.01.2025,6,62,86,24,144
826,3,8,14.01.2025,20,209,261,52,1040
147,15,20,25.01.2025,2,359,528,169,338
786,7,25,07.01.2025,11,42,55,13,143
972,5,11,28.01.2025,9,491,554,63,567
474,7,29,21.01.2025,2,220,269,49,98
970,10,17,03.01.2025,8,114,152,38,304
344,22,24,15.01.2025,1,466,582,116,116
864,8,20,17.01.2025,10,305,342,37,370
561,11,2,04.01.2025,3,229,294,65,195
18,20,24,06.01.2025,11,209,223,14,154
924,4,22,08.01.2025,1,215,226,11,11
60,27,13,25.01.2025,19,81,116,35,665
781,21,2,19.01.2025,18,57,60,3,54
844,30,16,30.01.2025,19,350,428,78,1482
703,20,13,15.01.2025,8,369,469,100,800
257,12,21,15.01.2025,16,490,713,223,3568
466,18,29,12.01.2025,8,93,110,17,136
749,6,13,09.01.2025,6,208,288,80,480
443,26,10,05.01.2025,2,255,315,60,120
901,18,28,08.01.2025,13,84,120,36,468
362,7,13,14.01.2025,14,255,352,97,1358
455,13,15,12.01.2025,11,186,251,65,715
137,24,17,07.01.2025,8,131,180,49,392
583,7,28,24.01.2025,20,206,300,94,1880
562,28,25,26.01.2025,14,211,283,72,1008
219,13,5,16.01.2025,4,297,399,102,408
308,29,27,31.01.2025,20,231,248,17,340
223,11,18,29.01.2025,6,357,437,80,480
530,14,6,31.01.2025,15,32,44,12,180
396,19,22,06.01.2025,9,401,544,143,1287
788,5,21,13.01.2025,19,420,592,172,3268
155,14,11,15.01.2025,8,464,641,177,1416
781,30,16,11.01.2025,20,497,693,196,3920
544,24,21,29.01.2025,2,366,400,34,68
67,3,1,01.01.2025,2,189,271,82,164
321,30,29,12.01.2025,7,400,447,47,329
219,10,27,03.01.2025,12,339,495,156,1872
598,29,27,15.01.2025,16,193,264,71,1136
297,10,4,26.01.2025,18,101,147,46,828
156,6,14,04.01.2025,18,486,646,160,2880
163,18,18,21.01.2025,16,378,564,186,2976
707,28,29,08.01.2025,4,359,530,171,684
932,15,4,25.01.2025,2,89,129,40,80
485,13,16,06.01.2025,1,320,435,115,115
838,12,30,15.01.2025,19,312,353,41,779
916,1,16,31.01.2025,19,196,284,88,1672
88,29,12,03.01.2025,6,89,118,29,174
694,13,30,05.01.2025,4,498,700,202,808
685,7,21,11.01.2025,10,384,540,156,1560
806,3,12,20.01.2025,16,28,37,9,144
605,14,6,12.01.2025,9,118,151,33,297
533,29,30,01.01.2025,16,183,267,84,1344
54,21,8,23.01.2025,10,154,193,39,390
444,11,2,09.01.2025,15,357,388,31,465
565,2,5,28.01.2025,20,25,35,10,200
20,10,13,07.01.2025,16,214,262,48,768
712,22,9,23.01.2025,13,191,232,41,533
525,28,26,14.01.2025,14,382,460,78,1092
966,12,24,09.01.2025,18,118,150,32,576
274,3,30,15.01.2025,3,432,583,151,453
327,28,17,29.01.2025,4,31,44,13,52
826,25,4,08.01.2025,3,110,134,24,72
158,19,26,08.01.2025,3,462,501,39,117
741,1,24,26.01.2025,11,465,678,213,2343
73,5,19,21.01.2025,15,343,495,152,2280
805,22,4,20.01.2025,4,48,66,18,72
205,30,24,30.01.2025,3,115,125,10,30
975,3,1,14.01.2025,8,127,136,9,72
82,13,11,21.01.2025,17,118,149,31,527
203,23,16,20.01.2025,6,260,307,47,282
693,19,28,28.01.2025,2,246,279,33,66
7,3,6,07.01.2025,9,93,134,41,369
590,7,23,04.01.2025,3,116,132,16,48
330,25,8,06.01.2025,13,345,492,147,1911
304,20,14,17.01.2025,10,131,163,32,320
845,12,24,08.01.2025,17,23,31,8,136
992,22,9,10.01.2025,6,53,57,4,24
506,12,29,24.01.2025,2,337,468,131,262
441,3,22,25.01.2025,15,26,39,13,195
691,3,11,19.01.2025,12,377,511,134,1608
695,3,19,09.01.2025,11,250,303,53,583
831,16,12,16.01.2025,10,410,521,111,1110
560,24,7,08.01.2025,19,107,114,7,133
362,14,15,29.01.2025,15,186,273,87,1305
867,13,15,28.01.2025,15,251,281,30,450
756,25,13,14.01.2025,1,467,520,53,53
325,13,28,21.01.2025,5,224,272,48,240
445,26,27,22.01.2025,6,97,128,31,186
189,7,4,01.01.2025,13,261,292,31,403
346,7,1,16.01.2025,13,101,120,19,247
979,28,18,09.01.2025,8,117,148,31,248
742,16,14,14.01.2025,6,269,400,131,786
62,12,4,03.01.2025,11,381,482,101,1111
297,5,8,17.01.2025,16,431,495,64,1024
503,1,10,21.01.2025,6,193,257,64,384
701,20,14,20.01.2025,4,326,361,35,140
289,11,24,12.01.2025,5,209,273,64,320
485,3,1,15.01.2025,12,233,270,37,444
968,11,23,08.01.2025,11,344,503,159,1749
996,16,26,09.01.2025,18,194,254,60,1080
340,23,7,29.01.2025,5,184,258,74,370
587,30,8,23.01.2025,19,332,384,52,988
840,8,16,19.01.2025,16,475,503,28,448
524,29,4,13.01.2025,5,339,405,66,330
542,16,15,20.01.2025,9,54,68,14,126
797,7,26,25.01.2025,9,384,428,44,396
869,25,2,16.01.2025,8,134,179,45,360
336,12,27,20.01.2025,16,307,343,36,576
280,11,16,11.01.2025,20,472,610,138,2760
844,26,21,07.01.2025,20,329,363,34,680
752,2,24,29.01.2025,7,288,406,118,826
290,8,26,13.01.2025,14,378,536,158,2212
12,10,9,07.01.2025,5,171,181,10,50
668,21,25,14.01.2025,3,208,262,54,162
932,5,15,21.01.2025,13,304,341,37,481
455,25,11,04.01.2025,9,253,297,44,396
724,20,15,10.01.2025,6,320,355,35,210
980,1,4,02.01.2025,11,302,382,80,880
146,11,27,24.01.2025,13,301,319,18,234
445,21,11,13.01.2025,6,187,248,61,366
779,2,21,10.01.2025,11,309,430,121,1331
41,29,17,02.01.2025,5,274,296,22,110
70,5,5,04.01.2025,17,103,152,49,833
241,3,25,12.01.2025,12,193,210,17,204
352,25,3,16.01.2025,13,299,322,23,299
427,21,26,13.01.2025,5,300,426,126,630
834,7,15,06.01.2025,4,410,599,189,756
268,8,8,02.01.2025,18,32,34,2,36
864,23,8,16.01.2025,2,41,47,6,12
239,5,28,05.01.2025,17,183,219,36,612
775,21,22,13.01.2025,1,281,392,111,111
505,1,22,23.01.2025,14,301,325,24,336
205,19,2,07.01.2025,8,318,404,86,688
358,23,3,19.01.2025,12,280,407,127,1524
169,13,7,05.01.2025,18,23,34,11,198
763,20,10,09.01.2025,18,211,270,59,1062
164,27,7,25.01.2025,20,151,181,30,600
335,29,9,13.01.2025,4,353,416,63,252
30,15,20,31.01.2025,17,414,510,96,1632
190,4,2,13.01.2025,4,400,588,188,752
211,7,25,19.01.2025,10,446,607,161,1610
220,29,19,27.01.2025,10,204,257,53,530
664,21,8,19.01.2025,9,131,168,37,333
318,1,7,27.01.2025,6,460,552,92,552
512,24,13,24.01.2025,11,254,379,125,1375
617,25,6,30.01.2025,16,265,345,80,1280
293,26,22,28.01.2025,8,59,78,19,152
906,1,28,01.01.2025,20,45,65,20,400
970,9,30,01.01.2025,10,247,302,55,550
582,6,4,02.01.2025,12,130,174,44,528
995,14,24,29.01.2025,12,58,68,10,120
670,1,10,25.01.2025,2,480,530,50,100
146,9,15,30.01.2025,7,81,119,38,266
763,22,26,01.01.2025,16,109,115,6,96
89,24,8,15.01.2025,19,375,488,113,2147
277,1,23,19.01.2025,16,52,72,20,320
157,7,3,13.01.2025,13,35,37,2,26
443,27,15,14.01.2025,6,26,34,8,48
46,22,3,31.01.2025,9,383,451,68,612
491,7,26,09.01.2025,1,363,426,63,63
893,7,8,23.01.2025,15,434,456,22,330
666,2,28,19.01.2025,14,306,452,146,2044
501,26,8,23.01.2025,2,166,201,35,70
613,12,15,27.01.2025,16,298,335,37,592
675,29,12,24.01.2025,18,296,330,34,612
753,21,12,14.01.2025,6,317,390,73,438
479,12,25,10.01.2025,5,436,590,154,770
911,16,22,18.01.2025,14,204,302,98,1372
89,20,9,29.01.2025,5,190,279,89,445
661,15,15,25.01.2025,18,461,625,164,2952
912,2,11,17.01.2025,5,326,392,66,330
648,27,24,06.01.2025,19,91,136,45,855
812,7,27,23.01.2025,13,61,87,26,338
902,4,17,18.01.2025,2,286,314,28,56
5,9,30,18.01.2025,6,398,459,61,366
727,26,11,16.01.2025,4,186,257,71,284
817,12,18,30.01.2025,13,287,386,99,1287
403,8,19,12.01.2025,14,372,516,144,2016
109,8,21,21.01.2025,15,99,141,42,630
917,25,7,23.01.2025,1,477,671,194,194
517,26,4,16.01.2025,5,488,528,40,200
973,10,8,25.01.2025,13,175,249,74,962
555,21,4,31.01.2025,7,32,34,2,14
303,4,7,06.01.2025,3,54,63,9,27
974,4,14,31.01.2025,12,358,441,83,996
715,20,10,11.01.2025,13,211,241,30,390
439,20,19,30.01.2025,16,345,458,113,1808
43,22,16,02.01.2025,16,183,221,38,608
262,23,16,28.01.2025,13,405,523,118,1534
101,14,23,19.01.2025,20,470,568,98,1960
995,22,16,01.01.2025,13,39,58,19,247
778,29,3,16.01.2025,9,298,325,27,243
252,24,27,23.01.2025,4,252,308,56,224
346,8,20,16.01.2025,2,185,220,35,70
796,23,28,15.01.2025,7,334,412,78,546
11,22,5,19.01.2025,1,498,636,138,138
71,17,6,15.01.2025,9,376,490,114,1026
821,30,18,21.01.2025,2,149,196,47,94
715,17,16,06.01.2025,15,170,244,74,1110
41,10,20,11.01.2025,14,76,103,27,378
992,27,3,07.01.2025,16,268,311,43,688
397,25,24,26.01.2025,6,415,506,91,546
310,6,8,11.01.2025,19,452,575,123,2337
731,15,26,23.01.2025,4,71,80,9,36
136,24,20,19.01.2025,1,244,311,67,67
814,23,14,01.01.2025,17,479,653,174,2958
651,18,4,14.01.2025,16,37,43,6,96
571,23,14,03.01.2025,3,64,75,11,33
972,22,12,16.01.2025,13,279,408,129,1677
929,30,29,05.01.2025,4,32,36,4,16
585,6,22,07.01.2025,15,357,535,178,2670
383,18,9,16.01.2025,3,424,570,146,438
597,14,4,18.01.2025,2,138,157,19,38
308,5,24,23.01.2025,13,25,30,5,65
523,26,1,04.01.2025,17,360,421,61,1037
544,1,10,29.01.2025,5,183,268,85,425
882,16,26,07.01.2025,7,359,454,95,665
491,7,4,06.01.2025,13,303,405,102,1326
555,28,26,03.01.2025,5,361,400,39,195
523,5,28,25.01.2025,3,264,338,74,222
75,19,6,08.01.2025,14,449,598,149,2086
961,8,27,09.01.2025,14,50,69,19,266
44,28,11,25.01.2025,13,34,39,5,65
744,30,12,13.01.2025,15,330,471,141,2115
231,24,30,05.01.2025,16,334,493,159,2544
522,29,14,21.01.2025,6,143,189,46,276
295,16,25,03.01.2025,14,327,348,21,294
68,18,3,23.01.2025,5,415,556,141,705
379,9,13,09.01.2025,15,352,497,145,2175
940,11,10,27.01.2025,18,329,394,65,1170
316,28,16,17.01.2025,16,217,302,85,1360
860,23,19,23.01.2025,18,492,668,176,3168
614,22,26,19.01.2025,5,260,312,52,260
709,16,11,18.01.2025,17,335,447,112,1904
258,21,9,30.01.2025,9,467,551,84,756
526,8,11,30.01.2025,11,484,560,76,836
196,12,10,07.01.2025,11,285,386,101,1111
286,9,20,14.01.2025,7,413,548,135,945
806,5,26,25.01.2025,10,117,159,42,420
371,23,18,18.01.2025,11,124,175,51,561
596,17,6,04.01.2025,10,346,402,56,560
613,26,21,27.01.2025,11,113,164,51,561
830,16,12,08.01.2025,13,267,367,100,1300
955,19,15,18.01.2025,11,94,109,15,165
74,9,4,31.01.2025,13,436,566,130,1690
403,1,3,07.01.2025,9,495,630,135,1215
958,18,19,27.01.2025,9,281,367,86,774
204,9,2,14.01.2025,16,324,356,32,512
448,13,11,04.01.2025,5,112,124,12,60
779,26,2,02.01.2025,3,162,178,16,48
549,9,5,26.01.2025,4,493,682,189,756
434,7,2,29.01.2025,19,50,53,3,57
346,20,24,09.01.2025,10,240,278,38,380
226,20,20,19.01.2025,9,495,643,148,1332
861,8,5,01.01.2025,18,319,380,61,1098
226,6,26,31.01.2025,13,124,160,36,468
18,6,3,19.01.2025,20,158,223,65,1300
128,4,8,28.01.2025,14,133,154,21,294
625,6,29,06.01.2025,8,163,179,16,128
245,22,10,14.01.2025,19,460,607,147,2793
396,15,7,08.01.2025,4,453,492,39,156
730,15,15,05.01.2025,13,455,604,149,1937
390,1,18,25.01.2025,9,125,181,56,504
504,14,26,29.01.2025,17,195,233,38,646
512,17,20,13.01.2025,15,330,377,47,705
148,23,3,20.01.2025,13,106,149,43,559
213,7,11,12.01.2025,13,160,186,26,338
298,29,8,13.01.2025,20,469,592,123,2460
25,22,30,19.01.2025,8,350,477,127,1016
464,23,26,01.01.2025,13,312,376,64,832
391,1,16,14.01.2025,15,485,602,117,1755
448,9,12,08.01.2025,9,207,302,95,855
267,16,6,06.01.2025,8,457,600,143,1144
530,20,17,26.01.2025,7,453,483,30,210
391,12,2,25.01.2025,8,66,90,24,192
163,3,20,23.01.2025,18,45,52,7,126
538,30,9,15.01.2025,5,170,189,19,95
447,9,28,30.01.2025,6,137,169,32,192
171,17,3,08.01.2025,3,337,362,25,75
671,26,26,28.01.2025,6,167,217,50,300
965,14,29,06.01.2025,8,28,40,12,96
201,20,23,03.01.2025,3,415,455,40,120
837,26,6,18.01.2025,4,418,526,108,432
780,12,24,06.01.2025,5,293,431,138,690
252,26,1,11.01.2025,6,412,483,71,426
833,1,17,17.01.2025,2,221,245,24,48
50,16,5,28.01.2025,5,143,206,63,315
855,12,19,26.01.2025,9,256,297,41,369
180,23,4,23.01.2025,8,102,136,34,272
773,2,3,13.01.2025,5,20,24,4,20
542,26,16,22.01.2025,13,301,389,88,1144
414,29,17,15.01.2025,17,201,282,81,1377
592,23,27,24.01.2025,13,404,470,66,858
960,14,6,17.01.2025,16,84,119,35,560
212,3,20,12.01.2025,10,79,104,25,250
423,13,13,10.01.2025,12,32,38,6,72
204,25,1,07.01.2025,14,416,556,140,1960
151,15,28,19.01.2025,5,352,495,143,715
406,8,5,01.01.2025,8,482,601,119,952
499,13,15,23.01.2025,15,210,304,94,1410
475,5,14,31.01.2025,2,145,214,69,138
919,21,30,04.01.2025,10,211,227,16,160
477,30,13,29.01.2025,14,59,78,19,266
364,27,17,18.01.2025,16,40,59,19,304
890,28,16,03.01.2025,12,189,215,26,312
945,17,6,01.01.2025,4,94,130,36,144
576,9,2,01.01.2025,17,131,175,44,748
381,1,15,13.01.2025,11,428,567,139,1529
356,20,11,10.01.2025,12,46,65,19,228
600,4,29,15.01.2025,16,241,336,95,1520
38,22,25,18.01.2025,19,279,301,22,418
992,5,30,27.01.2025,13,189,255,66,858
451,24,24,21.01.2025,9,93,104,11,99
937,7,3,20.01.2025,13,161,198,37,481
43,2,10,01.01.2025,5,119,147,28,140
199,14,26,27.01.2025,5,238,308,70,350
262,30,7,01.01.2025,3,103,148,45,135
272,24,16,26.01.2025,3,132,166,34,102
170,30,22,16.01.2025,4,60,81,21,84
832,29,11,20.01.2025,12,455,574,119,1428
980,9,19,18.01.2025,18,475,691,216,3888
760,11,21,22.01.2025,11,289,324,35,385
699,27,23,19.01.2025,17,369,434,65,1105
609,25,29,08.01.2025,8,437,463,26,208
495,9,11,31.01.2025,17,173,220,47,799
742,13,2,31.01.2025,19,173,244,71,1349
264,4,27,05.01.2025,18,134,192,58,1044
225,29,8,15.01.2025,5,494,541,47,235
556,17,12,14.01.2025,13,234,305,71,923
307,3,8,06.01.2025,20,266,393,127,2540
679,3,25,11.01.2025,2,243,300,57,114
443,5,14,16.01.2025,1,190,280,90,90
122,10,8,16.01.2025,16,495,733,238,3808
603,7,13,14.01.2025,8,166,192,26,208
824,6,11,06.01.2025,20,187,246,59,1180
874,3,4,03.01.2025,3,427,590,163,489
154,18,14,16.01.2025,3,498,740,242,726
828,23,21,05.01.2025,2,21,27,6,12
34,5,10,27.01.2025,12,367,499,132,1584
847,23,12,22.01.2025,19,64,68,4,76
915,10,11,04.01.2025,2,318,346,28,56
41,20,1,27.01.2025,7,424,478,54,378
401,27,16,04.01.2025,9,323,382,59,531
857,17,3,27.01.2025,20,165,184,19,380
474,20,28,09.01.2025,6,349,488,139,834
528,4,16,20.01.2025,8,372,438,66,528
403,28,11,22.01.2025,6,375,474,99,594
464,12,17,10.01.2025,10,354,484,130,1300
411,14,26,30.01.2025,8,426,636,210,1680
317,22,11,07.01.2025,8,256,286,30,240
159,2,3,02.01.2025,19,468,516,48,912
111,15,5,05.01.2025,3,164,229,65,195
705,11,19,08.01.2025,16,242,299,57,912
953,21,22,31.01.2025,18,393,517,124,2232
960,23,7,29.01.2025,16,355,378,23,368
161,13,7,12.01.2025,3,45,48,3,9
874,26,9,13.01.2025,6,436,555,119,714
675,13,26,23.01.2025,11,250,277,27,297
335,24,23,14.01.2025,11,488,677,189,2079
889,23,6,01.01.2025,6,148,183,35,210
499,29,11,05.01.2025,2,472,525,53,106
526,20,16,31.01.2025,9,484,552,68,612
185,14,2,25.01.2025,1,343,416,73,73
352,26,20,12.01.2025,11,21,23,2,22
791,27,17,07.01.2025,7,95,114,19,133
675,28,24,24.01.2025,17,160,206,46,782
911,17,19,20.01.2025,20,120,149,29,580
973,24,26,02.01.2025,15,388,511,123,1845
298,18,25,15.01.2025,2,165,198,33,66
418,19,21,31.01.2025,3,262,373,111,333
428,30,15,30.01.2025,20,312,360,48,960
323,27,19,08.01.2025,15,155,184,29,435
668,28,2,27.01.2025,8,362,527,165,1320
261,13,9,01.01.2025,17,137,146,9,153
975,27,15,08.01.2025,13,21,26,5,65
982,3,26,26.01.2025,9,294,416,122,1098
560,14,1,17.01.2025,10,413,545,132,1320
53,16,19,07.01.2025,18,358,465,107,1926
799,4,28,08.01.2025,13,307,423,116,1508
182,18,21,07.01.2025,1,370,460,90,90
337,21,8,31.01.2025,16,30,33,3,48
954,24,24,09.01.2025,6,356,421,65,390
264,14,6,29.01.2025,14,124,171,47,658
371,4,25,30.01.2025,10,178,267,89,890
709,18,21,03.01.2025,3,99,143,44,132
874,30,1,31.01.2025,8,53,74,21,168
814,25,9,31.01.2025,6,78,109,31,186
346,4,17,25.01.2025,18,258,330,72,1296
493,22,20,09.01.2025,3,202,284,82,246
362,6,13,26.01.2025,7,299,441,142,994
743,1,30,30.01.2025,20,431,641,210,4200
785,3,3,06.01.2025,5,195,219,24,120
835,23,18,07.01.2025,16,493,686,193,3088
360,1,11,28.01.2025,13,425,591,166,2158
107,26,17,25.01.2025,13,128,144,16,208
636,21,16,25.01.2025,19,402,548,146,2774
1000,24,8,27.01.2025,16,305,426,121,1936
397,11,21,12.01.2025,7,480,513,33,231
464,7,1,19.01.2025,12,28,42,14,168
957,12,21,11.01.2025,14,403,575,172,2408
993,11,28,15.01.2025,3,88,126,38,114
609,17,18,25.01.2025,4,323,359,36,144
507,18,18,24.01.2025,11,81,108,27,297
34,26,27,21.01.2025,11,145,173,28,308
842,14,10,02.01.2025,4,48,71,23,92
681,5,23,09.01.2025,13,98,115,17,221
871,14,3,17.01.2025,12,58,74,16,192
757,10,14,01.01.2025,1,165,198,33,33
729,3,28,05.01.2025,17,328,433,105,1785
103,12,4,04.01.2025,9,413,496,83,747
910,4,6,19.01.2025,7,318,448,130,910
238,2,9,10.01.2025,18,406,525,119,2142
880,3,26,23.01.2025,18,498,652,154,2772
708,18,10,30.01.2025,18,356,421,65,1170
917,13,25,30.01.2025,2,179,262,83,166
431,3,22,11.01.2025,9,399,428,29,261
71,4,19,01.01.2025,4,476,602,126,504
481,26,12,13.01.2025,18,74,87,13,234
606,18,29,26.01.2025,8,61,73,12,96
190,21,30,19.01.2025,4,342,484,142,568
482,7,24,23.01.2025,5,106,146,40,200
842,28,22,17.01.2025,8,228,240,12,96
536,29,9,19.01.2025,7,272,353,81,567
61,14,7,20.01.2025,13,118,168,50,650
300,12,5,13.01.2025,19,230,336,106,2014
295,9,8,20.01.2025,4,381,472,91,364
664,20,16,01.01.2025,4,227,299,72,288
765,9,23,05.01.2025,19,114,161,47,893
595,4,22,08.01.2025,5,384,410,26,130
256,24,2,24.01.2025,3,370,454,84,252
989,7,9,31.01.2025,4,314,330,16,64
216,23,4,27.01.2025,1,231,254,23,23
212,15,5,05.01.2025,4,464,564,100,400
421,13,22,17.01.2025,9,247,333,86,774
879,21,5,07.01.2025,13,200,227,27,351
682,28,22,08.01.2025,16,270,399,129,2064
448,2,9,01.01.2025,14,257,288,31,434
801,29,27,02.01.2025,15,288,340,52,780
424,4,29,10.01.2025,5,165,194,29,145
437,25,1,16.01.2025,17,53,70,17,289
357,10,21,08.01.2025,15,122,166,44,660
283,27,16,31.01.2025,13,158,177,19,247
226,15,29,05.01.2025,1,419,484,65,65
498,13,8,31.01.2025,18,280,375,95,1710
149,4,9,24.01.2025,12,287,334,47,564
102,9,28,22.01.2025,17,429,510,81,1377
414,1,3,19.01.2025,4,143,208,65,260
259,26,8,25.01.2025,18,458,607,149,2682
819,30,17,30.01.2025,6,341,434,93,558
542,1,5,31.01.2025,1,187,261,74,74
789,18,14,19.01.2025,11,20,25,5,55
192,4,24,10.01.2025,14,148,202,54,756
279,19,7,21.01.2025,13,362,517,155,2015
617,19,19,12.01.2025,4,214,270,56,224
201,29,8,11.01.2025,2,459,551,92,184
483,25,8,18.01.2025,11,272,313,41,451
981,18,1,23.01.2025,3,72,94,22,66
141,8,14,28.01.2025,2,124,156,32,64
548,24,3,04.01.2025,18,245,336,91,1638
227,24,7,07.01.2025,12,69,74,5,60
12,30,19,14.01.2025,4,163,218,55,220
912,15,29,07.01.2025,3,194,284,90,270
627,4,3,26.01.2025,9,425,561,136,1224
765,21,25,08.01.2025,2,263,358,95,190
555,6,22,25.01.2025,1,494,706,212,212
837,7,26,14.01.2025,11,71,77,6,66
597,8,30,19.01.2025,9,20,25,5,45
358,30,12,25.01.2025,15,304,414,110,1650
28,24,4,21.01.2025,19,30,41,11,209
198,6,27,06.01.2025,8,397,425,28,224
184,7,27,07.01.2025,7,87,103,16,112
63,22,15,08.01.2025,20,88,94,6,120
744,30,24,07.01.2025,12,341,474,133,1596
780,10,27,22.01.2025,14,98,133,35,490
854,29,6,16.01.2025,13,23,26,3,39
36,18,6,22.01.2025,14,75,82,7,98
162,7,3,05.01.2025,14,75,93,18,252
717,27,6,09.01.2025,17,385,500,115,1955
694,17,29,30.01.2025,19,480,712,232,4408
600,11,29,15.01.2025,6,444,665,221,1326
546,22,19,07.01.2025,15,237,267,30,450
857,26,15,09.01.2025,11,153,202,49,539
949,24,26,25.01.2025,1,120,148,28,28
385,25,18,15.01.2025,3,467,613,146,438
816,23,5,29.01.2025,2,137,189,52,104
547,28,4,18.01.2025,16,222,324,102,1632
595,23,24,27.01.2025,5,47,60,13,65
552,29,8,26.01.2025,5,143,209,66,330
521,28,20,18.01.2025,3,143,185,42,126
86,11,17,18.01.2025,3,152,177,25,75
563,5,27,06.01.2025,2,238,302,64,128
859,7,5,26.01.2025,8,377,504,127,1016
531,5,20,15.01.2025,3,236,324,88,264
560,3,24,25.01.2025,11,255,287,32,352
283,28,11,01.01.2025,2,411,434,23,46
28,25,22,23.01.2025,1,461,652,191,191
32,3,11,06.01.2025,19,61,66,5,95
195,16,26,04.01.2025,15,421,611,190,2850
664,12,2,26.01.2025,20,33,45,12,240
362,11,13,22.01.2025,4,426,623,197,788
662,10,25,10.01.2025,9,101,110,9,81
833,5,20,22.01.2025,19,296,374,78,1482
503,17,30,25.01.2025,3,97,110,13,39
782,10,17,20.01.2025,2,180,220,40,80
42,17,14,15.01.2025,1,42,55,13,13
3,22,9,29.01.2025,8,213,257,44,352
350,3,12,24.01.2025,17,160,206,46,782
415,13,19,04.01.2025,8,231,258,27,216
276,17,8,11.01.2025,12,358,384,26,312
318,27,6,26.01.2025,19,212,292,80,1520
566,23,2,21.01.2025,16,47,58,11,176
247,14,20,28.01.2025,20,305,383,78,1560
364,26,1,25.01.2025,20,418,559,141,2820
962,28,30,17.01.2025,6,84,91,7,42
275,26,2,30.01.2025,4,463,568,105,420
855,17,4,29.01.2025,18,488,629,141,2538
6,9,21,24.01.2025,9,458,614,156,1404
561,16,16,29.01.2025,8,284,323,39,312
736,25,7,17.01.2025,3,224,262,38,114
159,22,3,05.01.2025,13,336,455,119,1547
744,6,17,19.01.2025,10,228,270,42,420
22,8,29,14.01.2025,5,208,286,78,390
866,17,14,07.01.2025,4,178,264,86,344
258,3,15,28.01.2025,2,440,539,99,198
969,21,13,06.01.2025,12,404,492,88,1056
298,28,28,02.01.2025,6,226,318,92,552
739,22,12,11.01.2025,18,369,418,49,882
197,28,30,24.01.2025,1,362,394,32,32
387,10,14,26.01.2025,9,461,544,83,747
590,27,17,17.01.2025,1,415,478,63,63
112,12,8,18.01.2025,17,285,322,37,629
283,11,24,05.01.2025,15,332,473,141,2115
64,22,23,11.01.2025,2,168,228,60,120
59,28,10,08.01.2025,7,489,561,72,504
994,25,27,12.01.2025,7,444,571,127,889
602,11,29,23.01.2025,4,222,306,84,336
827,5,26,04.01.2025,3,68,93,25,75
466,17,15,24.01.2025,4,298,319,21,84
1000,7,8,19.01.2025,3,343,465,122,366
505,7,5,13.01.2025,11,135,144,9,99
417,28,2,24.01.2025,3,62,91,29,87
627,25,17,16.01.2025,11,219,239,20,220
984,17,28,14.01.2025,18,388,558,170,3060
914,1,1,30.01.2025,6,126,179,53,318
831,1,19,04.01.2025,11,418,517,99,1089
563,5,27,20.01.2025,17,493,521,28,476
705,13,11,16.01.2025,16,155,214,59,944
843,20,4,31.01.2025,14,489,514,25,350
636,22,7,13.01.2025,12,332,467,135,1620
138,29,2,03.01.2025,10,329,356,27,270
127,28,17,21.01.2025,19,166,182,16,304
300,8,8,13.01.2025,17,264,318,54,918
28,19,5,25.01.2025,14,119,134,15,210
741,6,7,20.01.2025,20,278,310,32,640
246,15,9,11.01.2025,11,234,254,20,220
262,30,2,23.01.2025,10,86,110,24,240
418,24,2,27.01.2025,12,342,362,20,240
812,11,8,16.01.2025,13,239,298,59,767
810,24,2,17.01.2025,4,79,109,30,120
437,25,28,01.01.2025,2,118,170,52,104
57,17,29,07.01.2025,12,219,269,50,600
623,3,27,28.01.2025,1,217,243,26,26
467,3,11,31.01.2025,7,71,105,34,238
787,7,9,29.01.2025,11,202,217,15,165
441,17,18,06.01.2025,14,312,343,31,434
642,28,16,14.01.2025,18,349,508,159,2862
637,7,17,27.01.2025,9,168,233,65,585
42,4,8,10.01.2025,18,22,31,9,162
459,25,7,11.01.2025,10,141,178,37,370
684,30,18,24.01.2025,17,89,110,21,357
218,8,21,12.01.2025,20,390,431,41,820
105,22,12,15.01.2025,1,330,469,139,139
520,12,19,19.01.2025,3,431,509,78,234
588,6,30,01.01.2025,15,150,197,47,705
170,13,25,20.01.2025,19,339,500,161,3059
431,25,20,19.01.2025,13,465,652,187,2431
304,27,18,21.01.2025,20,408,539,131,2620
748,22,22,25.01.2025,15,65,94,29,435
303,5,18,26.01.2025,12,316,386,70,840
975,19,8,05.01.2025,11,309,339,30,330
22,25,17,29.01.2025,10,311,413,102,1020
999,28,7,31.01.2025,6,475,539,64,384
190,27,25,26.01.2025,8,170,238,68,544
795,14,13,19.01.2025,18,500,537,37,666
638,23,1,18.01.2025,16,99,122,23,368
121,15,25,14.01.2025,1,348,435,87,87
768,7,10,18.01.2025,8,286,378,92,736
334,22,22,20.01.2025,12,352,408,56,672
973,17,5,22.01.2025,18,407,431,24,432
839,10,27,01.01.2025,12,228,330,102,1224
121,5,29,23.01.2025,19,332,413,81,1539
31,18,26,28.01.2025,5,227,299,72,360
368,18,22,05.01.2025,14,358,419,61,854
803,18,13,19.01.2025,13,196,242,46,598
75,30,27,07.01.2025,1,307,389,82,82
437,4,22,27.01.2025,5,412,468,56,280
542,11,19,11.01.2025,4,148,212,64,256
796,9,13,18.01.2025,5,143,188,45,225
792,10,28,17.01.2025,9,340,495,155,1395
876,1,27,31.01.2025,6,264,367,103,618
2,1,22,28.01.2025,17,242,319,77,1309
930,29,13,03.01.2025,2,79,113,34,68
782,13,17,07.01.2025,3,61,82,21,63
834,20,11,27.01.2025,1,44,65,21,21
385,17,2,20.01.2025,9,61,72,11,99
622,3,28,24.01.2025,11,47,59,12,132
793,6,28,21.01.2025,17,120,173,53,901
973,15,21,14.01.2025,5,45,62,17,85
226,21,9,09.01.2025,1,478,608,130,130
454,20,10,13.01.2025,6,49,67,18,108
460,29,5,24.01.2025,13,410,590,180,2340
688,5,20,05.01.2025,12,29,38,9,108
95,24,28,16.01.2025,16,492,602,110,1760
49,6,19,23.01.2025,20,54,75,21,420
270,1,13,30.01.2025,17,365,471,106,1802
69,7,7,07.01.2025,15,138,150,12,180
136,30,11,12.01.2025,6,123,148,25,150
985,13,4,15.01.2025,18,494,536,42,756
11,7,28,29.01.2025,6,367,402,35,210
618,6,1,13.01.2025,4,132,183,51,204
244,27,17,22.01.2025,11,87,110,23,253
560,19,12,13.01.2025,4,117,134,17,68
77,29,22,18.01.2025,10,177,207,30,300
51,24,6,28.01.2025,19,185,198,13,247
885,13,10,17.01.2025,2,438,479,41,82
283,10,2,08.01.2025,15,124,168,44,660
852,4,13,16.01.2025,18,75,110,35,630
927,15,24,26.01.2025,16,361,462,101,1616
938,6,3,01.01.2025,6,347,379,32,192
504,29,27,19.01.2025,18,443,502,59,1062
644,7,9,17.01.2025,14,107,140,33,462
349,24,27,16.01.2025,20,244,282,38,760
437,28,27,08.01.2025,18,144,208,64,1152
869,17,6,18.01.2025,11,229,243,14,154
235,19,25,15.01.2025,1,272,382,110,110
603,18,24,21.01.2025,14,226,307,81,1134
122,15,16,23.01.2025,2,226,325,99,198
509,8,29,13.01.2025,17,419,592,173,2941
881,26,1,12.01.2025,1,212,274,62,62
87,22,27,06.01.2025,6,134,179,45,270
336,22,6,03.01.2025,13,367,530,163,2119
375,1,25,11.01.2025,18,249,366,117,2106
704,9,13,19.01.2025,5,395,428,33,165
667,25,30,06.01.2025,3,312,347,35,105
582,13,15,25.01.2025,20,40,52,12,240
548,25,22,09.01.2025,8,240,319,79,632
555,10,26,18.01.2025,1,101,112,11,11
941,2,28,11.01.2025,2,329,448,119,238
236,22,27,18.01.2025,14,388,512,124,1736
709,9,17,10.01.2025,5,172,249,77,385
346,28,24,20.01.2025,17,303,404,101,1717
663,3,10,12.01.2025,15,340,440,100,1500
469,26,25,30.01.2025,2,375,504,129,258
94,12,30,06.01.2025,8,478,619,141,1128
459,13,16,07.01.2025,18,413,614,201,3618
192,1,30,20.01.2025,15,160,195,35,525
80,20,3,24.01.2025,15,273,362,89,1335
505,13,18,05.01.2025,20,314,459,145,2900
518,16,23,28.01.2025,5,448,639,191,955
328,17,19,07.01.2025,16,403,430,27,432
659,18,11,22.01.2025,17,20,25,5,85
191,22,21,26.01.2025,8,208,223,15,120
276,29,1,22.01.2025,12,406,608,202,2424
391,24,20,11.01.2025,15,311,332,21,315
690,4,6,09.01.2025,18,110,154,44,792
351,28,12,09.01.2025,9,113,166,53,477
403,15,19,13.01.2025,7,91,110,19,133
835,20,10,06.01.2025,8,344,509,165,1320
700,18,24,19.01.2025,9,424,520,96,864
888,8,28,31.01.2025,7,299,443,144,1008
946,19,30,04.01.2025,11,227,255,28,308
82,22,22,30.01.2025,11,115,148,33,363
346,24,30,16.01.2025,6,487,718,231,1386
399,6,19,06.01.2025,13,321,369,48,624
712,8,11,17.01.2025,20,420,571,151,3020
105,8,28,31.01.2025,17,74,96,22,374
401,12,12,01.01.2025,16,285,333,48,768
396,28,18,11.01.2025,1,332,396,64,64
500,25,22,10.01.2025,9,134,141,7,63
314,21,20,04.01.2025,17,442,579,137,2329
949,27,4,30.01.2025,16,326,413,87,1392
49,7,17,27.01.2025,11,317,367,50,550
813,2,3,27.01.2025,12,127,156,29,348
91,11,10,15.01.2025,4,187,266,79,316
208,4,7,24.01.2025,6,207,275,68,408
220,27,14,16.01.2025,17,69,80,11,187
437,15,28,11.01.2025,2,28,41,13,26
273,28,5,23.01.2025,4,165,244,79,316
812,3,2,25.01.2025,12,110,138,28,336
631,17,4,23.01.2025,19,288,364,76,1444
62,20,24,27.01.2025,5,407,515,108,540
279,12,5,08.01.2025,17,289,376,87,1479
786,12,13,06.01.2025,5,498,597,99,495
829,30,26,25.01.2025,14,233,251,18,252
333,28,25,19.01.2025,17,232,326,94,1598
461,18,15,09.01.2025,10,461,519,58,580
505,23,11,17.01.2025,11,399,579,180,1980
287,18,21,11.01.2025,19,236,350,114,2166
816,28,11,26.01.2025,20,167,189,22,440
132,10,20,30.01.2025,4,62,88,26,104
439,11,1,05.01.2025,1,471,503,32,32
160,26,10,12.01.2025,8,320,429,109,872
238,3,8,05.01.2025,4,429,513,84,336
325,3,7,01.01.2025,11,194,246,52,572
535,7,21,21.01.2025,14,304,420,116,1624
699,4,10,10.01.2025,10,455,584,129,1290
632,13,13,19.01.2025,20,386,491,105,2100
512,28,23,30.01.2025,8,236,295,59,472
653,26,15,24.01.2025,10,349,431,82,820
765,1,5,12.01.2025,17,398,544,146,2482
942,12,10,07.01.2025,3,289,332,43,129
834,6,23,18.01.2025,4,397,441,44,176
857,3,5,07.01.2025,20,93,134,41,820
661,1,21,10.01.2025,20,67,72,5,100
757,1,29,03.01.2025,17,145,179,34,578
502,6,7,23.01.2025,18,257,310,53,954
546,6,25,16.01.2025,13,285,390,105,1365
682,15,6,26.01.2025,6,480,580,100,600
476,11,9,24.01.2025,12,307,409,102,1224
496,5,13,05.01.2025,19,36,43,7,133
634,3,17,27.01.2025,15,215,313,98,1470
568,8,24,04.01.2025,13,47,61,14,182
187,23,15,31.01.2025,4,350,441,91,364
65,15,22,07.01.2025,7,246,345,99,693
746,7,30,19.01.2025,19,115,170,55,1045
949,1,11,06.01.2025,6,99,130,31,186
581,30,20,07.01.2025,14,471,531,60,840
104,24,14,26.01.2025,11,356,511,155,1705
78,21,10,08.01.2025,18,301,336,35,630
919,6,11,21.01.2025,12,379,562,183,2196
809,19,28,29.01.2025,18,124,148,24,432
963,10,9,14.01.2025,4,270,372,102,408
475,24,24,29.01.2025,16,132,148,16,256
403,10,8,31.01.2025,1,312,374,62,62
887,9,19,26.01.2025,16,332,455,123,1968
120,6,29,15.01.2025,20,442,633,191,3820
597,15,1,06.01.2025,19,109,136,27,513
166,2,11,08.01.2025,20,259,360,101,2020
933,16,24,04.01.2025,7,271,371,100,700
838,11,5,19.01.2025,18,488,626,138,2484
134,5,1,26.01.2025,4,88,124,36,144
407,24,26,24.01.2025,2,300,340,40,80
39,29,2,09.01.2025,18,270,357,87,1566
963,22,29,15.01.2025,17,277,354,77,1309
583,15,12,22.01.2025,7,374,517,143,1001
722,29,12,22.01.2025,17,202,229,27,459
653,18,13,30.01.2025,2,428,611,183,366
769,26,27,25.01.2025,2,123,130,7,14
310,8,30,13.01.2025,3,437,571,134,402
814,19,11,04.01.2025,15,54,65,11,165
893,6,7,28.01.2025,19,480,705,225,4275
96,1,25,05.01.2025,19,105,147,42,798
748,19,24,12.01.2025,1,67,79,12,12
490,9,21,28.01.2025,17,118,127,9,153
844,7,30,01.01.2025,19,232,347,115,2185
85,7,22,19.01.2025,16,67,89,22,352
118,5,13,02.01.2025,5,394,441,47,235
213,6,4,28.01.2025,15,229,289,60,900
677,5,2,04.01.2025,20,414,574,160,3200
92,4,4,13.01.2025,13,73,81,8,104
186,2,4,20.01.2025,2,248,276,28,56
352,22,24,30.01.2025,17,409,510,101,1717
255,7,30,20.01.2025,7,38,45,7,49
198,14,13,11.01.2025,7,294,310,16,112
184,15,21,29.01.2025,10,417,536,119,1190
154,25,26,10.01.2025,6,71,77,6,36
24,26,18,22.01.2025,13,340,437,97,1261
945,11,28,01.01.2025,19,360,431,71,1349
138,5,20,10.01.2025,13,85,90,5,65
843,19,7,23.01.2025,12,199,274,75,900
860,26,3,26.01.2025,1,432,635,203,203
733,22,19,20.01.2025,12,85,119,34,408
598,16,27,01.01.2025,4,137,204,67,268
122,5,9,07.01.2025,14,498,603,105,1470
335,18,12,13.01.2025,10,410,601,191,1910
218,28,1,09.01.2025,3,474,656,182,546
160,1,5,16.01.2025,2,236,261,25,50
629,6,16,08.01.2025,18,273,321,48,864
171,20,20,02.01.2025,15,388,533,145,2175
88,14,14,28.01.2025,19,31,38,7,133
134,5,28,10.01.2025,17,352,519,167,2839
110,11,11,09.01.2025,6,443,640,197,1182
647,21,1,08.01.2025,10,36,42,6,60
128,1,20,12.01.2025,13,274,357,83,1079
787,21,15,12.01.2025,14,477,670,193,2702
638,3,12,15.01.2025,19,366,512,146,2774
357,12,10,14.01.2025,6,146,170,24,144
862,4,5,27.01.2025,9,256,319,63,567
114,2,18,02.01.2025,4,428,600,172,688
126,2,7,01.01.2025,14,303,349,46,644
461,13,9,25.01.2025,3,270,303,33,99
529,2,18,01.01.2025,17,69,98,29,493
687,12,15,04.01.2025,5,323,344,21,105
738,4,11,23.01.2025,2,257,280,23,46
521,2,14,15.01.2025,4,146,157,11,44
730,8,11,03.01.2025,2,436,629,193,386
370,17,9,16.01.2025,10,122,172,50,500
180,4,23,07.01.2025,1,28,37,9,9
187,12,18,28.01.2025,17,366,443,77,1309
437,23,14,20.01.2025,9,274,291,17,153
124,18,1,11.01.2025,7,363,512,149,1043
796,7,20,13.01.2025,6,441,624,183,1098
962,15,30,09.01.2025,14,475,583,108,1512
843,5,3,12.01.2025,19,52,67,15,285
851,5,23,28.01.2025,16,29,31,2,32
273,13,14,14.01.2025,4,179,266,87,348
642,19,1,25.01.2025,3,427,471,44,132
458,19,16,22.01.2025,15,83,121,38,570
39,1,24,21.01.2025,9,319,369,50,450
787,18,3,27.01.2025,19,407,556,149,2831
725,21,23,09.01.2025,19,21,25,4,76
684,23,3,11.01.2025,6,41,48,7,42
624,17,2,26.01.2025,19,172,231,59,1121
613,27,16,30.01.2025,13,421,557,136,1768
505,21,8,21.01.2025,3,121,152,31,93
450,22,4,27.01.2025,14,215,284,69,966
768,10,4,14.01.2025,13,70,78,8,104
497,10,2,16.01.2025,16,312,365,53,848
239,27,6,25.01.2025,11,243,275,32,352
755,23,17,22.01.2025,19,324,382,58,1102
583,30,4,20.01.2025,15,433,458,25,375
729,27,30,09.01.2025,6,472,587,115,690
979,22,5,01.01.2025,7,259,278,19,133
472,27,29,18.01.2025,6,74,81,7,42
57,27,6,22.01.2025,1,342,483,141,141
643,9,4,28.01.2025,18,429,467,38,684
379,22,23,25.01.2025,20,312,400,88,1760
517,29,25,19.01.2025,15,481,537,56,840
115,3,15,31.01.2025,1,394,562,168,168
516,21,19,31.01.2025,10,495,667,172,1720
32,27,27,28.01.2025,3,299,439,140,420
916,9,10,18.01.2025,5,102,142,40,200
463,29,29,12.01.2025,17,282,390,108,1836
239,19,15,17.01.2025,12,244,359,115,1380
553,6,2,26.01.2025,1,152,197,45,45
429,16,11,16.01.2025,3,444,635,191,573
863,7,13,19.01.2025,3,173,228,55,165
94,25,21,22.01.2025,3,498,558,60,180
913,16,22,27.01.2025,19,158,222,64,1216
615,22,14,18.01.2025,17,97,122,25,425
771,13,19,31.01.2025,16,360,481,121,1936
274,2,19,12.01.2025,8,385,425,40,320
927,26,3,26.01.2025,19,236,260,24,456
438,2,16,29.01.2025,18,348,404,56,1008
500,10,22,29.01.2025,18,305,351,46,828
741,13,12,04.01.2025,15,317,447,130,1950
825,22,22,21.01.2025,13,113,134,21,273
47,29,20,30.01.2025,14,379,507,128,1792
856,20,13,13.01.2025,18,147,202,55,990
959,20,14,01.01.2025,9,251,321,70,630
156,3,15,01.01.2025,5,307,369,62,310
396,5,6,30.01.2025,12,316,440,124,1488
846,21,14,09.01.2025,18,299,331,32,576
515,19,26,25.01.2025,8,156,201,45,360
546,23,17,08.01.2025,20,41,59,18,360
141,9,13,16.01.2025,5,405,521,116,580
617,19,3,14.01.2025,1,339,483,144,144
92,10,3,07.01.2025,4,320,465,145,580
743,8,12,22.01.2025,20,347,492,145,2900
841,28,7,23.01.2025,14,75,87,12,168
487,24,14,29.01.2025,1,194,220,26,26
255,2,30,09.01.2025,11,304,389,85,935
411,11,25,27.01.2025,1,485,545,60,60
929,9,25,10.01.2025,16,94,110,16,256
632,4,14,11.01.2025,2,466,530,64,128
297,9,1,26.01.2025,19,233,287,54,1026
65,16,25,24.01.2025,16,479,699,220,3520
766,3,25,17.01.2025,5,378,441,63,315
552,19,25,18.01.2025,2,299,387,88,176
930,24,1,28.01.2025,13,256,365,109,1417
149,4,9,03.01.2025,15,158,195,37,555
869,4,26,08.01.2025,11,338,383,45,495
404,21,13,31.01.2025,9,299,371,72,648
680,18,20,26.01.2025,8,377,561,184,1472
406,23,20,18.01.2025,15,179,263,84,1260
391,19,10,23.01.2025,3,187,225,38,114
268,11,26,22.01.2025,2,76,84,8,16
139,24,20,22.01.2025,6,49,70,21,126
800,16,12,08.01.2025,13,475,647,172,2236
360,4,3,16.01.2025,3,236,320,84,252
64,8,27,20.01.2025,18,405,566,161,2898
827,13,7,14.01.2025,11,147,182,35,385
727,21,5,04.01.2025,17,316,369,53,901
382,20,2,13.01.2025,16,23,25,2,32
609,21,21,19.01.2025,10,433,481,48,480
544,19,9,06.01.2025,2,170,249,79,158
385,22,28,09.01.2025,18,334,416,82,1476
510,14,2,11.01.2025,14,154,173,19,266
840,26,30,10.01.2025,11,236,340,104,1144
502,25,15,11.01.2025,18,476,506,30,540
462,26,10,25.01.2025,11,133,151,18,198
519,26,20,01.01.2025,14,86,100,14,196
802,12,9,26.01.2025,13,468,572,104,1352
134,28,21,06.01.2025,14,192,262,70,980
56,4,13,21.01.2025,11,329,435,106,1166
235,30,2,01.01.2025,14,102,146,44,616
122,6,5,10.01.2025,6,410,578,168,1008
439,29,16,23.01.2025,16,179,220,41,656
783,11,20,03.01.2025,13,34,37,3,39
182,9,23,04.01.2025,3,210,307,97,291
873,17,27,31.01.2025,9,293,413,120,1080
655,13,2,01.01.2025,18,27,30,3,54
603,17,13,16.01.2025,16,306,339,33,528
896,3,6,19.01.2025,20,471,694,223,4460
455,30,26,29.01.2025,1,496,700,204,204
457,5,23,14.01.2025,9,456,512,56,504
832,14,3,05.01.2025,4,490,551,61,244
209,17,9,08.01.2025,16,195,225,30,480
355,23,19,24.01.2025,13,463,643,180,2340
50,15,18,12.01.2025,6,208,310,102,612
971,17,6,10.01.2025,5,83,112,29,145
712,25,8,17.01.2025,11,469,546,77,847
817,25,9,02.01.2025,2,366,540,174,348
261,10,21,12.01.2025,10,353,445,92,920
758,5,28,07.01.2025,3,77,86,9,27
199,5,30,23.01.2025,15,166,232,66,990
630,25,24,24.01.2025,16,369,544,175,2800
752,27,3,15.01.2025,15,481,672,191,2865
783,7,8,22.01.2025,10,350,469,119,1190
761,6,16,06.01.2025,1,118,170,52,52
569,18,13,22.01.2025,6,439,475,36,216
487,12,23,01.01.2025,18,51,72,21,378
69,20,26,13.01.2025,8,443,473,30,240
337,23,21,07.01.2025,2,217,287,70,140
812,8,11,24.01.2025,18,277,394,117,2106
274,20,29,08.01.2025,11,454,524,70,770
313,1,2,28.01.2025,4,283,306,23,92
894,13,15,16.01.2025,17,166,213,47,799
69,27,14,12.01.2025,6,162,189,27,162
939,22,12,09.01.2025,9,238,256,18,162
545,7,27,18.01.2025,12,372,402,30,360
618,20,7,15.01.2025,18,74,78,4,72
703,21,25,30.01.2025,11,143,192,49,539
127,5,18,15.01.2025,17,282,380,98,1666
896,18,24,13.01.2025,20,310,406,96,1920
601,17,17,25.01.2025,5,473,685,212,1060
708,20,2,10.01.2025,11,266,349,83,913
137,27,16,04.01.2025,9,449,562,113,1017
141,9,13,08.01.2025,2,434,473,39,78
747,20,18,24.01.2025,13,383,446,63,819
275,5,29,07.01.2025,18,352,405,53,954
461,6,17,08.01.2025,8,310,436,126,1008
155,4,21,22.01.2025,18,275,292,17,306
943,27,6,31.01.2025,19,127,190,63,1197
530,28,17,30.01.2025,2,384,503,119,238
947,7,6,05.01.2025,4,42,60,18,72
16,6,8,06.01.2025,1,28,30,2,2
535,13,15,14.01.2025,13,78,83,5,65
31,17,27,21.01.2025,20,363,523,160,3200
942,26,22,16.01.2025,13,82,87,5,65
86,27,10,07.01.2025,12,216,304,88,1056
296,2,30,24.01.2025,8,479,622,143,1144
951,11,21,08.01.2025,3,321,411,90,270
49,26,16,09.01.2025,14,420,583,163,2282
877,18,21,05.01.2025,7,181,215,34,238
888,19,11,27.01.2025,4,37,39,2,8
751,25,1,15.01.2025,13,488,552,64,832
379,27,27,09.01.2025,11,400,526,126,1386
449,27,3,11.01.2025,1,482,656,174,174
447,14,29,22.01.2025,13,236,276,40,520
76,1,29,21.01.2025,13,489,595,106,1378
889,3,23,03.01.2025,8,164,172,8,64
458,18,11,04.01.2025,13,334,474,140,1820
939,19,9,25.01.2025,20,260,278,18,360
630,1,12,25.01.2025,18,409,465,56,1008
430,18,7,10.01.2025,18,92,112,20,360
744,19,19,20.01.2025,13,101,124,23,299
471,26,1,17.01.2025,8,296,369,73,584
569,17,29,21.01.2025,19,80,101,21,399
699,22,21,16.01.2025,20,57,69,12,240
380,26,19,14.01.2025,6,205,257,52,312
80,19,15,29.01.2025,13,31,42,11,143
243,5,1,31.01.2025,3,87,108,21,63
719,25,12,15.01.2025,17,315,410,95,1615
894,6,13,01.01.2025,10,60,78,18,180
6,25,29,19.01.2025,12,498,554,56,672
75,26,15,12.01.2025,11,281,335,54,594
981,4,15,16.01.2025,15,168,230,62,930
688,24,5,16.01.2025,10,217,287,70,700
803,3,4,18.01.2025,18,94,111,17,306
624,23,19,13.01.2025,5,243,284,41,205
167,5,20,31.01.2025,16,191,245,54,864
77,15,2,26.01.2025,9,389,536,147,1323
273,30,5,04.01.2025,18,197,267,70,1260
382,16,27,27.01.2025,2,183,228,45,90
518,5,1,28.01.2025,19,92,102,10,190
891,12,16,27.01.2025,1,383,501,118,118
961,24,2,03.01.2025,13,132,194,62,806
921,11,14,09.01.2025,2,255,287,32,64
848,5,9,28.01.2025,16,110,140,30,480
942,18,20,11.01.2025,9,22,24,2,18
498,17,21,31.01.2025,17,113,127,14,238
269,23,15,08.01.2025,3,89,133,44,132
75,13,30,18.01.2025,12,23,29,6,72
61,26,12,31.01.2025,18,348,475,127,2286
972,2,3,04.01.2025,19,210,313,103,1957
626,6,28,15.01.2025,4,437,588,151,604
323,6,14,03.01.2025,2,400,485,85,170
970,27,28,26.01.2025,15,47,67,20,300
140,7,2,02.01.2025,15,56,79,23,345
608,11,22,01.01.2025,1,267,311,44,44
718,27,21,03.01.2025,17,313,439,126,2142
576,23,11,23.01.2025,10,136,192,56,560
145,26,19,17.01.2025,15,231,304,73,1095
587,7,28,28.01.2025,14,196,217,21,294
264,9,16,25.01.2025,4,231,329,98,392
91,20,26,24.01.2025,17,493,549,56,952
486,7,26,10.01.2025,18,62,71,9,162
790,24,25,03.01.2025,2,152,182,30,60
158,12,25,18.01.2025,20,226,260,34,680
188,3,15,29.01.2025,10,129,192,63,630
803,26,24,12.01.2025,15,151,194,43,645
903,27,8,11.01.2025,5,235,303,68,340
416,28,9,18.01.2025,14,39,54,15,210
459,7,19,18.01.2025,8,387,580,193,1544
913,10,30,18.01.2025,17,119,154,35,595
991,6,11,26.01.2025,8,215,315,100,800
817,30,21,28.01.2025,10,227,332,105,1050
554,2,11,11.01.2025,2,248,351,103,206
950,9,23,02.01.2025,13,204,255,51,663
344,12,3,12.01.2025,13,101,115,14,182
188,24,27,01.01.2025,20,37,48,11,220
342,29,25,11.01.2025,4,41,52,11,44
717,10,24,01.01.2025,20,72,104,32,640
103,3,4,15.01.2025,17,218,238,20,340
704,1,5,11.01.2025,10,380,560,180,1800
699,13,2,22.01.2025,6,106,142,36,216
416,23,20,12.01.2025,8,181,257,76,608
955,9,23,31.01.2025,3,369,417,48,144
1,29,3,22.01.2025,5,113,141,28,140
322,26,26,29.01.2025,19,202,291,89,1691
61,1,6,28.01.2025,14,408,578,170,2380
942,2,3,11.01.2025,4,192,220,28,112
737,30,6,30.01.2025,12,428,575,147,1764
703,19,9,15.01.2025,20,193,205,12,240
290,2,27,16.01.2025,4,411,513,102,408
196,28,5,15.01.2025,20,301,323,22,440
363,23,24,19.01.2025,12,349,371,22,264
237,22,25,27.01.2025,3,44,46,2,6
403,10,22,20.01.2025,7,175,245,70,490
13,7,23,29.01.2025,19,80,84,4,76
357,5,2,29.01.2025,7,239,256,17,119
627,23,25,10.01.2025,3,56,72,16,48
642,20,30,04.01.2025,8,354,425,71,568
631,20,29,06.01.2025,18,203,245,42,756
769,8,30,12.01.2025,19,194,216,22,418
371,13,3,02.01.2025,2,228,338,110,220
584,19,1,21.01.2025,1,223,291,68,68
966,30,30,27.01.2025,18,50,54,4,72
397,23,15,16.01.2025,9,42,59,17,153
917,8,16,17.01.2025,9,375,509,134,1206
734,29,7,22.01.2025,7,311,445,134,938
315,19,23,31.01.2025,12,461,531,70,840
3,13,16,15.01.2025,13,408,584,176,2288
161,11,11,01.01.2025,7,102,136,34,238
849,1,3,16.01.2025,7,214,255,41,287
134,29,13,06.01.2025,10,74,93,19,190
261,6,19,02.01.2025,6,358,528,170,1020
720,25,5,08.01.2025,8,177,212,35,280
98,3,1,24.01.2025,2,312,333,21,42
917,29,14,27.01.2025,2,202,234,32,64
653,25,18,18.01.2025,14,281,327,46,644
15,5,29,29.01.2025,4,65,79,14,56
455,8,26,05.01.2025,20,494,520,26,520
918,22,11,31.01.2025,15,191,265,74,1110
577,18,26,18.01.2025,15,185,266,81,1215
882,6,3,06.01.2025,19,397,523,126,2394
434,10,6,13.01.2025,2,138,204,66,132
247,14,22,26.01.2025,6,428,451,23,138
711,5,15,12.01.2025,12,286,324,38,456
262,15,15,29.01.2025,1,375,494,119,119
2,30,15,04.01.2025,3,430,518,88,264
166,8,23,25.01.2025,18,23,26,3,54
442,23,6,04.01.2025,20,391,527,136,2720
70,12,30,30.01.2025,17,422,467,45,765
587,30,16,24.01.2025,1,371,451,80,80
97,14,4,25.01.2025,4,277,345,68,272
549,12,11,18.01.2025,18,61,84,23,414
902,11,19,24.01.2025,15,373,555,182,2730
172,23,23,04.01.2025,13,304,390,86,1118
726,2,25,25.01.2025,11,489,565,76,836
548,25,26,23.01.2025,20,459,527,68,1360
561,13,20,31.01.2025,5,280,408,128,640
492,29,6,26.01.2025,17,161,193,32,544
904,10,28,02.01.2025,4,283,315,32,128
740,25,16,06.01.2025,1,47,53,6,6
219,20,10,18.01.2025,5,340,499,159,795
235,5,22,31.01.2025,5,50,58,8,40
285,9,16,09.01.2025,7,394,437,43,301
768,28,17,24.01.2025,4,53,66,13,52
977,12,19,20.01.2025,7,378,399,21,147
130,24,21,24.01.2025,1,85,91,6,6
213,2,9,30.01.2025,5,132,189,57,285
134,23,15,16.01.2025,12,455,668,213,2556
713,29,4,08.01.2025,12,387,440,53,636
921,25,25,05.01.2025,17,67,83,16,272
908,2,14,09.01.2025,13,120,126,6,78
845,2,12,23.01.2025,20,138,203,65,1300
451,15,15,12.01.2025,13,482,633,151,1963
626,18,8,05.01.2025,3,370,392,22,66
166,20,3,14.01.2025,3,260,308,48,144
886,20,2,28.01.2025,6,318,441,123,738
544,7,4,31.01.2025,1,154,179,25,25
989,24,18,27.01.2025,9,54,72,18,162
402,6,5,19.01.2025,3,430,620,190,570
962,4,14,16.01.2025,1,276,297,21,21
416,18,29,12.01.2025,14,450,669,219,3066
403,15,25,29.01.2025,2,216,250,34,68
404,30,5,03.01.2025,19,282,398,116,2204
371,12,2,10.01.2025,19,166,232,66,1254
803,9,10,21.01.2025,2,245,364,119,238
401,7,22,10.01.2025,20,414,470,56,1120
231,19,14,12.01.2025,1,174,233,59,59
386,6,15,07.01.2025,5,453,510,57,285
138,14,29,27.01.2025,4,65,77,12,48
151,9,7,26.01.2025,14,360,400,40,560
849,24,11,31.01.2025,18,376,449,73,1314
690,5,4,22.01.2025,17,455,583,128,2176
908,2,18,24.01.2025,16,324,479,155,2480
633,4,24,20.01.2025,14,95,127,32,448
742,10,30,27.01.2025,3,356,470,114,342
700,13,9,08.01.2025,7,306,368,62,434
246,29,5,24.01.2025,10,255,380,125,1250
192,29,12,22.01.2025,2,206,266,60,120
231,8,9,31.01.2025,7,437,466,29,203
707,8,3,03.01.2025,12,454,613,159,1908
512,13,1,12.01.2025,9,209,301,92,828
798,24,13,30.01.2025,19,365,427,62,1178
339,26,15,13.01.2025,19,384,558,174,3306
817,9,24,25.01.2025,11,122,148,26,286
246,14,12,19.01.2025,16,458,537,79,1264
396,30,24,20.01.2025,17,215,319,104,1768
66,14,7,29.01.2025,9,84,91,7,63
352,10,12,01.01.2025,18,377,550,173,3114
587,11,30,27.01.2025,20,489,720,231,4620
521,3,27,11.01.2025,6,409,503,94,564
147,11,26,31.01.2025,12,314,384,70,840
310,28,15,06.01.2025,4,456,668,212,848
14,15,28,09.01.2025,5,142,173,31,155
735,19,4,09.01.2025,6,217,240,23,138
834,10,2,22.01.2025,9,353,457,104,936
201,8,26,29.01.2025,6,232,329,97,582
309,25,11,29.01.2025,10,129,177,48,480
58,15,19,14.01.2025,8,356,497,141,1128
232,4,30,22.01.2025,1,35,45,10,10
703,24,4,16.01.2025,17,440,533,93,1581
172,5,30,04.01.2025,3,208,287,79,237
458,3,30,30.01.2025,18,163,194,31,558
215,12,27,22.01.2025,9,398,578,180,1620
444,29,29,17.01.2025,15,152,178,26,390
697,21,29,22.01.2025,16,44,48,4,64
199,21,6,28.01.2025,1,374,482,108,108
816,11,29,24.01.2025,5,133,194,61,305
474,15,5,19.01.2025,14,224,304,80,1120
417,7,7,15.01.2025,1,77,91,14,14
64,21,27,02.01.2025,12,437,489,52,624
450,30,18,03.01.2025,1,494,727,233,233
334,21,17,22.01.2025,2,38,40,2,4
156,16,28,22.01.2025,6,393,435,42,252
317,6,11,15.01.2025,7,81,101,20,140
619,10,8,31.01.2025,19,374,526,152,2888
788,30,7,25.01.2025,13,290,410,120,1560
711,3,16,06.01.2025,2,121,134,13,26
388,20,12,12.01.2025,5,285,399,114,570
181,30,24,01.01.2025,20,350,397,47,940
744,21,28,16.01.2025,8,196,217,21,168
383,20,12,27.01.2025,7,485,560,75,525
174,5,21,23.01.2025,15,136,186,50,750
195,29,17,20.01.2025,20,109,115,6,120
373,28,16,23.01.2025,8,420,508,88,704
133,8,14,14.01.2025,3,279,337,58,174
36,16,13,03.01.2025,2,302,450,148,296
47,17,6,13.01.2025,20,274,385,111,2220
124,25,17,26.01.2025,6,444,637,193,1158
391,2,4,01.01.2025,16,83,93,10,160
103,12,21,28.01.2025,18,133,193,60,1080
572,22,18,21.01.2025,6,381,415,34,204
880,16,22,26.01.2025,14,492,673,181,2534
269,18,28,09.01.2025,13,264,301,37,481
454,25,9,05.01.2025,5,127,189,62,310
988,7,23,05.01.2025,5,102,149,47,235
521,1,21,04.01.2025,20,169,197,28,560
158,12,18,22.01.2025,19,98,135,37,703
681,22,21,28.01.2025,6,111,153,42,252
363,13,2,13.01.2025,6,440,638,198,1188
346,7,12,21.01.2025,2,480,588,108,216
854,29,21,26.01.2025,16,462,651,189,3024
69,28,21,04.01.2025,18,48,56,8,144
701,26,16,09.01.2025,4,443,512,69,276
498,22,11,08.01.2025,18,176,246,70,1260
669,18,11,05.01.2025,1,474,638,164,164
226,25,13,06.01.2025,13,358,385,27,351
804,10,22,13.01.2025,8,312,444,132,1056
485,22,12,13.01.2025,3,180,248,68,204
810,16,2,12.01.2025,11,148,193,45,495
819,6,30,21.01.2025,3,208,226,18,54
738,9,3,03.01.2025,19,412,603,191,3629
351,11,14,09.01.2025,1,311,457,146,146
94,19,24,13.01.2025,19,128,168,40,760
462,18,16,12.01.2025,6,50,63,13,78
1,26,5,01.01.2025,9,106,132,26,234
163,22,1,03.01.2025,20,463,622,159,3180
99,5,24,22.01.2025,3,96,114,18,54
964,7,19,08.01.2025,14,483,713,230,3220
414,15,18,19.01.2025,15,227,242,15,225
978,17,16,07.01.2025,3,104,129,25,75
915,16,8,03.01.2025,20,414,469,55,1100
449,21,13,22.01.2025,1,255,378,123,123
713,19,17,18.01.2025,20,263,353,90,1800
431,12,8,27.01.2025,7,343,466,123,861
922,30,23,23.01.2025,10,123,136,13,130
94,21,25,13.01.2025,11,178,202,24,264
977,17,22,24.01.2025,19,346,415,69,1311
239,4,5,02.01.2025,6,81,106,25,150
361,27,1,25.01.2025,12,268,379,111,1332
279,10,19,21.01.2025,15,429,628,199,2985
492,1,23,02.01.2025,1,91,113,22,22
575,15,13,10.01.2025,10,298,402,104,1040
446,16,13,10.01.2025,19,249,328,79,1501
946,10,29,31.01.2025,3,234,332,98,294
395,29,12,14.01.2025,2,151,217,66,132
34,1,14,08.01.2025,12,181,247,66,792
482,7,2,19.01.2025,13,159,207,48,624
632,6,15,15.01.2025,3,76,110,34,102
580,21,12,05.01.2025,19,376,459,83,1577
329,7,2,23.01.2025,12,323,407,84,1008
9,6,12,12.01.2025,4,102,131,29,116
474,14,22,07.01.2025,14,173,200,27,378
81,28,11,20.01.2025,10,489,629,140,1400
871,18,27,19.01.2025,11,333,409,76,836
945,10,14,22.01.2025,14,146,173,27,378
339,25,9,28.01.2025,10,401,461,60,600
727,9,26,03.01.2025,10,333,368,35,350
584,30,20,19.01.2025,8,405,536,131,1048
854,23,28,09.01.2025,9,316,396,80,720
232,19,29,09.01.2025,14,155,164,9,126
778,22,27,22.01.2025,18,107,119,12,216
49,19,11,17.01.2025,14,85,112,27,378
489,24,30,07.01.2025,19,362,513,151,2869
658,25,29,17.01.2025,19,459,675,216,4104
103,8,6,04.01.2025,1,477,664,187,187
457,5,2,23.01.2025,6,78,112,34,204
780,2,16,11.01.2025,10,480,688,208,2080
357,7,10,21.01.2025,14,209,251,42,588
820,19,5,28.01.2025,5,39,45,6,30
44,10,9,19.01.2025,14,454,539,85,1190
952,3,5,24.01.2025,20,134,175,41,820
843,1,5,29.01.2025,12,74,82,8,96
118,7,24,28.01.2025,15,190,273,83,1245
886,12,17,23.01.2025,20,220,250,30,600
597,11,21,22.01.2025,16,21,27,6,96
441,26,3,30.01.2025,19,332,381,49,931
71,9,23,12.01.2025,18,172,195,23,414
713,11,13,13.01.2025,8,63,68,5,40
957,18,18,12.01.2025,2,473,540,67,134
912,6,7,27.01.2025,14,100,147,47,658
759,5,2,28.01.2025,8,119,142,23,184
300,6,9,14.01.2025,7,355,390,35,245
309,8,22,15.01.2025,19,232,296,64,1216
710,22,26,22.01.2025,13,420,596,176,2288
852,1,2,18.01.2025,11,383,524,141,1551
145,19,28,09.01.2025,13,405,531,126,1638
52,5,29,26.01.2025,3,351,473,122,366
499,15,29,10.01.2025,3,258,301,43,129
39,10,7,27.01.2025,11,49,55,6,66
550,26,26,27.01.2025,12,44,49,5,60
835,18,20,31.01.2025,9,236,289,53,477
186,15,25,11.01.2025,6,121,138,17,102
533,5,20,26.01.2025,8,24,27,3,24
138,11,13,19.01.2025,4,130,148,18,72
11,8,1,08.01.2025,7,149,184,35,245
452,3,24,23.01.2025,4,363,528,165,660
803,15,12,30.01.2025,1,244,350,106,106
146,25,16,20.01.2025,20,197,273,76,1520
323,8,29,24.01.2025,2,108,127,19,38
380,7,2,03.01.2025,6,486,561,75,450
596,18,25,09.01.2025,16,107,124,17,272
222,9,23,30.01.2025,5,43,48,5,25
304,15,3,31.01.2025,19,434,600,166,3154
940,25,1,03.01.2025,15,387,435,48,720
168,22,26,05.01.2025,10,46,67,21,210
60,15,27,29.01.2025,14,489,696,207,2898
677,29,18,15.01.2025,4,445,651,206,824
658,21,23,16.01.2025,11,442,516,74,814
109,20,26,27.01.2025,20,499,718,219,4380
948,9,2,13.01.2025,12,347,449,102,1224
550,28,30,15.01.2025,5,423,573,150,750
645,5,11,17.01.2025,3,112,125,13,39
614,2,26,31.01.2025,19,420,571,151,2869
395,13,25,18.01.2025,10,384,447,63,630
520,24,24,05.01.2025,8,268,311,43,344
193,15,19,25.01.2025,3,426,483,57,171
134,3,3,02.01.2025,4,291,366,75,300
526,2,8,23.01.2025,12,372,483,111,1332
827,30,24,20.01.2025,2,362,529,167,334
1000,29,3,15.01.2025,2,461,655,194,388
299,23,2,26.01.2025,8,326,364,38,304
107,19,20,20.01.2025,9,375,454,79,711
613,11,24,29.01.2025,4,272,298,26,104
180,5,29,16.01.2025,13,403,469,66,858
226,18,15,06.01.2025,6,30,36,6,36
297,5,5,04.01.2025,13,110,134,24,312
329,22,26,09.01.2025,19,470,630,160,3040
871,7,30,07.01.2025,1,374,484,110,110
201,7,10,10.01.2025,10,246,355,109,1090
854,1,10,17.01.2025,17,275,352,77,1309
595,30,11,01.01.2025,9,257,272,15,135
171,1,28,12.01.2025,20,369,450,81,1620
520,22,12,03.01.2025,20,412,595,183,3660
195,26,22,15.01.2025,16,151,201,50,800
926,6,13,14.01.2025,7,101,149,48,336
613,24,11,14.01.2025,8,157,178,21,168
944,16,16,11.01.2025,6,101,148,47,282
581,5,1,14.01.2025,3,473,582,109,327
556,3,5,26.01.2025,20,88,93,5,100
378,19,24,30.01.2025,6,97,128,31,186
120,3,11,30.01.2025,14,131,140,9,126
606,11,11,25.01.2025,19,225,260,35,665
251,15,22,24.01.2025,5,350,432,82,410
847,20,24,10.01.2025,6,41,51,10,60
78,11,22,09.01.2025,20,283,301,18,360
685,18,11,04.01.2025,7,124,171,47,329
229,21,18,25.01.2025,2,42,49,7,14
548,28,28,08.01.2025,6,52,74,22,132
86,6,28,05.01.2025,4,444,501,57,228
79,12,24,10.01.2025,17,359,524,165,2805
116,23,12,18.01.2025,5,465,579,114,570
428,18,16,13.01.2025,10,477,503,26,260
782,19,4,17.01.2025,11,154,200,46,506
60,13,10,10.01.2025,5,448,639,191,955
1,2,26,13.01.2025,6,311,456,145,870
938,30,16,15.01.2025,17,265,307,42,714
322,17,11,25.01.2025,13,346,426,80,1040
969,28,13,24.01.2025,10,416,576,160,1600
611,14,24,05.01.2025,7,171,230,59,413
115,20,5,23.01.2025,14,434,484,50,700
77,7,6,01.01.2025,10,373,402,29,290
292,6,20,09.01.2025,18,131,184,53,954
116,10,24,16.01.2025,17,489,707,218,3706
792,28,23,28.01.2025,4,66,83,17,68
630,15,5,27.01.2025,14,321,425,104,1456
628,9,19,23.01.2025,17,69,93,24,408
527,23,7,04.01.2025,18,30,32,2,36
897,14,14,14.01.2025,1,397,540,143,143
173,23,1,02.01.2025,1,198,291,93,93
766,6,18,11.01.2025,7,298,366,68,476
894,4,1,11.01.2025,2,187,264,77,154
277,8,29,17.01.2025,8,301,412,111,888
958,12,18,23.01.2025,6,493,610,117,702
830,20,6,22.01.2025,19,412,546,134,2546
62,15,13,18.01.2025,14,103,146,43,602
775,14,30,08.01.2025,8,110,157,47,376
911,7,29,28.01.2025,17,332,482,150,2550
690,26,29,31.01.2025,7,129,183,54,378
418,29,24,03.01.2025,17,192,256,64,1088
905,21,18,30.01.2025,13,110,135,25,325
108,8,14,18.01.2025,10,417,458,41,410
997,3,7,05.01.2025,17,425,476,51,867
922,8,23,20.01.2025,5,70,95,25,125
870,17,24,08.01.2025,12,479,543,64,768
755,20,24,28.01.2025,3,290,367,77,231
726,25,24,31.01.2025,1,227,336,109,109
494,16,13,04.01.2025,2,236,328,92,184
741,12,27,19.01.2025,6,23,31,8,48
957,18,17,04.01.2025,9,146,204,58,522
637,5,15,20.01.2025,15,229,252,23,345
941,17,23,04.01.2025,12,323,400,77,924
874,18,21,08.01.2025,18,374,443,69,1242
677,16,6,24.01.2025,1,386,548,162,162
155,23,13,13.01.2025,12,376,556,180,2160
409,18,13,25.01.2025,6,333,480,147,882
589,27,4,05.01.2025,11,249,284,35,385
632,17,19,19.01.2025,6,195,233,38,228
617,9,22,14.01.2025,1,411,514,103,103
306,29,5,19.01.2025,20,31,39,8,160
643,16,5,25.01.2025,20,230,285,55,1100
312,3,25,15.01.2025,19,336,413,77,1463
23,18,1,18.01.2025,20,254,302,48,960
697,16,9,18.01.2025,12,371,493,122,1464
585,10,13,09.01.2025,3,280,318,38,114
623,26,17,28.01.2025,10,77,95,18,180
249,10,27,15.01.2025,17,342,412,70,1190
409,24,19,18.01.2025,18,74,111,37,666
300,25,19,18.01.2025,1,155,183,28,28
11,26,20,06.01.2025,17,432,530,98,1666
11,11,6,04.01.2025,2,103,127,24,48
985,15,2,13.01.2025,13,168,218,50,650
924,2,1,27.01.2025,18,111,130,19,342
854,9,12,17.01.2025,4,414,476,62,248
570,29,18,19.01.2025,18,117,169,52,936
824,2,11,16.01.2025,10,361,511,150,1500
565,8,20,20.01.2025,16,154,219,65,1040
762,4,18,12.01.2025,14,463,535,72,1008
153,30,15,26.01.2025,12,488,515,27,324
1,7,2,22.01.2025,12,388,476,88,1056
696,13,4,19.01.2025,20,202,271,69,1380
18,30,12,13.01.2025,10,69,90,21,210
786,19,7,27.01.2025,15,297,401,104,1560
919,10,14,15.01.2025,19,46,59,13,247
492,30,24,30.01.2025,1,354,391,37,37
484,6,14,29.01.2025,2,35,39,4,8
769,7,14,12.01.2025,4,44,51,7,28
941,10,10,31.01.2025,9,87,115,28,252
961,2,13,16.01.2025,9,360,434,74,666
433,18,29,30.01.2025,13,439,642,203,2639
169,10,2,13.01.2025,5,423,592,169,845
120,11,30,12.01.2025,20,325,405,80,1600
490,5,11,30.01.2025,14,413,467,54,756
962,28,6,04.01.2025,20,24,29,5,100
221,30,21,21.01.2025,10,245,345,100,1000
265,16,10,16.01.2025,13,175,226,51,663
702,26,11,12.01.2025,20,134,177,43,860
335,6,4,28.01.2025,8,293,337,44,352
7,16,27,03.01.2025,5,167,200,33,165
357,7,4,06.01.2025,20,48,50,2,40
256,13,5,22.01.2025,6,66,97,31,186
70,30,23,25.01.2025,16,141,207,66,1056
656,5,21,15.01.2025,16,100,124,24,384
278,18,21,18.01.2025,8,336,405,69,552
329,23,22,11.01.2025,18,186,210,24,432
599,22,10,06.01.2025,12,91,125,34,408
321,4,13,04.01.2025,17,187,238,51,867
630,3,15,03.01.2025,2,192,281,89,178
542,28,21,02.01.2025,12,177,234,57,684
265,15,15,10.01.2025,9,261,301,40,360
375,21,7,12.01.2025,5,172,215,43,215
542,24,24,28.01.2025,10,77,110,33,330
865,15,4,12.01.2025,19,173,236,63,1197
585,15,7,09.01.2025,10,453,659,206,2060
209,2,11,08.01.2025,16,281,363,82,1312
228,7,4,17.01.2025,7,235,256,21,147
807,3,23,07.01.2025,8,442,592,150,1200
941,20,6,14.01.2025,2,282,356,74,148
548,29,6,26.01.2025,18,54,65,11,198
179,16,18,16.01.2025,7,24,28,4,28
569,14,6,11.01.2025,3,180,204,24,72
456,23,10,14.01.2025,11,445,600,155,1705
949,11,24,08.01.2025,16,435,614,179,2864
525,2,4,17.01.2025,19,462,507,45,855
436,22,16,07.01.2025,10,162,233,71,710
509,3,24,16.01.2025,15,400,488,88,1320
167,19,26,13.01.2025,19,497,536,39,741
318,8,7,27.01.2025,13,89,117,28,364
590,9,29,13.01.2025,14,154,229,75,1050
350,2,20,19.01.2025,19,319,448,129,2451
707,2,4,02.01.2025,18,324,421,97,1746
492,8,19,01.01.2025,18,483,558,75,1350
954,22,23,11.01.2025,6,68,93,25,150
554,20,14,22.01.2025,17,168,245,77,1309
175,21,10,13.01.2025,9,396,583,187,1683
796,17,10,20.01.2025,20,390,490,100,2000
380,15,6,18.01.2025,12,441,617,176,2112
503,11,21,23.01.2025,19,198,275,77,1463
130,17,24,04.01.2025,19,46,52,6,114
74,15,24,19.01.2025,15,394,509,115,1725
677,29,22,28.01.2025,3,439,488,49,147
542,18,7,21.01.2025,20,484,695,211,4220
921,3,15,01.01.2025,11,404,530,126,1386
307,30,9,30.01.2025,11,435,476,41,451
273,26,30,07.01.2025,14,274,381,107,1498
164,17,13,17.01.2025,4,62,70,8,32
223,21,1,07.01.2025,17,277,333,56,952
445,28,18,04.01.2025,3,315,366,51,153
504,27,18,03.01.2025,9,489,588,99,891
12,29,27,01.01.2025,20,356,521,165,3300
990,27,24,19.01.2025,6,446,489,43,258
480,19,2,12.01.2025,11,95,124,29,319
436,30,14,19.01.2025,7,133,189,56,392
383,3,21,27.01.2025,11,401,512,111,1221
769,1,25,24.01.2025,15,403,425,22,330
857,22,11,07.01.2025,5,364,447,83,415
765,24,4,04.01.2025,19,143,201,58,1102
82,1,8,31.01.2025,18,84,120,36,648
486,10,5,21.01.2025,11,198,219,21,231
741,14,2,19.01.2025,2,373,481,108,216
847,18,26,04.01.2025,17,387,428,41,697
291,11,2,29.01.2025,5,173,198,25,125
473,7,13,03.01.2025,11,497,678,181,1991
806,17,16,07.01.2025,13,407,501,94,1222
937,15,3,07.01.2025,12,280,385,105,1260
411,19,8,07.01.2025,12,143,202,59,708
62,23,1,21.01.2025,11,298,356,58,638
895,25,27,14.01.2025,3,207,276,69,207
299,15,22,08.01.2025,3,353,424,71,213
396,27,13,08.01.2025,19,269,351,82,1558
366,12,26,29.01.2025,4,71,87,16,64
253,13,22,20.01.2025,2,357,396,39,78
521,30,8,16.01.2025,16,113,142,29,464
876,6,18,20.01.2025,14,412,553,141,1974
420,1,11,30.01.2025,8,171,193,22,176
85,13,26,09.01.2025,9,55,78,23,207
700,14,3,02.01.2025,4,339,508,169,676
473,11,21,29.01.2025,7,191,247,56,392
838,21,30,10.01.2025,14,444,519,75,1050
999,12,4,02.01.2025,7,362,471,109,763
2,5,16,07.01.2025,1,155,173,18,18
430,7,14,05.01.2025,17,466,511,45,765
649,9,22,09.01.2025,15,79,102,23,345
593,8,19,11.01.2025,7,494,524,30,210
422,19,26,02.01.2025,14,273,336,63,882
712,25,28,30.01.2025,20,340,505,165,3300
942,1,19,06.01.2025,6,278,359,81,486
879,9,20,17.01.2025,15,411,481,70,1050
328,25,12,04.01.2025,8,445,634,189,1512
337,18,24,29.01.2025,15,89,127,38,570
127,15,9,29.01.2025,7,30,40,10,70
436,26,18,31.01.2025,18,81,114,33,594
776,13,27,27.01.2025,9,417,573,156,1404
849,2,7,10.01.2025,7,322,411,89,623
536,29,3,17.01.2025,16,125,162,37,592
454,21,24,12.01.2025,17,133,183,50,850
220,13,10,25.01.2025,16,250,264,14,224
258,4,8,23.01.2025,1,329,347,18,18
936,4,12,07.01.2025,17,442,591,149,2533
430,1,6,18.01.2025,5,222,246,24,120
271,26,6,02.01.2025,9,54,73,19,171
175,28,28,08.01.2025,3,332,354,22,66
669,12,15,15.01.2025,5,23,27,4,20
287,3,1,02.01.2025,16,373,491,118,1888
722,9,4,19.01.2025,7,101,118,17,119
800,8,27,18.01.2025,3,50,66,16,48
732,20,10,04.01.2025,5,93,129,36,180
558,15,1,19.01.2025,18,263,294,31,558
400,9,28,30.01.2025,19,228,260,32,608
182,12,3,16.01.2025,10,426,475,49,490
297,1,9,27.01.2025,7,108,134,26,182
111,18,27,20.01.2025,2,38,43,5,10
392,17,14,04.01.2025,13,130,139,9,117
13,5,18,13.01.2025,15,375,504,129,1935
58,30,30,05.01.2025,2,36,47,11,22
799,26,8,13.01.2025,14,389,432,43,602
585,12,7,14.01.2025,18,318,338,20,360
348,15,16,20.01.2025,11,35,38,3,33
507,8,5,11.01.2025,19,26,28,2,38
473,7,20,15.01.2025,3,117,162,45,135
36,21,15,06.01.2025,6,67,74,7,42
554,27,13,19.01.2025,2,400,512,112,224
906,3,21,13.01.2025,16,92,104,12,192
26,26,27,09.01.2025,11,465,681,216,2376
793,9,24,14.01.2025,4,273,300,27,108
172,18,26,31.01.2025,3,262,373,111,333
466,9,10,08.01.2025,14,47,70,23,322
149,27,8,25.01.2025,10,170,244,74,740
954,29,5,06.01.2025,12,93,102,9,108
407,1,5,11.01.2025,6,129,188,59,354
277,25,3,05.01.2025,1,318,373,55,55
760,27,15,26.01.2025,16,472,534,62,992
632,1,7,22.01.2025,6,235,315,80,480
362,11,4,08.01.2025,5,260,321,61,305
668,15,20,27.01.2025,10,388,505,117,1170
994,22,5,09.01.2025,12,443,603,160,1920
599,18,12,04.01.2025,13,38,42,4,52
109,19,22,04.01.2025,11,496,641,145,1595
945,27,3,06.01.2025,14,296,428,132,1848
776,23,10,24.01.2025,20,430,555,125,2500
424,9,16,18.01.2025,14,425,614,189,2646
527,22,14,05.01.2025,7,257,314,57,399
61,30,1,17.01.2025,17,157,187,30,510
266,1,17,24.01.2025,8,244,346,102,816
571,3,19,04.01.2025,19,36,46,10,190
635,28,19,05.01.2025,3,243,288,45,135
52,13,19,24.01.2025,17,497,706,209,3553
916,7,13,20.01.2025,5,446,508,62,310
334,8,9,18.01.2025,9,281,350,69,621
460,2,17,06.01.2025,4,134,175,41,164
541,14,11,09.01.2025,14,115,128,13,182
877,1,6,03.01.2025,6,122,169,47,282
504,22,24,05.01.2025,1,203,296,93,93
2,29,7,25.01.2025,7,21,23,2,14
19,18,17,13.01.2025,8,426,503,77,616
732,13,15,08.01.2025,19,76,101,25,475
4,17,17,19.01.2025,19,66,73,7,133
122,13,26,01.01.2025,1,316,468,152,152
871,3,13,19.01.2025,5,440,509,69,345
702,16,7,30.01.2025,15,399,568,169,2535
690,18,25,19.01.2025,15,398,546,148,2220
46,13,1,18.01.2025,11,173,224,51,561
863,3,28,28.01.2025,18,237,300,63,1134
265,13,8,02.01.2025,2,31,45,14,28
836,27,19,17.01.2025,9,370,425,55,495
445,4,29,04.01.2025,8,248,270,22,176
99,17,29,03.01.2025,11,67,90,23,253
569,21,12,23.01.2025,9,188,240,52,468
778,19,26,10.01.2025,5,29,33,4,20
267,26,28,22.01.2025,1,55,67,12,12
332,25,8,09.01.2025,14,230,245,15,210
330,13,19,20.01.2025,20,148,174,26,520
912,23,9,28.01.2025,13,241,301,60,780
734,2,4,02.01.2025,18,90,105,15,270
660,24,1,26.01.2025,5,381,532,151,755
933,3,23,17.01.2025,5,491,546,55,275
228,17,15,20.01.2025,10,20,22,2,20
913,13,5,02.01.2025,17,197,251,54,918
72,16,9,23.01.2025,11,483,537,54,594
233,26,30,12.01.2025,7,230,274,44,308
974,30,8,12.01.2025,15,28,30,2,30
90,6,20,04.01.2025,18,91,118,27,486
340,4,18,04.01.2025,14,500,541,41,574
181,26,21,11.01.2025,12,309,327,18,216
682,28,29,13.01.2025,4,472,502,30,120
476,20,6,08.01.2025,2,155,192,37,74
25,2,3,05.01.2025,18,144,185,41,738
470,3,1,03.01.2025,6,122,182,60,360
131,19,24,30.01.2025,14,55,66,11,154
129,1,21,29.01.2025,9,292,401,109,981
12,16,24,14.01.2025,14,404,483,79,1106
979,27,25,29.01.2025,9,179,219,40,360
48,29,10,21.01.2025,6,477,532,55,330
451,14,8,28.01.2025,10,216,307,91,910
26,4,20,03.01.2025,11,141,148,7,77
512,24,24,26.01.2025,7,394,469,75,525
866,5,9,08.01.2025,12,305,452,147,1764
86,16,14,18.01.2025,6,103,152,49,294
776,4,24,22.01.2025,5,442,555,113,565
976,6,13,15.01.2025,1,280,343,63,63
429,23,26,13.01.2025,12,497,678,181,2172
410,5,28,05.01.2025,9,59,87,28,252
637,29,15,29.01.2025,14,456,591,135,1890
523,28,28,09.01.2025,20,170,215,45,900
850,3,22,06.01.2025,19,50,67,17,323
371,1,2,14.01.2025,4,432,553,121,484
513,19,16,10.01.2025,5,84,97,13,65
885,9,26,07.01.2025,10,47,56,9,90
430,29,24,25.01.2025,13,300,336,36,468
114,5,3,11.01.2025,14,451,525,74,1036
756,25,12,06.01.2025,12,151,198,47,564
177,1,13,22.01.2025,9,430,506,76,684
839,3,25,04.01.2025,4,363,497,134,536
505,25,7,18.01.2025,18,61,79,18,324
475,8,1,28.01.2025,14,139,165,26,364
346,22,19,26.01.2025,10,276,398,122,1220
515,26,6,24.01.2025,3,290,372,82,246
601,26,14,18.01.2025,1,227,280,53,53
887,25,1,12.01.2025,4,438,480,42,168
45,6,3,06.01.2025,12,179,204,25,300
768,9,3,26.01.2025,6,146,210,64,384
122,23,13,02.01.2025,10,332,460,128,1280
541,14,1,27.01.2025,8,274,305,31,248
731,24,21,28.01.2025,17,217,233,16,272
60,7,6,02.01.2025,7,73,96,23,161
564,27,19,20.01.2025,20,487,721,234,4680
83,3,26,09.01.2025,2,500,528,28,56
305,30,30,16.01.2025,4,143,157,14,56
707,16,24,04.01.2025,19,441,556,115,2185
668,18,14,02.01.2025,4,472,629,157,628
398,29,30,05.01.2025,12,370,508,138,1656
770,2,24,17.01.2025,9,70,92,22,198
292,28,21,15.01.2025,17,188,271,83,1411
944,1,21,04.01.2025,3,125,185,60,180
349,8,11,17.01.2025,6,381,421,40,240
484,30,6,18.01.2025,17,366,527,161,2737
455,17,24,01.01.2025,16,90,126,36,576
614,25,2,23.01.2025,8,259,285,26,208
426,4,14,01.01.2025,18,373,478,105,1890
798,20,16,27.01.2025,5,86,125,39,195
694,20,29,25.01.2025,19,344,514,170,3230
258,16,16,25.01.2025,4,294,335,41,164
347,27,8,02.01.2025,15,469,581,112,1680
885,4,29,29.01.2025,1,113,159,46,46
561,1,22,24.01.2025,18,207,290,83,1494
477,28,17,02.01.2025,1,106,142,36,36
686,28,10,07.01.2025,5,129,186,57,285
988,6,6,27.01.2025,4,220,289,69,276
809,13,20,22.01.2025,13,302,365,63,819
467,9,13,22.01.2025,16,30,37,7,112
454,22,22,12.01.2025,3,243,323,80,240
122,8,19,28.01.2025,12,376,521,145,1740
899,5,3,11.01.2025,2,396,436,40,80
417,29,10,27.01.2025,5,218,236,18,90
492,30,1,07.01.2025,7,206,221,15,105
964,27,21,17.01.2025,9,477,669,192,1728
289,28,7,23.01.2025,4,337,435,98,392
228,19,5,10.01.2025,18,457,540,83,1494
68,8,1,01.01.2025,10,487,535,48,480
436,20,26,26.01.2025,3,436,461,25,75
879,8,2,05.01.2025,4,208,304,96,384
387,16,24,12.01.2025,18,218,297,79,1422
414,23,26,08.01.2025,8,361,520,159,1272
630,28,11,08.01.2025,10,301,328,27,270
4,11,1,27.01.2025,4,470,654,184,736
934,16,14,09.01.2025,5,271,346,75,375
828,19,26,14.01.2025,4,183,231,48,192
566,11,11,24.01.2025,4,90,117,27,108
79,29,15,30.01.2025,16,188,266,78,1248
138,8,19,12.01.2025,19,274,350,76,1444
350,12,9,05.01.2025,13,457,673,216,2808
47,25,22,26.01.2025,20,256,287,31,620
752,13,1,05.01.2025,10,422,499,77,770
777,24,27,12.01.2025,9,236,330,94,846
480,5,2,12.01.2025,3,246,270,24,72
472,7,2,27.01.2025,17,257,284,27,459
394,26,9,25.01.2025,16,292,437,145,2320
771,8,16,22.01.2025,2,130,142,12,24
326,10,8,17.01.2025,1,417,473,56,56
453,10,27,03.01.2025,10,277,396,119,1190
723,15,22,06.01.2025,13,45,51,6,78
177,11,9,25.01.2025,13,370,476,106,1378
152,29,15,06.01.2025,18,284,405,121,2178
47,15,14,14.01.2025,9,89,94,5,45
669,29,13,22.01.2025,7,93,118,25,175
70,28,27,23.01.2025,7,193,221,28,196
562,30,13,16.01.2025,14,374,416,42,588
619,5,7,29.01.2025,17,240,330,90,1530
856,16,20,02.01.2025,14,478,646,168,2352
31,26,9,17.01.2025,17,221,291,70,1190
240,6,2,23.01.2025,11,419,510,91,1001
241,9,1,12.01.2025,1,371,477,106,106
855,20,25,05.01.2025,16,122,160,38,608
761,3,29,11.01.2025,20,457,572,115,2300
975,9,25,01.01.2025,11,118,160,42,462
756,11,14,15.01.2025,2,397,501,104,208
610,29,15,16.01.2025,11,196,228,32,352
447,28,3,19.01.2025,1,143,204,61,61
540,9,5,28.01.2025,6,264,302,38,228
413,24,27,05.01.2025,15,393,449,56,840
62,23,6,06.01.2025,5,266,292,26,130
780,3,27,15.01.2025,12,353,512,159,1908
437,20,4,31.01.2025,16,74,92,18,288
59,25,10,06.01.2025,20,472,611,139,2780
117,10,9,27.01.2025,18,226,296,70,1260
239,2,12,06.01.2025,4,447,555,108,432
593,1,7,19.01.2025,6,115,122,7,42
185,24,14,31.01.2025,19,426,553,127,2413
98,29,9,06.01.2025,13,157,200,43,559
80,2,14,18.01.2025,1,464,502,38,38
476,29,29,25.01.2025,1,491,563,72,72
83,13,30,07.01.2025,15,474,664,190,2850
910,11,22,01.01.2025,2,169,222,53,106
214,6,14,27.01.2025,15,113,132,19,285
287,13,19,08.01.2025,4,461,652,191,764
164,19,9,26.01.2025,15,241,359,118,1770
938,18,1,18.01.2025,8,308,328,20,160
408,25,30,11.01.2025,9,51,57,6,54
359,20,24,20.01.2025,18,186,204,18,324
619,8,24,20.01.2025,8,85,107,22,176
162,25,16,06.01.2025,18,460,501,41,738
917,19,4,27.01.2025,13,133,160,27,351
49,10,25,19.01.2025,14,50,55,5,70
441,23,14,15.01.2025,13,350,420,70,910
176,15,28,06.01.2025,18,349,414,65,1170
211,19,16,09.01.2025,20,403,537,134,2680
383,1,15,24.01.2025,1,278,399,121,121
446,10,27,01.01.2025,14,403,513,110,1540
373,25,14,28.01.2025,1,106,113,7,7
11,22,23,30.01.2025,4,309,458,149,596
865,6,20,02.01.2025,6,115,161,46,276
926,12,25,27.01.2025,10,471,667,196,1960
635,2,9,09.01.2025,18,313,457,144,2592
599,8,6,29.01.2025,6,198,293,95,570
254,7,6,01.01.2025,6,145,176,31,186
42,5,26,12.01.2025,11,196,281,85,935
61,4,20,29.01.2025,8,192,226,34,272
816,23,22,29.01.2025,2,135,194,59,118
595,17,27,18.01.2025,18,165,225,60,1080
214,20,7,25.01.2025,8,118,170,52,416
302,28,8,13.01.2025,6,323,401,78,468
8,26,18,01.01.2025,12,308,427,119,1428
552,21,8,04.01.2025,5,445,661,216,1080
276,25,9,03.01.2025,6,470,616,146,876
455,25,11,25.01.2025,20,221,263,42,840
896,20,20,20.01.2025,5,48,53,5,25
249,16,13,07.01.2025,3,266,334,68,204
603,12,9,06.01.2025,3,484,511,27,81
187,20,25,28.01.2025,9,348,380,32,288
209,29,15,11.01.2025,20,427,467,40,800
136,6,13,15.01.2025,3,379,437,58,174
494,12,8,24.01.2025,13,85,125,40,520
876,9,16,11.01.2025,5,361,518,157,785
645,30,13,09.01.2025,13,72,105,33,429
146,23,1,29.01.2025,20,237,262,25,500
829,25,8,01.01.2025,1,312,411,99,99
676,24,29,18.01.2025,9,181,261,80,720
277,2,7,06.01.2025,4,52,63,11,44
236,28,11,12.01.2025,1,182,199,17,17
215,24,25,05.01.2025,4,317,424,107,428
307,8,22,27.01.2025,2,284,407,123,246
497,30,19,15.01.2025,5,153,193,40,200
998,5,12,23.01.2025,9,460,510,50,450
995,3,17,18.01.2025,8,382,542,160,1280
644,26,22,11.01.2025,18,425,467,42,756
185,24,30,01.01.2025,10,415,537,122,1220
505,2,14,16.01.2025,13,444,581,137,1781
985,7,29,08.01.2025,6,321,422,101,606
572,14,12,04.01.2025,12,466,619,153,1836
59,6,11,15.01.2025,18,360,425,65,1170
444,9,2,29.01.2025,17,190,254,64,1088
805,26,12,24.01.2025,17,291,331,40,680
757,18,6,25.01.2025,11,378,471,93,1023
813,16,5,13.01.2025,6,29,40,11,66
273,13,16,05.01.2025,19,418,471,53,1007
313,30,7,28.01.2025,11,397,484,87,957
805,19,13,06.01.2025,18,101,114,13,234
891,12,1,25.01.2025,4,293,332,39,156
747,26,22,30.01.2025,13,106,147,41,533
308,15,6,18.01.2025,14,116,153,37,518
258,29,6,21.01.2025,1,66,95,29,29
174,26,6,08.01.2025,9,64,75,11,99
588,6,20,01.01.2025,1,330,451,121,121
428,13,6,27.01.2025,15,40,44,4,60
409,1,9,30.01.2025,11,443,632,189,2079
986,19,12,14.01.2025,7,114,123,9,63
857,10,21,02.01.2025,1,387,447,60,60
77,2,24,25.01.2025,3,314,361,47,141
380,25,7,18.01.2025,20,110,122,12,240
306,27,15,03.01.2025,3,323,371,48,144
873,1,23,02.01.2025,14,30,44,14,196
148,15,16,22.01.2025,2,184,226,42,84
410,4,30,22.01.2025,14,445,636,191,2674
486,14,28,05.01.2025,13,164,188,24,312
539,23,12,01.01.2025,1,313,375,62,62
475,6,7,09.01.2025,14,66,83,17,238
436,22,5,28.01.2025,8,364,400,36,288
889,29,7,26.01.2025,14,78,82,4,56
960,26,20,09.01.2025,10,384,419,35,350
446,10,5,31.01.2025,7,386,423,37,259
358,9,29,27.01.2025,10,79,115,36,360
202,15,6,15.01.2025,16,357,519,162,2592
536,12,16,31.01.2025,14,477,698,221,3094
33,14,28,23.01.2025,7,424,493,69,483
300,6,20,02.01.2025,9,470,584,114,1026
72,16,11,28.01.2025,11,71,91,20,220
452,1,3,27.01.2025,16,337,447,110,1760
194,6,10,23.01.2025,6,41,59,18,108
294,18,8,15.01.2025,10,156,218,62,620
80,25,16,06.01.2025,8,157,189,32,256
800,11,26,07.01.2025,17,441,540,99,1683
262,15,19,25.01.2025,1,104,126,22,22
301,25,18,12.01.2025,8,213,304,91,728
141,14,18,19.01.2025,2,163,222,59,118
178,7,17,14.01.2025,9,52,70,18,162
981,1,20,11.01.2025,8,276,398,122,976
641,29,11,16.01.2025,9,109,119,10,90
744,9,8,11.01.2025,19,328,347,19,361
818,2,19,25.01.2025,8,264,341,77,616
269,22,14,02.01.2025,10,270,386,116,1160
651,14,24,04.01.2025,10,133,167,34,340
980,30,17,09.01.2025,9,128,161,33,297
406,24,13,03.01.2025,18,405,508,103,1854
668,28,12,29.01.2025,14,151,219,68,952
870,15,5,22.01.2025,13,406,469,63,819
567,30,26,29.01.2025,3,208,280,72,216
904,23,3,17.01.2025,12,438,562,124,1488
624,19,2,31.01.2025,2,96,120,24,48
947,23,6,19.01.2025,4,25,35,10,40
316,11,2,23.01.2025,15,352,503,151,2265
576,13,1,10.01.2025,8,206,254,48,384
904,14,2,11.01.2025,2,136,186,50,100
455,9,30,14.01.2025,19,280,325,45,855
28,13,16,21.01.2025,15,360,412,52,780
838,13,16,23.01.2025,4,300,441,141,564
188,24,6,14.01.2025,14,474,681,207,2898
934,19,21,09.01.2025,3,334,353,19,57
525,15,17,21.01.2025,17,240,288,48,816
515,25,11,22.01.2025,20,433,616,183,3660
397,16,25,07.01.2025,19,232,265,33,627
697,27,6,23.01.2025,17,375,498,123,2091
869,17,25,16.01.2025,13,32,44,12,156
323,26,21,11.01.2025,1,452,611,159,159
310,19,5,05.01.2025,4,375,471,96,384
269,21,28,18.01.2025,14,411,561,150,2100
80,18,28,13.01.2025,15,35,43,8,120
211,6,27,02.01.2025,3,225,314,89,267
592,30,22,29.01.2025,1,262,298,36,36
830,19,19,06.01.2025,17,449,596,147,2499
690,19,27,18.01.2025,6,271,299,28,168
158,14,23,11.01.2025,7,415,586,171,1197
475,3,15,24.01.2025,1,293,363,70,70
851,10,20,09.01.2025,6,227,298,71,426
162,1,7,23.01.2025,19,294,400,106,2014
681,8,29,03.01.2025,8,187,222,35,280
656,20,23,01.01.2025,4,164,199,35,140
580,20,14,15.01.2025,1,214,282,68,68
66,20,11,27.01.2025,18,244,277,33,594
377,9,20,17.01.2025,6,159,184,25,150
935,17,24,25.01.2025,9,357,501,144,1296
832,2,23,05.01.2025,3,258,355,97,291
115,14,16,17.01.2025,1,217,290,73,73
977,21,9,22.01.2025,8,367,404,37,296
905,21,17,19.01.2025,2,72,88,16,32
872,9,29,25.01.2025,19,491,675,184,3496
146,29,28,21.01.2025,17,67,80,13,221
205,15,25,02.01.2025,4,263,283,20,80
614,5,14,21.01.2025,10,41,51,10,100
50,7,1,17.01.2025,18,36,46,10,180
920,28,28,03.01.2025,15,101,124,23,345
542,6,20,31.01.2025,14,301,340,39,546
892,25,10,27.01.2025,10,451,580,129,1290
771,1,22,28.01.2025,1,254,284,30,30
520,22,19,31.01.2025,11,309,350,41,451
663,15,21,09.01.2025,3,58,72,14,42
3,14,30,19.01.2025,4,388,512,124,496
916,13,28,04.01.2025,6,429,542,113,678
402,5,1,18.01.2025,2,291,323,32,64
18,8,20,04.01.2025,15,49,65,16,240
824,6,30,14.01.2025,7,364,530,166,1162
271,9,9,07.01.2025,11,431,568,137,1507
646,21,6,21.01.2025,9,191,286,95,855
697,27,29,16.01.2025,1,61,69,8,8
754,24,10,26.01.2025,5,172,193,21,105
898,12,7,14.01.2025,20,29,38,9,180
962,30,5,31.01.2025,8,254,308,54,432
10,6,18,30.01.2025,9,311,390,79,711
843,27,30,23.01.2025,2,147,195,48,96
665,25,15,01.01.2025,5,490,681,191,955
249,13,11,05.01.2025,10,41,50,9,90
228,23,25,14.01.2025,9,276,383,107,963
717,18,27,15.01.2025,12,418,616,198,2376
696,1,8,28.01.2025,13,443,605,162,2106
861,29,29,17.01.2025,18,95,105,10,180
896,23,19,15.01.2025,16,147,189,42,672
284,23,13,14.01.2025,5,121,179,58,290
237,14,2,13.01.2025,13,433,545,112,1456
795,20,17,14.01.2025,10,319,346,27,270
382,19,10,19.01.2025,16,486,697,211,3376
683,29,6,05.01.2025,2,151,171,20,40
538,13,6,06.01.2025,14,308,409,101,1414
12,13,14,13.01.2025,3,252,372,120,360
583,19,14,06.01.2025,7,476,574,98,686
625,19,30,29.01.2025,20,356,505,149,2980
603,30,24,20.01.2025,18,146,167,21,378
770,18,24,16.01.2025,13,304,390,86,1118
728,16,15,20.01.2025,6,210,307,97,582
445,1,10,04.01.2025,8,150,193,43,344
51,17,28,26.01.2025,9,478,633,155,1395
253,4,11,07.01.2025,20,290,402,112,2240
1000,25,20,03.01.2025,5,84,103,19,95
31,1,29,03.01.2025,10,172,184,12,120
675,23,15,30.01.2025,13,95,136,41,533
742,24,3,31.01.2025,10,399,536,137,1370
233,28,2,28.01.2025,10,394,580,186,1860
73,7,10,04.01.2025,1,124,159,35,35
589,16,11,05.01.2025,18,260,288,28,504
606,20,18,14.01.2025,11,446,603,157,1727
305,6,24,26.01.2025,5,171,249,78,390
338,20,23,21.01.2025,5,48,62,14,70
240,11,27,08.01.2025,1,311,457,146,146
437,14,20,31.01.2025,4,338,498,160,640
573,29,20,13.01.2025,5,488,718,230,1150
963,27,25,18.01.2025,2,352,526,174,348
379,13,18,05.01.2025,1,63,80,17,17
374,8,21,30.01.2025,1,249,330,81,81
419,4,30,17.01.2025,14,312,374,62,868
492,5,25,25.01.2025,10,454,650,196,1960
318,8,26,31.01.2025,10,271,316,45,450
728,6,11,08.01.2025,3,356,405,49,147
677,20,11,28.01.2025,13,69,73,4,52
509,16,16,07.01.2025,6,57,73,16,96
994,12,2,08.01.2025,14,64,89,25,350
781,22,6,31.01.2025,2,95,129,34,68
854,20,24,27.01.2025,19,325,447,122,2318
605,7,17,16.01.2025,7,127,160,33,231
195,10,24,06.01.2025,10,456,683,227,2270
282,28,15,10.01.2025,18,331,348,17,306
278,16,14,01.01.2025,15,403,597,194,2910
426,28,5,25.01.2025,8,181,270,89,712
946,29,1,23.01.2025,16,231,276,45,720
797,25,20,03.01.2025,16,342,364,22,352
941,23,18,28.01.2025,12,65,82,17,204
245,22,6,28.01.2025,18,323,390,67,1206
275,12,13,07.01.2025,9,38,50,12,108
76,18,26,12.01.2025,17,20,24,4,68
558,24,3,24.01.2025,4,184,267,83,332
463,9,9,23.01.2025,20,220,297,77,1540
255,20,22,04.01.2025,13,44,59,15,195
841,16,1,02.01.2025,10,25,33,8,80
914,27,26,01.01.2025,10,183,266,83,830
121,18,9,01.01.2025,8,329,482,153,1224
729,18,5,06.01.2025,3,431,557,126,378
698,7,19,13.01.2025,13,413,463,50,650
963,24,24,02.01.2025,8,283,344,61,488
841,18,18,13.01.2025,9,341,507,166,1494
762,1,22,15.01.2025,18,296,312,16,288
402,11,6,20.01.2025,11,66,98,32,352
392,10,23,14.01.2025,20,125,180,55,1100
740,8,11,24.01.2025,14,87,99,12,168
955,7,20,15.01.2025,10,154,221,67,670
516,30,17,29.01.2025,2,410,572,162,324
443,16,2,17.01.2025,20,305,387,82,1640
993,2,20,06.01.2025,2,367,504,137,274
614,23,20,03.01.2025,18,449,618,169,3042
710,21,29,10.01.2025,8,60,65,5,40
698,28,30,05.01.2025,13,213,233,20,260
344,18,9,18.01.2025,11,307,329,22,242
167,26,13,08.01.2025,6,356,393,37,222
609,21,13,02.01.2025,10,252,355,103,1030
689,6,5,01.01.2025,11,135,178,43,473
482,22,1,16.01.2025,16,159,193,34,544
286,10,16,24.01.2025,2,462,596,134,268
914,22,25,05.01.2025,7,60,75,15,105
66,10,13,24.01.2025,3,441,586,145,435
348,24,8,19.01.2025,9,235,339,104,936
498,26,13,14.01.2025,5,466,575,109,545
255,11,23,25.01.2025,19,212,311,99,1881
373,8,1,05.01.2025,13,57,79,22,286
309,1,5,12.01.2025,16,436,567,131,2096
460,1,7,30.01.2025,13,284,349,65,845
339,30,27,02.01.2025,13,141,151,10,130
406,8,14,27.01.2025,1,209,224,15,15
749,17,29,21.01.2025,3,351,469,118,354
273,27,1,20.01.2025,18,320,353,33,594
881,7,19,02.01.2025,19,80,120,40,760
61,26,24,08.01.2025,1,93,113,20,20
24,20,9,11.01.2025,6,372,424,52,312
966,15,25,12.01.2025,19,259,353,94,1786
376,8,28,04.01.2025,19,352,500,148,2812
993,13,2,02.01.2025,20,386,498,112,2240
45,5,28,31.01.2025,15,198,290,92,1380
971,16,30,10.01.2025,11,151,214,63,693
646,19,5,02.01.2025,11,166,230,64,704
986,20,10,23.01.2025,10,493,591,98,980
527,3,4,18.01.2025,1,342,445,103,103
736,18,20,13.01.2025,12,342,413,71,852
217,10,29,27.01.2025,10,410,491,81,810
416,6,28,06.01.2025,20,426,579,153,3060
153,4,16,20.01.2025,16,46,55,9,144
418,13,1,08.01.2025,14,72,102,30,420
861,5,10,18.01.2025,14,35,44,9,126
304,15,28,21.01.2025,5,407,505,98,490
944,13,1,05.01.2025,7,200,282,82,574
65,12,17,12.01.2025,1,56,68,12,12
204,22,1,03.01.2025,15,137,186,49,735
651,3,14,16.01.2025,4,181,225,44,176
356,17,15,19.01.2025,2,211,234,23,46
262,10,3,07.01.2025,8,322,385,63,504
453,19,9,02.01.2025,13,155,214,59,767
375,7,4,22.01.2025,11,375,552,177,1947
940,15,19,02.01.2025,11,390,490,100,1100
587,30,24,03.01.2025,17,346,453,107,1819
408,14,24,30.01.2025,10,453,622,169,1690
595,7,14,11.01.2025,13,473,523,50,650
241,7,29,11.01.2025,20,273,319,46,920
687,18,15,13.01.2025,18,23,28,5,90
480,2,25,06.01.2025,8,401,546,145,1160
868,16,26,24.01.2025,3,297,347,50,150
877,1,26,21.01.2025,4,308,349,41,164
27,20,12,14.01.2025,16,143,164,21,336
871,27,5,23.01.2025,20,377,477,100,2000
806,22,5,07.01.2025,19,460,567,107,2033
266,2,6,28.01.2025,18,491,545,54,972
246,25,6,27.01.2025,13,498,703,205,2665
988,15,13,20.01.2025,19,354,401,47,893
170,15,16,30.01.2025,8,338,497,159,1272
164,8,24,18.01.2025,11,353,393,40,440
140,8,22,06.01.2025,1,314,343,29,29
706,1,3,14.01.2025,20,116,134,18,360
818,6,17,09.01.2025,10,90,103,13,130
305,16,22,03.01.2025,20,322,414,92,1840
911,20,1,26.01.2025,16,189,268,79,1264
883,3,11,27.01.2025,9,373,449,76,684
919,13,2,30.01.2025,15,185,231,46,690
707,20,20,03.01.2025,7,302,447,145,1015
128,1,1,23.01.2025,13,423,498,75,975
252,7,22,05.01.2025,6,416,579,163,978
641,24,25,05.01.2025,5,272,341,69,345
479,7,7,31.01.2025,3,232,336,104,312
519,23,2,31.01.2025,13,225,330,105,1365
748,16,1,30.01.2025,15,21,24,3,45
371,2,8,13.01.2025,2,191,253,62,124
174,20,17,26.01.2025,10,89,119,30,300
87,24,27,02.01.2025,16,425,582,157,2512
746,2,5,29.01.2025,16,158,167,9,144
664,28,14,16.01.2025,12,279,314,35,420
465,14,5,12.01.2025,19,494,519,25,475
949,14,27,06.01.2025,1,451,482,31,31
724,13,7,26.01.2025,17,359,536,177,3009
650,28,26,26.01.2025,13,472,698,226,2938
269,14,24,03.01.2025,10,313,392,79,790
323,20,16,21.01.2025,19,126,138,12,228
948,7,19,23.01.2025,19,367,465,98,1862
589,27,18,23.01.2025,9,451,676,225,2025
809,3,9,20.01.2025,17,238,254,16,272
758,20,29,11.01.2025,11,27,39,12,132
612,23,26,22.01.2025,7,93,132,39,273
794,28,14,10.01.2025,7,85,94,9,63
228,19,9,29.01.2025,13,71,79,8,104
161,23,18,19.01.2025,18,432,580,148,2664
677,28,30,04.01.2025,11,335,395,60,660
956,11,8,09.01.2025,1,22,30,8,8
187,22,15,14.01.2025,6,90,131,41,246
837,19,17,23.01.2025,10,500,637,137,1370
177,27,29,30.01.2025,6,194,238,44,264
473,24,17,23.01.2025,16,52,74,22,352
793,17,17,05.01.2025,5,124,155,31,155
659,18,21,16.01.2025,2,188,253,65,130
996,28,10,03.01.2025,13,287,308,21,273
715,3,24,07.01.2025,9,314,420,106,954
411,10,15,24.01.2025,19,326,421,95,1805
891,9,13,01.01.2025,11,283,352,69,759
455,20,9,19.01.2025,13,118,171,53,689
555,8,1,28.01.2025,20,459,672,213,4260
158,7,13,26.01.2025,4,45,64,19,76
61,19,29,05.01.2025,14,62,76,14,196
136,1,4,14.01.2025,11,202,294,92,1012
751,15,22,17.01.2025,14,162,194,32,448
682,30,17,31.01.2025,13,185,222,37,481
777,12,29,16.01.2025,12,71,106,35,420
177,9,16,14.01.2025,9,22,23,1,9
396,17,15,11.01.2025,17,422,597,175,2975
828,17,28,05.01.2025,10,369,397,28,280
74,14,13,12.01.2025,9,186,204,18,162
180,29,9,28.01.2025,10,153,165,12,120
525,19,20,16.01.2025,10,22,25,3,30
869,27,7,07.01.2025,17,228,333,105,1785
437,1,17,25.01.2025,8,448,535,87,696
482,28,2,24.01.2025,3,251,266,15,45
252,14,7,02.01.2025,20,172,243,71,1420
275,5,30,07.01.2025,17,349,431,82,1394
178,2,26,23.01.2025,11,394,422,28,308
627,24,18,08.01.2025,1,331,463,132,132
285,24,3,07.01.2025,9,362,474,112,1008
598,25,14,21.01.2025,3,441,584,143,429
611,16,28,28.01.2025,19,469,595,126,2394
861,9,11,05.01.2025,18,157,173,16,288
372,13,20,09.01.2025,17,26,31,5,85
937,2,15,07.01.2025,12,405,566,161,1932
770,23,16,10.01.2025,17,27,35,8,136
511,21,21,31.01.2025,8,313,364,51,408
20,29,11,19.01.2025,18,43,48,5,90
443,1,6,23.01.2025,20,148,173,25,500
667,28,26,28.01.2025,2,430,497,67,134
93,12,30,17.01.2025,20,410,456,46,920
534,9,20,27.01.2025,1,259,294,35,35
320,5,2,08.01.2025,4,308,427,119,476
681,15,16,10.01.2025,18,243,305,62,1116
625,12,4,22.01.2025,10,54,69,15,150
436,24,9,30.01.2025,17,389,436,47,799
4,17,17,25.01.2025,5,449,594,145,725
806,21,17,28.01.2025,13,376,482,106,1378
961,9,4,19.01.2025,14,101,117,16,224
785,8,6,29.01.2025,14,35,48,13,182
370,24,18,13.01.2025,20,407,479,72,1440
471,14,27,16.01.2025,10,495,635,140,1400
102,28,15,07.01.2025,1,216,266,50,50
864,19,7,22.01.2025,3,210,229,19,57
832,17,30,29.01.2025,3,259,335,76,228
154,10,25,05.01.2025,13,441,535,94,1222
349,19,10,14.01.2025,20,300,395,95,1900
24,30,14,30.01.2025,5,140,155,15,75
743,5,8,21.01.2025,16,80,100,20,320
515,19,1,05.01.2025,6,136,172,36,216
848,19,2,02.01.2025,14,181,257,76,1064
894,26,23,18.01.2025,15,48,65,17,255
566,9,26,15.01.2025,15,317,379,62,930
266,3,21,26.01.2025,15,235,299,64,960
322,7,19,17.01.2025,3,439,635,196,588
558,18,20,22.01.2025,2,451,565,114,228
216,15,17,03.01.2025,12,318,343,25,300
506,20,2,18.01.2025,19,174,212,38,722
624,25,23,21.01.2025,13,105,129,24,312
564,7,17,09.01.2025,18,282,352,70,1260
211,17,1,28.01.2025,5,28,38,10,50
409,3,5,08.01.2025,19,224,304,80,1520
185,4,30,21.01.2025,20,34,45,11,220
342,24,3,18.01.2025,18,71,79,8,144
581,21,26,18.01.2025,17,349,427,78,1326
672,26,25,04.01.2025,17,412,457,45,765
828,1,21,27.01.2025,16,23,34,11,176
398,23,25,28.01.2025,20,38,55,17,340
49,15,19,05.01.2025,8,266,373,107,856
604,18,5,13.01.2025,18,330,479,149,2682
230,9,29,23.01.2025,17,359,527,168,2856
448,22,10,20.01.2025,15,491,526,35,525
731,11,2,14.01.2025,16,187,235,48,768
629,14,28,17.01.2025,8,117,141,24,192
708,15,1,26.01.2025,16,246,284,38,608
104,25,6,27.01.2025,7,71,85,14,98
349,21,2,22.01.2025,11,245,332,87,957
34,12,5,21.01.2025,3,288,364,76,228
618,22,29,24.01.2025,8,284,333,49,392
842,9,9,02.01.2025,10,208,310,102,1020
551,7,4,03.01.2025,10,52,62,10,100
495,2,21,30.01.2025,4,405,453,48,192
233,21,26,11.01.2025,2,121,149,28,56
455,4,11,21.01.2025,13,439,646,207,2691
547,20,3,24.01.2025,2,318,425,107,214
900,28,15,20.01.2025,15,295,317,22,330
904,5,8,21.01.2025,10,431,603,172,1720
274,12,14,17.01.2025,10,154,190,36,360
485,19,26,10.01.2025,1,488,680,192,192
238,27,25,14.01.2025,14,172,244,72,1008
68,14,7,31.01.2025,5,333,397,64,320
224,25,16,17.01.2025,7,464,512,48,336
597,16,12,15.01.2025,6,327,477,150,900
686,5,22,15.01.2025,8,73,93,20,160
985,18,25,24.01.2025,7,383,409,26,182
579,27,3,11.01.2025,18,208,305,97,1746
678,10,21,06.01.2025,8,136,154,18,144
93,13,28,24.01.2025,12,55,71,16,192
642,24,9,18.01.2025,8,318,396,78,624
399,1,15,30.01.2025,7,173,204,31,217
394,28,16,23.01.2025,9,219,247,28,252
126,12,24,21.01.2025,19,202,262,60,1140
666,3,30,21.01.2025,16,157,217,60,960
946,30,20,04.01.2025,14,52,65,13,182
345,1,6,29.01.2025,6,59,76,17,102
97,13,19,18.01.2025,3,350,499,149,447
294,29,4,08.01.2025,10,448,526,78,780
492,13,23,29.01.2025,2,381,501,120,240
837,18,7,23.01.2025,16,435,545,110,1760
27,24,5,19.01.2025,5,294,362,68,340
681,21,8,07.01.2025,1,435,486,51,51
985,28,21,12.01.2025,1,314,432,118,118
